//MAP CONVERTED BY dmm2tgm.py THIS HEADER COMMENT PREVENTS RECONVERSION, DO NOT REMOVE
"a" = (
/turf/template_noop,
/area/tether_away/debrisfield/explored)
"b" = (
/turf/simulated/mineral/vacuum,
/area/tether_away/debrisfield/explored)

(1,1,1) = {"
a
a
a
b
b
b
b
a
a
a
a
b
b
"}
(2,1,1) = {"
a
a
a
b
b
b
a
a
a
a
a
b
a
"}
(3,1,1) = {"
a
a
a
a
a
a
a
a
a
a
a
a
a
"}
(4,1,1) = {"
a
b
b
a
a
a
a
a
b
b
a
a
a
"}
(5,1,1) = {"
b
b
b
b
a
a
a
a
b
b
b
a
a
"}
(6,1,1) = {"
b
b
b
b
a
a
a
b
b
b
b
b
a
"}
(7,1,1) = {"
a
b
b
b
a
a
b
b
b
b
b
a
a
"}
(8,1,1) = {"
a
a
a
a
a
a
a
b
b
b
b
a
a
"}
