"a" = (/turf/simulated/mineral/vacuum,/area/tether_away/debrisfield/explored)
"b" = (/turf/template_noop,/area/tether_away/debrisfield/explored)

(1,1,1) = {"
aaabbbaab
babbbaaaa
bbbbbaaab
baabbbabb
aaaabbbbb
aaaaabbbb
aaaaaabba
aaaaabbba
baabbbabb
"}
