"a" = (/turf/space,/area/space)
"b" = (/obj/structure/lattice,/turf/space,/area/space)

(1,1,1) = {"
bbb
bbb
aba
"}
