//MAP CONVERTED BY dmm2tgm.py THIS HEADER COMMENT PREVENTS RECONVERSION, DO NOT REMOVE
"a" = (
/turf/space,
/area/tether_away/debrisfield/explored)
"b" = (
/obj/structure/lattice,
/turf/space,
/area/tether_away/debrisfield/explored)
"c" = (
/obj/structure/girder,
/turf/simulated/floor/airless,
/area/tether_away/debrisfield/explored)
"d" = (
/turf/simulated/shuttle/wall,
/area/tether_away/debrisfield/explored)
"e" = (
/turf/simulated/floor/airless,
/area/tether_away/debrisfield/explored)
"f" = (
/turf/simulated/shuttle/floor/white/airless,
/area/tether_away/debrisfield/explored)

(1,1,1) = {"
a
b
a
b
b
"}
(2,1,1) = {"
a
c
e
e
a
"}
(3,1,1) = {"
a
d
f
e
b
"}
(4,1,1) = {"
a
d
e
b
a
"}
(5,1,1) = {"
b
c
e
b
a
"}
(6,1,1) = {"
b
b
b
a
a
"}
