//MAP CONVERTED BY dmm2tgm.py THIS HEADER COMMENT PREVENTS RECONVERSION, DO NOT REMOVE
"a" = (
/turf/template_noop,
/area/mine/explored/underdark)
"b" = (
/turf/simulated/mineral/floor/ignore_cavegen/virgo3b,
/area/mine/explored/underdark)
"c" = (
/obj/tether_away_spawner/underdark_normal,
/turf/simulated/mineral/floor/ignore_cavegen/virgo3b,
/area/mine/explored/underdark)
"d" = (
/obj/structure/closet/crate/mimic/dangerous,
/obj/random/underdark,
/obj/random/underdark,
/turf/simulated/mineral/floor/ignore_cavegen/virgo3b,
/area/mine/explored/underdark)
"e" = (
/turf/simulated/wall/r_lead,
/area/mine/explored/underdark)
"f" = (
/obj/structure/frame/computer,
/turf/simulated/mineral/floor/ignore_cavegen/virgo3b,
/area/mine/explored/underdark)
"g" = (
/obj/structure/frame,
/turf/simulated/mineral/floor/ignore_cavegen/virgo3b,
/area/mine/explored/underdark)
"h" = (
/obj/machinery/the_singularitygen,
/turf/simulated/mineral/floor/ignore_cavegen/virgo3b,
/area/mine/explored/underdark)
"i" = (
/obj/random/underdark/uncertain,
/turf/simulated/mineral/floor/ignore_cavegen/virgo3b,
/area/mine/explored/underdark)
"j" = (
/turf/simulated/mineral/ignore_cavegen/virgo3b,
/area/mine/explored/underdark)
"k" = (
/obj/structure/closet/crate/mimic/safe,
/obj/item/stack/cable_coil/brown,
/obj/item/stack/material/lead{
	amount = 10
	},
/turf/simulated/mineral/floor/ignore_cavegen/virgo3b,
/area/mine/explored/underdark)
"l" = (
/obj/machinery/power/port_gen/pacman/super,
/turf/simulated/mineral/floor/ignore_cavegen/virgo3b,
/area/mine/explored/underdark)
"m" = (
/obj/structure/closet/crate/mimic,
/obj/item/stack/material/uranium{
	amount = 5
	},
/turf/simulated/mineral/floor/ignore_cavegen/virgo3b,
/area/mine/explored/underdark)
"n" = (
/obj/effect/decal/remains,
/turf/simulated/mineral/floor/ignore_cavegen/virgo3b,
/area/mine/explored/underdark)
"B" = (
/obj/structure/salvageable/data,
/turf/simulated/mineral/floor/ignore_cavegen/virgo3b,
/area/mine/explored/underdark)

(1,1,1) = {"
a
a
a
b
b
b
b
a
a
a
"}
(2,1,1) = {"
a
a
b
b
b
b
b
b
a
a
"}
(3,1,1) = {"
a
b
b
g
b
b
b
l
b
a
"}
(4,1,1) = {"
c
b
f
b
b
b
b
m
b
a
"}
(5,1,1) = {"
b
b
b
g
n
b
b
b
b
a
"}
(6,1,1) = {"
b
b
g
g
i
b
b
b
b
a
"}
(7,1,1) = {"
b
b
b
b
b
b
b
b
b
b
"}
(8,1,1) = {"
b
d
B
b
b
b
b
i
b
b
"}
(9,1,1) = {"
b
e
e
e
b
k
j
j
c
b
"}
(10,1,1) = {"
b
e
b
b
b
e
j
j
j
b
"}
(11,1,1) = {"
b
e
b
h
b
e
j
j
j
j
"}
(12,1,1) = {"
b
e
b
b
b
j
j
j
j
j
"}
(13,1,1) = {"
b
e
e
e
e
j
j
j
j
a
"}
(14,1,1) = {"
b
b
b
b
j
j
j
j
j
a
"}
(15,1,1) = {"
a
a
b
b
b
j
j
j
a
a
"}
