//MAP CONVERTED BY dmm2tgm.py THIS HEADER COMMENT PREVENTS RECONVERSION, DO NOT REMOVE
"a" = (
/turf/simulated/wall/dungeon/rock{
	block_tele = 0
	},
/area/submap/cave/IceCave1)
"b" = (
/turf/template_noop,
/area/submap/cave/IceCave1)
"c" = (
/turf/simulated/floor/outdoors/ice{
	outdoors = 0
	},
/area/submap/cave/IceCave1)
"d" = (
/obj/machinery/crystal/ice,
/turf/simulated/floor/outdoors/ice{
	outdoors = 0
	},
/area/submap/cave/IceCave1)
"e" = (
/turf/simulated/mineral/floor/ignore_mapgen,
/area/submap/cave/IceCave1)
"f" = (
/obj/machinery/crystal/ice,
/turf/simulated/mineral/floor/ignore_mapgen,
/area/submap/cave/IceCave1)

(1,1,1) = {"
a
a
a
a
a
a
a
a
a
a
a
a
a
a
a
a
a
a
a
a
a
a
a
a
e
e
e
e
"}
(2,1,1) = {"
a
a
a
a
a
a
a
a
a
a
a
a
a
a
a
a
a
a
a
a
a
a
a
a
a
e
e
e
"}
(3,1,1) = {"
a
a
c
c
c
c
d
c
c
c
c
c
c
c
a
a
f
f
a
a
a
a
a
a
a
a
e
e
"}
(4,1,1) = {"
a
a
c
c
c
c
c
c
c
c
c
c
c
c
a
a
f
e
f
a
a
a
a
f
a
a
e
e
"}
(5,1,1) = {"
a
a
c
c
c
c
c
c
c
c
d
c
c
c
a
a
f
e
f
e
e
a
f
f
a
a
e
e
"}
(6,1,1) = {"
a
a
c
c
c
c
c
c
c
c
c
c
c
c
a
a
e
e
e
e
e
e
e
a
a
a
e
e
"}
(7,1,1) = {"
a
a
c
c
c
c
c
c
c
c
c
d
c
c
d
f
e
e
a
a
f
e
e
e
e
f
e
e
"}
(8,1,1) = {"
a
a
d
c
c
c
c
c
c
c
c
c
c
c
d
f
e
e
a
a
a
f
e
e
e
e
e
e
"}
(9,1,1) = {"
a
a
c
c
c
c
c
c
c
c
c
c
d
c
d
f
e
e
a
a
a
a
a
e
e
e
e
a
"}
(10,1,1) = {"
a
a
c
c
c
c
c
c
c
c
c
c
c
c
d
e
e
e
a
a
a
a
a
a
f
a
a
a
"}
(11,1,1) = {"
a
a
c
c
c
c
c
c
c
c
c
c
c
c
d
e
e
e
a
a
a
a
a
a
a
a
a
a
"}
(12,1,1) = {"
a
a
c
c
c
c
c
c
c
d
c
c
c
c
d
e
e
e
a
a
a
a
a
a
a
a
a
a
"}
(13,1,1) = {"
a
a
c
c
c
d
c
c
c
c
c
c
c
c
d
e
e
e
a
a
a
a
a
a
a
a
a
a
"}
(14,1,1) = {"
a
a
c
c
c
c
c
c
c
c
c
c
c
c
d
d
e
e
a
a
a
a
a
a
a
a
a
a
"}
(15,1,1) = {"
a
a
c
c
c
c
c
c
c
c
c
c
c
c
d
d
c
c
c
c
c
c
a
a
a
a
a
a
"}
(16,1,1) = {"
a
a
c
c
c
c
d
c
c
c
c
d
c
c
e
d
c
c
c
c
c
c
a
a
a
a
a
a
"}
(17,1,1) = {"
a
a
d
d
a
a
a
a
e
e
a
a
a
a
e
d
a
a
a
a
c
c
d
d
a
a
a
a
"}
(18,1,1) = {"
a
a
d
d
a
a
a
a
e
e
a
a
a
a
e
f
a
a
a
a
c
c
d
d
a
a
a
a
"}
(19,1,1) = {"
a
a
a
a
a
a
a
a
e
e
a
a
f
e
e
f
a
a
a
a
c
c
c
c
a
a
a
a
"}
(20,1,1) = {"
b
a
a
a
a
a
a
a
e
e
a
a
f
e
e
f
a
a
a
a
c
c
c
c
a
a
a
a
"}
(21,1,1) = {"
b
b
b
a
a
a
a
a
e
e
a
a
e
e
f
f
a
a
a
a
d
d
e
e
a
a
a
a
"}
(22,1,1) = {"
b
b
b
b
a
a
a
a
e
e
a
a
e
e
e
f
a
a
a
a
d
d
e
e
a
a
a
a
"}
(23,1,1) = {"
b
b
b
b
a
a
c
c
d
c
d
d
f
e
e
f
a
a
a
a
a
a
e
e
e
f
a
a
"}
(24,1,1) = {"
b
b
b
b
a
a
c
c
c
c
d
d
d
f
e
e
a
a
e
e
e
a
e
e
e
f
a
a
"}
(25,1,1) = {"
b
b
b
b
a
a
c
c
c
d
a
a
a
a
e
e
e
f
e
e
e
f
e
e
e
f
a
a
"}
(26,1,1) = {"
b
b
b
b
a
a
c
c
c
c
a
f
f
a
e
f
e
f
e
e
e
e
e
e
f
f
a
a
"}
(27,1,1) = {"
b
b
b
b
a
a
d
c
c
c
a
e
e
a
e
e
e
f
e
e
e
a
a
a
a
a
a
a
"}
(28,1,1) = {"
b
b
b
b
a
a
c
c
c
c
a
e
e
e
e
e
f
f
e
e
e
a
a
a
a
a
a
a
"}
(29,1,1) = {"
b
b
b
b
a
a
c
c
c
d
a
e
e
a
a
a
a
a
e
e
e
a
a
b
b
b
b
b
"}
(30,1,1) = {"
b
b
b
a
a
a
f
e
f
f
a
e
e
e
e
e
f
e
e
a
a
a
a
b
b
b
b
b
"}
(31,1,1) = {"
b
a
a
a
a
a
f
e
f
f
a
e
e
f
e
e
e
e
e
a
a
a
a
b
b
b
b
b
"}
(32,1,1) = {"
a
a
a
a
a
e
e
e
f
f
a
a
a
a
a
a
a
a
a
a
a
b
b
b
b
b
b
b
"}
(33,1,1) = {"
a
a
a
e
e
e
e
e
a
a
a
a
a
a
a
a
a
a
a
a
a
b
b
b
b
b
b
b
"}
(34,1,1) = {"
a
a
e
e
e
e
e
e
a
a
a
a
b
b
b
b
b
b
b
b
b
b
b
b
b
b
b
b
"}
(35,1,1) = {"
a
a
e
e
e
e
e
e
a
a
a
a
b
b
b
b
b
b
b
b
b
b
b
b
b
b
b
b
"}
(36,1,1) = {"
a
a
f
e
e
e
e
e
a
a
b
b
b
b
b
b
b
b
b
b
b
b
b
b
b
b
b
b
"}
(37,1,1) = {"
a
a
f
f
e
e
e
f
a
a
b
b
b
b
b
b
b
b
b
b
b
b
b
b
b
b
b
b
"}
(38,1,1) = {"
a
a
a
e
e
e
a
a
a
a
b
b
b
b
b
b
b
b
b
b
b
b
b
b
b
b
b
b
"}
(39,1,1) = {"
a
a
a
a
a
a
a
a
a
a
b
b
b
b
b
b
b
b
b
b
b
b
b
b
b
b
b
b
"}
(40,1,1) = {"
a
a
a
a
a
a
a
a
a
b
b
b
b
b
b
b
b
b
b
b
b
b
b
b
b
b
b
b
"}
