"aa" = (/turf/template_noop,/area/template_noop)
"ab" = (/turf/simulated/floor/outdoors/grass/sif/forest,/area/submap/Blackshuttledown)
"ac" = (/obj/effect/decal/remains/human,/turf/simulated/floor/outdoors/grass/sif/forest,/area/submap/Blackshuttledown)
"ad" = (/obj/effect/decal/cleanable/blood,/turf/simulated/floor/outdoors/grass/sif/forest,/area/submap/Blackshuttledown)
"ae" = (/obj/structure/flora/tree/sif,/turf/simulated/floor/outdoors/grass/sif/forest,/area/submap/Blackshuttledown)
"af" = (/turf/simulated/mineral/ignore_mapgen,/area/submap/Blackshuttledown)
"ag" = (/obj/structure/table/steel,/turf/simulated/floor/outdoors/grass/sif/forest,/area/submap/Blackshuttledown)
"ah" = (/mob/living/simple_animal/hostile/syndicate/ranged{desc = "Dosen't look friendly in the slightest."; name = "Unknown Individual."; say_got_target = list("Looks like trouble!","Contact!","We've got company!","Perimeter Breached!!"); speak = list("One day the'll fix that damn engine..","Next time, We're hidding on the tropical beach planet.","Wish I had better equipment...","I knew I should have been a line chef...","Fuckin' helmet keeps fogging up.","Hate this blocky ass ship.")},/turf/simulated/floor/outdoors/grass/sif/forest,/area/submap/Blackshuttledown)
"ai" = (/turf/simulated/floor/outdoors/grass/sif/forest,/turf/simulated/shuttle/wall/dark{icon_state = "dark6"; name = "Unknown Shuttle"; tag = "icon-dark6"},/area/submap/Blackshuttledown)
"aj" = (/turf/simulated/shuttle/wall/dark{icon_state = "dark0"; name = "Unknown Shuttle"; tag = "icon-dark0"},/area/submap/Blackshuttledown)
"ak" = (/turf/simulated/floor/outdoors/grass/sif/forest,/turf/simulated/shuttle/wall/dark{icon_state = "dark10"; name = "Unknown Shuttle"; tag = "icon-dark10"},/area/submap/Blackshuttledown)
"al" = (/obj/machinery/door/airlock/external,/turf/simulated/shuttle/wall/dark{icon_state = "dark0"; name = "Unknown Shuttle"; tag = "icon-dark0"},/area/submap/Blackshuttledown)
"am" = (/obj/structure/shuttle/engine/heater{icon_state = "heater"; dir = 4},/turf/simulated/shuttle/wall/dark{icon_state = "dark0"; name = "Unknown Shuttle"; tag = "icon-dark0"},/area/submap/Blackshuttledown)
"an" = (/obj/structure/shuttle/engine/propulsion{dir = 4; icon_state = "propulsion_l"},/turf/simulated/floor/outdoors/grass/sif/forest,/area/submap/Blackshuttledown)
"ao" = (/obj/machinery/light{dir = 1},/obj/structure/table/rack,/obj/item/clothing/head/helmet/space,/obj/item/clothing/head/helmet/space,/obj/item/clothing/head/helmet/space,/obj/item/clothing/head/helmet/space,/obj/item/clothing/suit/space,/obj/item/clothing/suit/space,/obj/item/clothing/suit/space,/obj/item/clothing/suit/space,/turf/simulated/floor/tiled/steel,/area/submap/Blackshuttledown)
"ap" = (/obj/structure/dispenser/oxygen,/turf/simulated/floor/tiled/steel,/area/submap/Blackshuttledown)
"aq" = (/turf/simulated/floor/tiled/steel,/area/submap/Blackshuttledown)
"ar" = (/obj/machinery/light/small{dir = 4; pixel_y = 0},/turf/simulated/floor/tiled/steel,/area/submap/Blackshuttledown)
"as" = (/obj/machinery/light{dir = 1},/turf/simulated/floor/tiled/steel,/area/submap/Blackshuttledown)
"at" = (/obj/machinery/organ_printer/flesh,/turf/simulated/floor/tiled/steel,/area/submap/Blackshuttledown)
"au" = (/turf/simulated/floor/tiled/steel,/turf/simulated/shuttle/wall/dark{icon_state = "dark5"; name = "Unknown Shuttle"; tag = "icon-dark5"},/area/submap/Blackshuttledown)
"av" = (/obj/structure/table/steel,/obj/item/weapon/gun/projectile/automatic/wt550,/obj/item/weapon/gun/projectile/automatic/p90,/turf/simulated/floor/tiled/steel,/area/submap/Blackshuttledown)
"aw" = (/obj/machinery/door/airlock/external,/turf/simulated/floor/tiled/steel,/area/submap/Blackshuttledown)
"ax" = (/obj/machinery/optable,/turf/simulated/floor/tiled/steel,/area/submap/Blackshuttledown)
"ay" = (/obj/machinery/bodyscanner{dir = 8},/turf/simulated/floor/tiled/steel,/area/submap/Blackshuttledown)
"az" = (/turf/simulated/floor/tiled/steel,/turf/simulated/shuttle/wall/dark{icon_state = "dark9"; name = "Unknown Shuttle"; tag = "icon-dark9"},/area/submap/Blackshuttledown)
"aA" = (/turf/simulated/floor/tiled/steel,/turf/simulated/shuttle/wall/dark{icon_state = "dark6"; name = "Unknown Shuttle"; tag = "icon-dark6"},/area/submap/Blackshuttledown)
"aB" = (/mob/living/simple_animal/hostile/viscerator,/mob/living/simple_animal/hostile/viscerator,/mob/living/simple_animal/hostile/viscerator,/turf/simulated/floor/tiled/steel,/area/submap/Blackshuttledown)
"aC" = (/obj/structure/table/steel,/obj/item/weapon/gun/projectile/automatic/c20r,/obj/machinery/light/small{dir = 4; pixel_y = 0},/turf/simulated/floor/tiled/steel,/area/submap/Blackshuttledown)
"aD" = (/mob/living/simple_animal/hostile/syndicate/ranged{desc = "Dosen't look friendly in the slightest."; name = "Unknown Individual."; say_got_target = list("Looks like trouble!","Contact!","We've got company!","Perimeter Breached!!"); speak = list("One day the'll fix that damn engine..","Next time, We're hidding on the tropical beach planet.","Wish I had better equipment...","I knew I should have been a line chef...","Fuckin' helmet keeps fogging up.","Hate this blocky ass ship.")},/turf/simulated/floor/tiled/steel,/area/submap/Blackshuttledown)
"aE" = (/obj/machinery/light{dir = 4; icon_state = "tube1"; pixel_x = 0},/turf/simulated/floor/tiled/steel,/area/submap/Blackshuttledown)
"aF" = (/obj/structure/table/steel,/turf/simulated/floor/tiled/steel,/area/submap/Blackshuttledown)
"aG" = (/obj/structure/table/standard,/obj/item/weapon/storage/firstaid/surgery,/turf/simulated/floor/tiled/steel,/area/submap/Blackshuttledown)
"aH" = (/obj/structure/table/standard,/obj/item/weapon/tank/anesthetic,/turf/simulated/floor/tiled/steel,/area/submap/Blackshuttledown)
"aI" = (/obj/structure/table/standard,/obj/item/clothing/gloves/sterile,/obj/item/clothing/gloves/sterile,/turf/simulated/floor/tiled/steel,/area/submap/Blackshuttledown)
"aJ" = (/obj/structure/table/standard,/obj/item/weapon/reagent_containers/spray/sterilizine,/obj/item/weapon/reagent_containers/spray/sterilizine,/turf/simulated/floor/tiled/steel,/area/submap/Blackshuttledown)
"aK" = (/obj/structure/table/standard,/obj/item/weapon/storage/box/masks,/turf/simulated/floor/tiled/steel,/area/submap/Blackshuttledown)
"aL" = (/obj/machinery/light{icon_state = "tube1"; dir = 8},/turf/simulated/floor/tiled/steel,/area/submap/Blackshuttledown)
"aM" = (/obj/structure/bed/chair/office/dark{dir = 1},/turf/simulated/floor/tiled/steel,/area/submap/Blackshuttledown)
"aN" = (/obj/machinery/door/airlock/security,/turf/simulated/floor/tiled/steel,/area/submap/Blackshuttledown)
"aO" = (/obj/machinery/door/airlock/glass,/turf/simulated/floor/tiled/steel,/area/submap/Blackshuttledown)
"aP" = (/turf/simulated/floor/tiled/steel,/turf/simulated/shuttle/wall/dark{icon_state = "dark10"; name = "Unknown Shuttle"; tag = "icon-dark10"},/area/submap/Blackshuttledown)
"aQ" = (/obj/machinery/computer/communications,/turf/simulated/floor/tiled/steel,/area/submap/Blackshuttledown)
"aR" = (/obj/structure/closet/secure_closet/freezer/fridge,/turf/simulated/floor/tiled/steel,/area/submap/Blackshuttledown)
"aS" = (/obj/structure/table/steel,/obj/item/weapon/material/knife,/turf/simulated/floor/tiled/steel,/area/submap/Blackshuttledown)
"aT" = (/obj/structure/table/steel,/obj/random/toolbox,/turf/simulated/floor/tiled/steel,/area/submap/Blackshuttledown)
"aU" = (/obj/structure/table/steel,/obj/machinery/light/small{dir = 4; pixel_y = 0},/turf/simulated/floor/tiled/steel,/area/submap/Blackshuttledown)
"aV" = (/obj/structure/window,/turf/simulated/floor/tiled/steel,/area/submap/Blackshuttledown)
"aW" = (/obj/item/weapon/stool,/turf/simulated/floor/tiled/steel,/area/submap/Blackshuttledown)
"aX" = (/obj/structure/table/steel,/obj/item/pizzabox,/turf/simulated/floor/tiled/steel,/area/submap/Blackshuttledown)
"aY" = (/obj/machinery/door/airlock,/turf/simulated/floor/tiled/steel,/area/submap/Blackshuttledown)
"aZ" = (/obj/machinery/power/apc{cell_type = /obj/item/weapon/cell/hyper; dir = 4; name = "Unknown APC"; pixel_x = 24},/turf/simulated/shuttle/wall/dark{icon_state = "dark0"; name = "Unknown Shuttle"; tag = "icon-dark0"},/area/submap/Blackshuttledown)
"ba" = (/obj/machinery/computer/area_atmos,/turf/simulated/floor/tiled/steel,/area/submap/Blackshuttledown)
"bb" = (/obj/structure/closet/toolcloset,/turf/simulated/floor/tiled/steel,/area/submap/Blackshuttledown)
"bc" = (/obj/machinery/portable_atmospherics/canister/empty/oxygen,/turf/simulated/floor/tiled/steel,/area/submap/Blackshuttledown)
"bd" = (/obj/machinery/atmospherics/pipe/tank/oxygen,/obj/machinery/light/small{dir = 4; pixel_y = 0},/turf/simulated/floor/tiled/steel,/area/submap/Blackshuttledown)
"be" = (/obj/structure/bed/chair/office/dark,/turf/simulated/floor/tiled/steel,/area/submap/Blackshuttledown)
"bf" = (/obj/structure/table/steel,/obj/item/weapon/gun/projectile/automatic/c20r,/turf/simulated/floor/tiled/steel,/area/submap/Blackshuttledown)
"bg" = (/obj/structure/bed,/obj/item/weapon/bedsheet,/turf/simulated/floor/tiled/steel,/area/submap/Blackshuttledown)
"bh" = (/mob/living/simple_animal/hostile/viscerator,/turf/simulated/floor/tiled/steel,/area/submap/Blackshuttledown)
"bi" = (/obj/structure/table/steel,/obj/item/weapon/gun/projectile/pistol,/obj/machinery/light/small{dir = 4; pixel_y = 0},/turf/simulated/floor/tiled/steel,/area/submap/Blackshuttledown)
"bj" = (/obj/structure/bed,/obj/item/weapon/bedsheet,/obj/structure/bed,/turf/simulated/floor/tiled/steel,/area/submap/Blackshuttledown)
"bk" = (/mob/living/simple_animal/hostile/viscerator,/mob/living/simple_animal/hostile/viscerator,/turf/simulated/floor/tiled/steel,/area/submap/Blackshuttledown)
"bl" = (/obj/structure/table/steel,/obj/item/weapon/gun/projectile/pistol,/obj/item/weapon/gun/projectile/shotgun/pump,/turf/simulated/floor/tiled/steel,/area/submap/Blackshuttledown)
"bm" = (/obj/structure/toilet{dir = 1},/turf/simulated/floor/tiled/steel,/area/submap/Blackshuttledown)
"bn" = (/obj/machinery/light,/obj/structure/table/rack,/obj/item/clothing/head/helmet/space,/obj/item/clothing/head/helmet/space,/obj/item/clothing/head/helmet/space,/obj/item/clothing/head/helmet/space,/obj/item/clothing/suit/space,/obj/item/clothing/suit/space,/obj/item/clothing/suit/space,/obj/item/clothing/suit/space,/turf/simulated/floor/tiled/steel,/area/submap/Blackshuttledown)
"bo" = (/obj/structure/bed,/obj/item/weapon/bedsheet,/obj/machinery/light,/turf/simulated/floor/tiled/steel,/area/submap/Blackshuttledown)
"bp" = (/obj/structure/bed,/obj/item/weapon/bedsheet,/obj/item/toy/plushie/spider,/turf/simulated/floor/tiled/steel,/area/submap/Blackshuttledown)
"bq" = (/turf/simulated/floor/outdoors/grass/sif/forest,/turf/simulated/shuttle/wall/dark{icon_state = "dark5"; name = "Unknown Shuttle"; tag = "icon-dark5"},/area/submap/Blackshuttledown)
"br" = (/turf/simulated/floor/outdoors/grass/sif/forest,/turf/simulated/shuttle/wall/dark{icon_state = "dark9"; name = "Unknown Shuttle"; tag = "icon-dark9"},/area/submap/Blackshuttledown)

(1,1,1) = {"
aaaaaaaaaaaaaaaaaaaaaaaaaaaaaaaaaaaaaaaaaaaaaaaaaaaaaaaaaaaaaaaaaaaaaa
aaabababababacabababababababababababacabababababacabababababababababaa
aaababababababadababababababababababababababababababababababaeababacaa
aaabababababababababababababababababababababababababadabababababababaa
aaababaeabafafafababababaeabababababababababababababababababababababaa
aaabababababafafafabacababababagagagagagagabababababacabaeabababababaa
aaababababababafafababababababagahabababagabababababababababababababaa
aaabababababababaiajajajakababagabababahagabababaeaiajajajajakabababaa
aaabababababababajajajajajajajajajalalajajajajajajajajajajajamanababaa
aaababababaeababajajajajajajaoapajaqarajaqaqasaqatajajajajajamanababaa
aaabababababababauajajaqavajaqaqajawawajaqaxaqaqaqaqayajajazababababaa
aaabababababababaAajajaBaCajaqaqaqaqaqajaqaqaqaqaDaqaEajazabababababaa
aaabaeababababaAajaFajaqaFajaqaqaqaqaEajaGaHaqaqaIaJaKajababababaeabaa
aaabababababaAajaLaMajaNajajaqaqajajajajajajaOajajajajajaPabababababaa
aaabababababajaQaqaqajaqaqaqaqaqajaRaSaqaqaqaDaqajaTaTaUajaPababababaa
aaabababababaVaFaqaqajaLaqaqaqaEajaqaqaWaWaWaqaqajaFaqaqaqamanabababaa
aaabababababaVaFaqaqaOaqaqaqaqaqaOaqaqaXaFaFaqaqaYaqaqaqaqamanabababaa
aaabababababaVaFaqaqaOaqaqaqaqaqaOaqaqaFaFaFaqaqaYaqaqaqaqamanabababaa
aaabababababaVaFaqaqajaLaqaqaqaEajaqaqaWaWaWaqaqaZaqaqaqaDamanabababaa
aaabababababajbaaqaDajaqaqaqaqaqajaFaFaqaqaDaqaqajbbbcbdajazababababaa
aaabababababauajaLbeajaNajajaqaqajajajajajajaOajajajajajazabababababaa
aaababababababauajaFajaqbfajaqaqaqaqaEajbgaqaqaqaqaYaqajababababababaa
aaabaeabababababauajajbhbiajaqaqaqaqaqajbjaqbgaqbgajarajaPabaeabababaa
aaabababababababaAajajbkblajaqaDajawawajbgaqbgaqbgajbmajajaPababababaa
aaabababababababajajajajajajbnapajaqarajbgaqboaqbpajajajajamanabababaa
aaabababababababajajajajajajajajajalalajajajajajajajajajajamanabababaa
aaababaeababababbqajajajbrababagahabababagabababbqajajajajbrababababaa
aaabababafabababababaeababababagabababahagababababaeabababafafafababaa
aaababafafabacababababababababagagagagagagababababacababafafafafababaa
aaabafafafabababababababadabababababababababababababababafafafafababaa
aaababafafababacabababababababababababababababababababababafafabababaa
aaabababababababababaeababababababababacababababaeabababababababababaa
aaabababaeababababababababababababababababababababababababababaeababaa
aaababababababababababacababababababababababababadabacaeababababababaa
aaaaaaaaaaaaaaaaaaaaaaaaaaaaaaaaaaaaaaaaaaaaaaaaaaaaaaaaaaaaaaaaaaaaaa
"}
