"a" = (/turf/template_noop,/area/template_noop)
"b" = (/turf/template_noop,/area/submap/BoomBase)
"c" = (/obj/effect/decal/remains/human,/turf/template_noop,/area/submap/BoomBase)
"d" = (/obj/structure/flora/tree/sif,/turf/template_noop,/area/submap/BoomBase)
"e" = (/turf/simulated/wall/r_wall,/area/submap/BoomBase)
"f" = (/obj/structure/girder,/turf/simulated/floor/plating,/area/submap/BoomBase)
"g" = (/obj/structure/girder,/obj/item/stack/rods,/turf/simulated/floor/plating,/area/submap/BoomBase)
"h" = (/obj/item/stack/rods,/turf/simulated/wall/r_wall,/area/submap/BoomBase)
"i" = (/obj/structure/closet/crate/secure/phoron,/obj/fiftyspawner/phoron,/turf/simulated/floor/plating,/area/submap/BoomBase)
"j" = (/obj/structure/closet/crate/secure/phoron,/obj/fiftyspawner/phoron,/turf/simulated/floor/tiled/steel,/area/submap/BoomBase)
"k" = (/obj/effect/decal/cleanable/dirt,/turf/simulated/floor/tiled/steel{tag = "icon-burned1"; icon_state = "burned1"},/area/submap/BoomBase)
"l" = (/obj/effect/decal/cleanable/dirt,/obj/effect/decal/cleanable/ash,/turf/simulated/floor/tiled/steel,/area/submap/BoomBase)
"m" = (/obj/effect/decal/cleanable/dirt,/turf/simulated/floor/tiled/steel,/area/submap/BoomBase)
"n" = (/obj/effect/decal/cleanable/dirt,/obj/effect/spider,/obj/item/weapon/material/shard,/turf/simulated/floor/tiled/steel,/area/submap/BoomBase)
"o" = (/turf/simulated/floor/tiled/steel,/area/submap/BoomBase)
"p" = (/mob/living/simple_animal/hostile/giant_spider/phorogenic{returns_home = 1},/turf/simulated/floor/tiled/steel,/area/submap/BoomBase)
"q" = (/obj/machinery/portable_atmospherics/canister/empty/phoron,/turf/simulated/floor/tiled/steel{tag = "icon-steel_dirty"; icon_state = "steel_dirty"},/area/submap/BoomBase)
"r" = (/obj/machinery/portable_atmospherics/canister/empty/phoron,/obj/item/weapon/material/shard,/turf/simulated/floor/tiled/steel{tag = "icon-steel_dirty"; icon_state = "steel_dirty"},/area/submap/BoomBase)
"s" = (/obj/item/weapon/material/shard,/turf/simulated/floor/plating,/area/submap/BoomBase)
"t" = (/obj/effect/spider/stickyweb,/turf/simulated/floor/plating,/area/submap/BoomBase)
"u" = (/turf/simulated/floor/outdoors/dirt,/area/submap/BoomBase)
"v" = (/obj/effect/decal/cleanable/dirt,/turf/simulated/floor/plating,/area/submap/BoomBase)
"w" = (/turf/simulated/floor/tiled/steel{tag = "icon-burned1"; icon_state = "burned1"},/area/submap/BoomBase)
"x" = (/obj/effect/decal/remains/human,/turf/simulated/floor/tiled/steel,/area/submap/BoomBase)
"y" = (/turf/simulated/floor/tiled/steel{tag = "icon-steel_dirty"; icon_state = "steel_dirty"},/area/submap/BoomBase)
"z" = (/turf/simulated/floor/tiled/steel{tag = "icon-broken0"; icon_state = "broken0"},/area/submap/BoomBase)
"A" = (/turf/simulated/floor/plating,/area/submap/BoomBase)
"B" = (/obj/structure/flora/tree/dead,/turf/simulated/floor/outdoors/dirt,/area/submap/BoomBase)
"C" = (/obj/effect/decal/cleanable/dirt,/turf/simulated/floor/outdoors/dirt,/area/submap/BoomBase)
"D" = (/obj/effect/decal/cleanable/dirt,/obj/effect/spider/stickyweb,/turf/simulated/floor/tiled/steel,/area/submap/BoomBase)
"E" = (/obj/effect/decal/cleanable/dirt,/turf/simulated/floor/tiled/steel{tag = "icon-broken1"; icon_state = "broken1"},/area/submap/BoomBase)
"F" = (/obj/effect/decal/cleanable/dirt,/turf/simulated/floor/tiled/steel{tag = "icon-burned2"; icon_state = "burned2"},/area/submap/BoomBase)
"G" = (/obj/effect/decal/cleanable/ash,/turf/simulated/floor/outdoors/dirt,/area/submap/BoomBase)
"H" = (/obj/structure/table,/turf/simulated/floor/tiled/steel,/area/submap/BoomBase)
"I" = (/obj/effect/decal/cleanable/dirt,/mob/living/simple_animal/hostile/giant_spider/phorogenic,/turf/simulated/floor/tiled/steel,/area/submap/BoomBase)
"J" = (/turf/simulated/floor/tiled/steel{tag = "icon-burned2"; icon_state = "burned2"},/area/submap/BoomBase)
"K" = (/turf/simulated/floor/outdoors/rocks,/area/submap/BoomBase)
"L" = (/obj/effect/decal/cleanable/dirt,/obj/structure/table/standard,/obj/item/weapon/tank/phoron,/obj/item/weapon/fuel_assembly/phoron,/turf/simulated/floor/tiled/steel,/area/submap/BoomBase)
"M" = (/obj/effect/decal/remains/human,/obj/effect/decal/cleanable/ash,/turf/simulated/floor/tiled/steel{tag = "icon-steel_dirty"; icon_state = "steel_dirty"},/area/submap/BoomBase)
"N" = (/obj/item/weapon/material/shard,/turf/simulated/floor/tiled/steel{tag = "icon-steel_dirty"; icon_state = "steel_dirty"},/area/submap/BoomBase)
"O" = (/obj/item/device/transfer_valve,/turf/simulated/floor/outdoors/rocks,/area/submap/BoomBase)
"P" = (/obj/item/weapon/material/shard,/turf/template_noop,/area/submap/BoomBase)
"Q" = (/obj/effect/decal/cleanable/ash,/turf/simulated/floor/plating,/area/submap/BoomBase)
"R" = (/obj/effect/decal/cleanable/ash,/turf/simulated/floor/tiled/steel,/area/submap/BoomBase)
"S" = (/obj/effect/spider/stickyweb,/obj/item/weapon/material/shard,/turf/simulated/floor/tiled/steel,/area/submap/BoomBase)
"T" = (/obj/effect/spider/stickyweb,/mob/living/simple_animal/hostile/giant_spider/phorogenic,/turf/simulated/floor/tiled/steel,/area/submap/BoomBase)
"U" = (/obj/effect/spider/stickyweb,/obj/effect/decal/cleanable/ash,/turf/simulated/floor/tiled/steel{tag = "icon-burned1"; icon_state = "burned1"},/area/submap/BoomBase)
"V" = (/obj/effect/decal/remains/human,/obj/effect/decal/cleanable/ash,/turf/template_noop,/area/submap/BoomBase)
"W" = (/obj/structure/flora/tree/dead,/turf/template_noop,/area/submap/BoomBase)

(1,1,1) = {"
aaaaaaaaaaaaaaaaaaaaaaaaa
abcbbdbbbbbbbbbdbbbbbbbca
abbbbbeeeeeeeeeeeeeeefgba
abbbbheijklmnopqrstgbbbua
adbbbevvvmmvvwxyzAuuubuBa
abbdbevvvmvfCuuuuuuuuuuua
abbbbeDvvvCCCuuuuuuuuuuua
abbbbemEvfFCuuuuuuuuuuuua
abbbdemmCCCuuuGuuuuuuuuBa
abbbbeHICJuuuuKKuuuuuuuua
abbdbeLMuuuuKKKKKuuuuuuba
abbbbeoNuuuuuKKOPuuuuuuba
abbbQeAzuuuuuKKKKuuuubbba
adbbbeRyuuuuuKuuuuuuubAba
abbbbfAgbuuuuuuuuuuuuASba
abbbbbbAbuuuuuuuuuuAAToba
abbbbbbfAbuuuuuuuuAAUVeba
abbbbbbAfbuubbbuuuAeeheba
abWbbbbbWbbbbbbuubbbbbbca
aaaaaaaaaaaaaaaaaaaaaaaaa
"}
