"a" = (/turf/template_noop,/area/template_noop)
"b" = (/turf/simulated/floor/outdoors/grass/sif/forest,/area/submap/MilitaryCamp1)
"c" = (/turf/simulated/floor/outdoors/dirt,/area/submap/MilitaryCamp1)
"d" = (/obj/effect/mine,/turf/simulated/floor/outdoors/grass/sif/forest,/area/submap/MilitaryCamp1)
"e" = (/obj/structure/flora/bush,/turf/simulated/floor/outdoors/grass/sif/forest,/area/submap/MilitaryCamp1)
"f" = (/obj/effect/decal/cleanable/blood,/turf/simulated/floor/outdoors/grass/sif/forest,/area/submap/MilitaryCamp1)
"g" = (/obj/effect/decal/remains,/turf/simulated/floor/outdoors/dirt,/area/submap/MilitaryCamp1)
"h" = (/obj/structure/flora/tree/sif,/turf/simulated/floor/outdoors/grass/sif/forest,/area/submap/MilitaryCamp1)
"i" = (/obj/item/stack/rods,/turf/simulated/floor/outdoors/grass/sif/forest,/area/submap/MilitaryCamp1)
"j" = (/obj/effect/mine,/turf/simulated/floor/outdoors/dirt,/area/submap/MilitaryCamp1)
"k" = (/turf/simulated/wall,/area/submap/MilitaryCamp1)
"l" = (/turf/simulated/floor,/area/submap/MilitaryCamp1)
"m" = (/obj/item/weapon/material/shard,/turf/simulated/floor/outdoors/grass/sif/forest,/area/submap/MilitaryCamp1)
"n" = (/obj/structure/table/standard,/turf/simulated/floor/tiled/steel,/area/submap/MilitaryCamp1)
"o" = (/turf/simulated/floor/tiled/steel,/area/submap/MilitaryCamp1)
"p" = (/obj/effect/mine,/turf/simulated/floor,/area/submap/MilitaryCamp1)
"q" = (/obj/structure/table/standard,/obj/item/weapon/gun/energy/gun,/turf/simulated/floor/tiled/steel,/area/submap/MilitaryCamp1)
"r" = (/obj/structure/table/standard,/obj/item/weapon/gun/projectile/automatic/c20r,/turf/simulated/floor/tiled/steel,/area/submap/MilitaryCamp1)
"s" = (/obj/structure/table/standard,/obj/item/weapon/storage/box/syndie_kit/space,/turf/simulated/floor/tiled/steel,/area/submap/MilitaryCamp1)
"t" = (/obj/machinery/door/airlock,/turf/simulated/floor/tiled/steel,/area/submap/MilitaryCamp1)
"u" = (/mob/living/simple_animal/hostile/viscerator,/turf/simulated/floor/tiled/steel,/area/submap/MilitaryCamp1)
"v" = (/obj/effect/decal/cleanable/blood,/turf/simulated/floor/tiled/steel,/area/submap/MilitaryCamp1)
"w" = (/obj/structure/girder,/turf/simulated/floor,/area/submap/MilitaryCamp1)
"x" = (/obj/machinery/computer/security,/turf/simulated/floor/tiled/steel,/area/submap/MilitaryCamp1)
"y" = (/obj/machinery/computer/message_monitor,/turf/simulated/floor/holofloor/tiled,/area/submap/MilitaryCamp1)
"z" = (/obj/machinery/light,/turf/simulated/floor/tiled/steel,/area/submap/MilitaryCamp1)
"A" = (/obj/structure/flora/tree/dead,/turf/simulated/floor/outdoors/grass/sif/forest,/area/submap/MilitaryCamp1)
"B" = (/obj/structure/door_assembly,/turf/simulated/floor/tiled/steel,/area/submap/MilitaryCamp1)
"C" = (/obj/structure/table/standard,/obj/random/toolbox,/turf/simulated/floor/tiled/steel,/area/submap/MilitaryCamp1)
"D" = (/obj/machinery/light,/obj/structure/table/standard,/turf/simulated/floor/tiled/steel,/area/submap/MilitaryCamp1)
"E" = (/obj/machinery/door/airlock,/turf/simulated/floor,/area/submap/MilitaryCamp1)

(1,1,1) = {"
aaaaaaaaaaaaaaaaaaaa
abbcbdbefdbbbbbbbbba
acgcbbbbbbbfdbcgbbba
abccbbdbbhibbbccjhba
abhbbikklkkklkmcbbba
abbbbkkkllkkkkkbdbda
abbdkknoplokqrkkbeba
abbbkkslllotuokkbbba
abbmkkkkkvokkkkwbdba
abbblkokxooykokkbbba
afdblkotzuoztukkbdba
abbbwkokkkkkkokwbAba
abbbkkvoooBoookkbbba
aAbbkkCnooooDnkkmbfa
abbebkkkkElkkkkbdbba
abdbbbkkkllkkkbccdba
abcbbbbkkbmkkbjcbbba
acgcdbbbbdbibbcghbba
abccebdbhfbbdccbbbba
aaaaaaaaaaaaaaaaaaaa
"}
