//MAP CONVERTED BY dmm2tgm.py THIS HEADER COMMENT PREVENTS RECONVERSION, DO NOT REMOVE
"a" = (
/turf/simulated/wall,
/area/template_noop)
"b" = (
/obj/effect/floor_decal/spline/plain,
/turf/simulated/floor/water/pool{
	name = "hot tub"
	},
/area/template_noop)
"c" = (
/obj/effect/floor_decal/spline/plain{
	dir = 5
	},
/obj/item/bikehorn/rubberducky,
/turf/simulated/floor/water/pool{
	name = "hot tub"
	},
/area/template_noop)
"d" = (
/obj/machinery/atmospherics/pipe/simple/hidden/scrubbers{
	dir = 5
	},
/turf/simulated/floor/tiled/techfloor,
/area/template_noop)
"e" = (
/obj/structure/closet/crate/engineering,
/obj/item/tank/oxygen,
/obj/item/clothing/mask/gas/clear,
/obj/item/reagent_containers/glass/bucket,
/obj/random/medical/lite,
/obj/random/maintenance/clean,
/obj/random/maintenance,
/turf/simulated/floor/tiled/techfloor,
/area/template_noop)
"f" = (
/obj/structure/cable{
	icon_state = "2-8"
	},
/turf/simulated/floor/tiled/techfloor,
/area/template_noop)
"g" = (
/obj/effect/floor_decal/techfloor/orange{
	dir = 1
	},
/obj/machinery/atmospherics/pipe/simple/hidden/supply{
	dir = 4
	},
/turf/simulated/floor/tiled/techfloor,
/area/template_noop)
"i" = (
/obj/effect/floor_decal/techfloor/orange{
	dir = 8
	},
/obj/machinery/light{
	dir = 4
	},
/turf/simulated/floor/tiled/techfloor,
/area/template_noop)
"j" = (
/obj/effect/floor_decal/spline/plain{
	dir = 4
	},
/turf/simulated/floor/water/pool{
	name = "hot tub"
	},
/area/template_noop)
"l" = (
/obj/effect/floor_decal/techfloor/orange,
/turf/simulated/floor/tiled/techfloor,
/area/template_noop)
"n" = (
/obj/structure/table/rack,
/obj/item/towel/random,
/obj/item/towel/random,
/turf/simulated/floor/tiled/techfloor,
/area/template_noop)
"o" = (
/obj/machinery/door/airlock{
	name = "Construction Area"
	},
/obj/machinery/atmospherics/pipe/cap/hidden/scrubbers{
	dir = 1
	},
/turf/simulated/floor/tiled/steel_grid,
/area/template_noop)
"q" = (
/obj/machinery/pump,
/turf/simulated/floor/tiled/techfloor,
/area/template_noop)
"t" = (
/obj/effect/floor_decal/techfloor/corner{
	dir = 6
	},
/obj/effect/floor_decal/techfloor/orange/corner,
/obj/structure/sign/poster/custom{
	dir = 1;
	pixel_y = 32;
	poster_decl = /decl/poster/bay_11
	},
/turf/simulated/floor/tiled/techfloor,
/area/template_noop)
"u" = (
/obj/effect/floor_decal/techfloor/orange{
	dir = 1
	},
/obj/item/stack/tile/floor/techgrey,
/obj/machinery/atmospherics/pipe/simple/hidden/supply{
	dir = 6
	},
/obj/machinery/atmospherics/pipe/simple/hidden/scrubbers{
	dir = 10
	},
/turf/simulated/floor/tiled/techfloor,
/area/template_noop)
"w" = (
/obj/effect/floor_decal/techfloor/corner{
	dir = 10
	},
/obj/effect/floor_decal/techfloor/orange/corner{
	dir = 8
	},
/obj/item/clothing/suit/caution,
/turf/simulated/floor/tiled/techfloor,
/area/template_noop)
"x" = (
/obj/effect/floor_decal/spline/plain{
	dir = 8
	},
/turf/simulated/floor/water/pool{
	name = "hot tub"
	},
/area/template_noop)
"B" = (
/obj/effect/floor_decal/techfloor/orange{
	dir = 8
	},
/turf/simulated/floor/tiled/techfloor,
/area/template_noop)
"D" = (
/obj/machinery/light{
	dir = 8
	},
/obj/machinery/atmospherics/unary/vent_scrubber,
/turf/simulated/floor/tiled/techfloor,
/area/template_noop)
"E" = (
/turf/simulated/floor/water/pool{
	name = "hot tub"
	},
/area/template_noop)
"G" = (
/obj/machinery/atmospherics/pipe/cap/hidden/supply{
	dir = 1
	},
/obj/machinery/atmospherics/pipe/simple/hidden/scrubbers,
/turf/simulated/floor/plating,
/area/template_noop)
"H" = (
/turf/template_noop,
/area/template_noop)
"I" = (
/obj/effect/floor_decal/spline/plain{
	dir = 10
	},
/turf/simulated/floor/water/pool{
	name = "hot tub"
	},
/area/template_noop)
"J" = (
/obj/effect/floor_decal/techfloor/corner{
	dir = 5
	},
/obj/effect/floor_decal/techfloor/orange/corner{
	dir = 4
	},
/obj/machinery/atmospherics/pipe/simple/hidden/scrubbers{
	dir = 4
	},
/turf/simulated/floor/tiled/techfloor,
/area/template_noop)
"L" = (
/obj/effect/floor_decal/techfloor/corner{
	dir = 9
	},
/obj/effect/floor_decal/techfloor/orange/corner{
	dir = 1
	},
/obj/machinery/firealarm{
	dir = 4;
	pixel_x = 24
	},
/obj/machinery/atmospherics/pipe/simple/hidden/supply{
	dir = 10
	},
/turf/simulated/floor/tiled/techfloor,
/area/template_noop)
"M" = (
/obj/structure/cable{
	icon_state = "4-8"
	},
/turf/simulated/floor/plating,
/area/template_noop)
"N" = (
/obj/structure/reagent_dispensers/watertank/high,
/turf/simulated/floor/tiled/techfloor,
/area/template_noop)
"P" = (
/obj/structure/cable{
	icon_state = "1-4"
	},
/turf/template_noop,
/area/template_noop)
"Q" = (
/obj/effect/floor_decal/spline/plain{
	dir = 6
	},
/turf/simulated/floor/water/pool{
	name = "hot tub"
	},
/area/template_noop)
"R" = (
/obj/structure/closet,
/obj/random/maintenance/engineering,
/obj/random/maintenance/engineering,
/obj/random/maintenance/clean,
/turf/simulated/floor/tiled/techfloor,
/area/template_noop)
"S" = (
/obj/effect/floor_decal/spline/plain{
	dir = 1
	},
/turf/simulated/floor/water/pool{
	name = "hot tub"
	},
/area/template_noop)
"T" = (
/obj/machinery/atmospherics/unary/vent_pump{
	dir = 1
	},
/obj/structure/closet/athletic_swimwear,
/turf/simulated/floor/tiled/techfloor,
/area/template_noop)
"U" = (
/obj/machinery/space_heater,
/turf/simulated/floor/plating,
/area/template_noop)
"V" = (
/obj/structure/cable,
/obj/machinery/light_switch{
	dir = 4;
	pixel_x = -24;
	pixel_y = 12
	},
/obj/random/trash,
/obj/machinery/power/apc{
	dir = 8;
	name = "west bump";
	pixel_x = -24
	},
/obj/effect/floor_decal/steeldecal/steel_decals_central7{
	dir = 8
	},
/turf/simulated/floor/tiled/techfloor,
/area/template_noop)
"W" = (
/obj/effect/floor_decal/spline/plain{
	dir = 9
	},
/turf/simulated/floor/water/pool{
	name = "hot tub"
	},
/area/template_noop)
"Y" = (
/obj/effect/floor_decal/techfloor/orange{
	dir = 4
	},
/turf/simulated/floor/tiled/techfloor,
/area/template_noop)
"Z" = (
/obj/effect/floor_decal/techfloor/orange,
/obj/machinery/alarm{
	pixel_y = 24
	},
/turf/simulated/floor/tiled/techfloor,
/area/template_noop)

(1,1,1) = {"
H
H
P
H
a
a
a
a
"}
(2,1,1) = {"
a
a
M
a
a
U
U
a
"}
(3,1,1) = {"
a
e
f
V
D
d
q
a
"}
(4,1,1) = {"
a
t
Y
Y
Y
J
N
a
"}
(5,1,1) = {"
a
l
W
x
I
u
G
o
"}
(6,1,1) = {"
a
Z
S
E
b
g
n
a
"}
(7,1,1) = {"
a
l
c
j
Q
g
R
a
"}
(8,1,1) = {"
a
w
B
i
B
L
T
a
"}
(9,1,1) = {"
a
a
a
a
a
a
a
a
"}
