"a" = (/turf/simulated/wall,/area/template_noop)
"b" = (/obj/machinery/door/airlock{name = "Construction Area"},/obj/machinery/atmospherics/pipe/cap/hidden/scrubbers{dir = 1},/turf/simulated/floor/tiled/techfloor,/area/template_noop)
"e" = (/obj/structure/cable{icon_state = "2-8"},/turf/simulated/floor/tiled/techfloor/grid,/area/template_noop)
"k" = (/obj/structure/cable{d1 = 1; d2 = 4; icon_state = "1-4"},/turf/template_noop,/area/template_noop)
"n" = (/obj/machinery/light/small{dir = 8},/obj/machinery/atmospherics/unary/vent_scrubber,/turf/simulated/floor/tiled/techfloor/grid,/area/template_noop)
"p" = (/turf/template_noop,/area/template_noop)
"r" = (/obj/structure/salvageable/data,/turf/simulated/floor/tiled/techfloor/grid,/area/template_noop)
"s" = (/obj/machinery/atmospherics/pipe/simple/hidden/supply,/turf/simulated/floor/tiled/techfloor/grid,/area/template_noop)
"t" = (/obj/structure/cable{d1 = 4; d2 = 8; icon_state = "4-8"},/turf/simulated/floor/plating,/area/template_noop)
"v" = (/obj/machinery/atmospherics/pipe/simple/hidden/supply{dir = 9},/turf/simulated/floor/tiled/techfloor/grid,/area/template_noop)
"x" = (/obj/machinery/atmospherics/pipe/cap/hidden/supply{dir = 1},/obj/machinery/atmospherics/pipe/simple/hidden/scrubbers,/turf/simulated/floor/tiled/techfloor/grid,/area/template_noop)
"y" = (/obj/structure/bed/chair/office/dark,/obj/machinery/atmospherics/pipe/simple/hidden/scrubbers{dir = 5},/turf/simulated/floor/tiled/techfloor/grid,/area/template_noop)
"z" = (/obj/machinery/atmospherics/pipe/simple/hidden/scrubbers{dir = 4},/turf/simulated/floor/tiled/techfloor/grid,/area/template_noop)
"A" = (/obj/random/trash,/obj/machinery/atmospherics/pipe/simple/hidden/supply{dir = 4},/turf/simulated/floor/tiled/techfloor/grid,/area/template_noop)
"B" = (/obj/structure/cable,/obj/machinery/power/apc{dir = 8; name = "west bump"; pixel_x = -24},/obj/machinery/light_switch{dir = 4; pixel_x = -24; pixel_y = 12},/turf/simulated/floor/tiled/techfloor/grid,/area/template_noop)
"F" = (/obj/structure/salvageable/computer,/turf/simulated/floor/tiled/techfloor/grid,/area/template_noop)
"H" = (/turf/simulated/floor/tiled/techfloor/grid,/area/template_noop)
"J" = (/obj/machinery/light_construct/small,/turf/simulated/floor/tiled/techfloor/grid,/area/template_noop)
"K" = (/obj/structure/salvageable/server,/turf/simulated/floor/tiled/techfloor/grid,/area/template_noop)
"N" = (/obj/machinery/firealarm{dir = 1; pixel_y = -24},/obj/structure/salvageable/personal,/obj/structure/table/steel,/turf/simulated/floor/tiled/techfloor/grid,/area/template_noop)
"O" = (/obj/machinery/atmospherics/pipe/simple/hidden/supply{dir = 6},/obj/machinery/atmospherics/pipe/simple/hidden/scrubbers{dir = 10},/turf/simulated/floor/tiled/techfloor/grid,/area/template_noop)
"Q" = (/obj/random/tech_supply/component/nofail,/obj/random/tech_supply/nofail,/obj/random/tech_supply/component,/obj/random/tech_supply/component,/obj/random/tech_supply,/obj/random/tech_supply,/obj/random/maintenance,/obj/structure/sign/poster/custom{pixel_y = -32; poster_decl = /decl/poster/bay_38},/obj/structure/table/steel,/turf/simulated/floor/tiled/techfloor/grid,/area/template_noop)
"R" = (/obj/machinery/light_construct/small{dir = 1},/obj/structure/loot_pile/maint/technical,/turf/simulated/floor/tiled/techfloor/grid,/area/template_noop)
"V" = (/obj/structure/salvageable/server,/obj/machinery/alarm{pixel_y = 24},/turf/simulated/floor/tiled/techfloor/grid,/area/template_noop)
"W" = (/obj/machinery/atmospherics/unary/vent_pump,/turf/simulated/floor/tiled/techfloor/grid,/area/template_noop)
"Z" = (/obj/structure/sign/poster{dir = 8; pixel_x = -32; poster_decl = /decl/poster/bay_3},/obj/item/radio/intercom{dir = 1; pixel_y = 21},/obj/random/technology_scanner,/obj/item/bikehorn/rubberducky,/obj/structure/table/steel,/turf/simulated/floor/tiled/techfloor/grid,/area/template_noop)

(1,1,1) = {"
paaaaaaaa
paKKVKRKa
kteHHHWKa
paBKHKsKa
aanKHKsKa
aZyzOAvKa
aQNFxrJKa
aaaabaaaa
"}
