//MAP CONVERTED BY dmm2tgm.py THIS HEADER COMMENT PREVENTS RECONVERSION, DO NOT REMOVE
"a" = (
/turf/template_noop,
/area/template_noop)
"c" = (
/turf/simulated/shuttle/floor/alien/blue,
/area/om_adventure/poi/alienchamber3)
"f" = (
/obj/structure/loot_pile/surface/alien/security,
/turf/simulated/shuttle/floor/alien/blue,
/area/om_adventure/poi/alienchamber3)
"r" = (
/turf/simulated/wall/eris/r_wall,
/area/om_adventure/poi/alienchamber3)
"P" = (
/turf/simulated/shuttle/floor/alienplating/vacuum,
/area/om_adventure/poi/alienchamber3)
"V" = (
/obj/random/awayloot/looseloot,
/turf/simulated/shuttle/floor/alienplating/vacuum,
/area/om_adventure/poi/alienchamber3)
"X" = (
/obj/tether_away_spawner/spookyland,
/turf/simulated/shuttle/floor/alienplating/vacuum,
/area/om_adventure/poi/alienchamber3)

(1,1,1) = {"
a
a
a
a
a
r
r
r
a
a
a
a
a
"}
(2,1,1) = {"
a
a
a
a
r
r
P
r
r
a
a
a
a
"}
(3,1,1) = {"
a
a
a
r
r
P
P
P
r
r
a
a
a
"}
(4,1,1) = {"
a
a
r
r
P
P
c
P
P
r
r
a
a
"}
(5,1,1) = {"
a
r
r
P
V
P
X
P
V
P
r
r
a
"}
(6,1,1) = {"
r
r
P
P
P
P
c
P
P
P
P
r
r
"}
(7,1,1) = {"
r
P
P
c
X
c
f
c
X
c
P
P
r
"}
(8,1,1) = {"
r
r
P
P
P
P
c
P
P
P
P
r
r
"}
(9,1,1) = {"
a
r
r
P
P
V
X
P
P
P
r
r
a
"}
(10,1,1) = {"
a
a
r
r
P
P
c
P
P
r
r
a
a
"}
(11,1,1) = {"
a
a
a
r
r
P
P
P
r
r
a
a
a
"}
(12,1,1) = {"
a
a
a
a
r
r
P
r
r
a
a
a
a
"}
(13,1,1) = {"
a
a
a
a
a
r
r
r
a
a
a
a
a
"}
