//MAP CONVERTED BY dmm2tgm.py THIS HEADER COMMENT PREVENTS RECONVERSION, DO NOT REMOVE
"a" = (
/turf/template_noop,
/area/template_noop)
"v" = (
/turf/simulated/floor/weird_things/dark,
/area/om_adventure/poi/darktear3)
"Y" = (
/obj/tether_away_spawner/spookyland,
/turf/simulated/floor/weird_things/dark,
/area/om_adventure/poi/darktear3)

(1,1,1) = {"
a
a
a
a
a
a
a
a
a
"}
(2,1,1) = {"
v
a
a
a
a
a
a
a
a
"}
(3,1,1) = {"
a
v
v
v
a
a
a
a
v
"}
(4,1,1) = {"
a
a
v
v
v
v
v
v
a
"}
(5,1,1) = {"
a
a
v
v
Y
v
v
v
a
"}
(6,1,1) = {"
a
a
a
a
v
v
v
a
a
"}
(7,1,1) = {"
a
a
a
a
a
a
a
a
a
"}
