//MAP CONVERTED BY dmm2tgm.py THIS HEADER COMMENT PREVENTS RECONVERSION, DO NOT REMOVE
"a" = (
/turf/template_noop,
/area/template_noop)
"b" = (
/turf/simulated/floor/tiled/eris/dark/techfloor,
/area/om_adventure/poi/shippart1)
"d" = (
/obj/random/awayloot/looseloot,
/turf/simulated/floor/tiled/eris/dark/monofloor,
/area/om_adventure/poi/shippart1)
"g" = (
/turf/simulated/wall/eris/r_wall,
/area/om_adventure/poi/shippart1)
"h" = (
/obj/random/awayloot/looseloot,
/obj/effect/floor_decal/rust,
/turf/simulated/floor/plating/eris/under,
/area/om_adventure/poi/shippart1)
"i" = (
/obj/move_trader_landmark{
	dir = 4;
	trader_type = /obj/trader/general
	},
/turf/template_noop,
/area/template_noop)
"j" = (
/obj/tether_away_spawner/spookyland,
/turf/template_noop,
/area/template_noop)
"p" = (
/obj/random/awayloot/looseloot,
/turf/simulated/floor/plating/eris/under,
/area/om_adventure/poi/shippart1)
"q" = (
/obj/tether_away_spawner/spookyland,
/turf/simulated/floor/tiled/eris/dark/techfloor,
/area/om_adventure/poi/shippart1)
"r" = (
/obj/item/material/shard,
/turf/template_noop,
/area/template_noop)
"s" = (
/obj/random/tech_supply/component,
/turf/simulated/floor/tiled/eris/dark/techfloor,
/area/om_adventure/poi/shippart1)
"t" = (
/obj/structure/frame/computer,
/obj/random/tech_supply/component,
/turf/simulated/floor/tiled/eris/dark/monofloor,
/area/om_adventure/poi/shippart1)
"v" = (
/obj/effect/floor_decal/rust,
/obj/random/tech_supply/component,
/turf/simulated/floor/plating/eris/under,
/area/om_adventure/poi/shippart1)
"w" = (
/obj/effect/decal/remains/tajaran,
/turf/template_noop,
/area/template_noop)
"D" = (
/turf/simulated/floor/tiled/eris/dark/monofloor,
/area/om_adventure/poi/shippart1)
"F" = (
/turf/simulated/floor/weird_things/dark,
/area/om_adventure/poi/shippart1)
"I" = (
/obj/effect/floor_decal/rust,
/turf/simulated/floor/plating/eris/under,
/area/om_adventure/poi/shippart1)
"J" = (
/obj/structure/salvageable/bliss,
/turf/simulated/floor/tiled/eris/dark/monofloor,
/area/om_adventure/poi/shippart1)
"K" = (
/obj/move_trader_landmark{
	dir = 8;
	trader_type = /obj/trader/general
	},
/turf/template_noop,
/area/template_noop)
"M" = (
/obj/item/material/shard,
/obj/effect/floor_decal/rust,
/turf/simulated/floor/plating/eris/under,
/area/om_adventure/poi/shippart1)
"O" = (
/obj/effect/decal/remains/ribcage,
/turf/template_noop,
/area/template_noop)
"Q" = (
/obj/item/material/shard,
/turf/simulated/floor/tiled/eris/dark/monofloor,
/area/om_adventure/poi/shippart1)
"R" = (
/obj/random/tech_supply/component,
/turf/simulated/floor/tiled/eris/dark/monofloor,
/area/om_adventure/poi/shippart1)
"T" = (
/obj/item/material/shard/shrapnel,
/turf/simulated/floor/weird_things/dark,
/area/om_adventure/poi/shippart1)
"X" = (
/obj/item/material/shard/shrapnel,
/turf/template_noop,
/area/template_noop)
"Z" = (
/obj/effect/decal/remains/deer,
/turf/simulated/floor/tiled/eris/dark/monofloor,
/area/om_adventure/poi/shippart1)

(1,1,1) = {"
a
a
a
a
a
a
F
a
a
a
F
a
a
a
a
a
a
a
a
a
a
"}
(2,1,1) = {"
a
a
a
a
a
F
j
a
X
a
a
a
a
a
i
a
a
a
a
a
a
"}
(3,1,1) = {"
a
a
a
a
X
a
a
F
a
a
X
a
F
a
a
a
a
a
a
a
a
"}
(4,1,1) = {"
a
a
a
w
a
F
F
g
g
v
g
a
r
j
a
F
a
a
a
a
a
"}
(5,1,1) = {"
X
a
X
a
F
g
g
g
t
I
p
F
F
F
F
a
a
a
a
a
a
"}
(6,1,1) = {"
a
a
F
g
M
g
d
D
Z
D
I
I
F
F
F
F
F
a
a
F
F
"}
(7,1,1) = {"
a
F
T
M
t
b
q
s
b
b
b
I
I
F
F
F
F
F
a
a
a
"}
(8,1,1) = {"
a
r
F
g
I
g
R
Q
d
D
M
v
F
F
F
F
F
a
a
a
a
"}
(9,1,1) = {"
a
a
a
a
F
g
g
g
J
I
h
D
I
I
F
a
a
a
a
a
F
"}
(10,1,1) = {"
a
a
j
T
a
F
F
g
g
I
g
g
g
g
a
a
F
F
F
a
a
"}
(11,1,1) = {"
a
X
a
a
X
a
a
a
a
a
T
a
a
a
j
a
a
a
a
a
a
"}
(12,1,1) = {"
a
a
a
a
a
K
a
a
X
a
a
a
O
a
a
a
a
a
a
a
a
"}
(13,1,1) = {"
a
a
a
a
a
a
F
a
a
a
a
a
a
a
a
a
a
a
a
a
a
"}
