//MAP CONVERTED BY dmm2tgm.py THIS HEADER COMMENT PREVENTS RECONVERSION, DO NOT REMOVE
"a" = (
/turf/template_noop,
/area/template_noop)
"e" = (
/turf/simulated/floor/weird_things/dark,
/area/om_adventure/poi/shuttlewreck1)
"i" = (
/obj/machinery/door/airlock/external,
/turf/simulated/shuttle/floor/white,
/area/om_adventure/poi/shuttlewreck1)
"m" = (
/obj/structure/bed/chair/bay/shuttle{
	dir = 1
	},
/turf/simulated/shuttle/floor/white,
/area/om_adventure/poi/shuttlewreck1)
"s" = (
/obj/structure/shuttle/window,
/obj/structure/grille,
/turf/simulated/floor/plating,
/area/om_adventure/poi/shuttlewreck1)
"D" = (
/obj/structure/shuttle/engine/propulsion,
/turf/simulated/floor/plating,
/area/om_adventure/poi/shuttlewreck1)
"M" = (
/turf/simulated/shuttle/wall,
/area/om_adventure/poi/shuttlewreck1)

(1,1,1) = {"
a
a
a
a
a
a
a
a
a
"}
(2,1,1) = {"
a
a
a
e
a
a
a
e
a
"}
(3,1,1) = {"
e
e
e
e
a
e
a
a
a
"}
(4,1,1) = {"
a
e
M
M
M
M
D
e
a
"}
(5,1,1) = {"
e
e
s
m
m
i
e
e
e
"}
(6,1,1) = {"
a
e
M
M
M
M
D
e
a
"}
(7,1,1) = {"
a
e
e
e
a
e
a
a
a
"}
(8,1,1) = {"
a
a
a
a
a
a
a
a
a
"}
(9,1,1) = {"
a
a
a
a
a
a
a
a
a
"}
