"a" = (/turf/simulated/mineral/ignore_cavegen,/area/mine/explored/belt_miner)
"b" = (/turf/simulated/mineral/floor/ignore_mapgen/vacuum,/area/mine/explored/belt_miner)
"c" = (/obj/structure/closet/crate/mimic/guaranteed,/turf/simulated/mineral/floor/ignore_mapgen/vacuum,/area/mine/explored/belt_miner)
"d" = (/obj/structure/closet/crate/mimic/cointoss,/turf/simulated/mineral/floor/ignore_mapgen/vacuum,/area/mine/explored/belt_miner)
"e" = (/obj/structure/closet/crate/mimic/safe,/turf/simulated/mineral/floor/ignore_mapgen/vacuum,/area/mine/explored/belt_miner)

(1,1,1) = {"
aabbaa
acbbda
aebbea
adbbea
acedea
aaaaaa
"}
