//MAP CONVERTED BY dmm2tgm.py THIS HEADER COMMENT PREVENTS RECONVERSION, DO NOT REMOVE
"a" = (
/turf/simulated/mineral/ignore_cavegen,
/area/mine/explored/belt_miner)
"b" = (
/turf/simulated/mineral/floor/ignore_mapgen/vacuum,
/area/mine/explored/belt_miner)
"c" = (
/obj/structure/closet/crate/mimic/guaranteed,
/turf/simulated/mineral/floor/ignore_mapgen/vacuum,
/area/mine/explored/belt_miner)
"d" = (
/obj/structure/closet/crate/mimic/cointoss,
/turf/simulated/mineral/floor/ignore_mapgen/vacuum,
/area/mine/explored/belt_miner)
"e" = (
/obj/structure/closet/crate/mimic/safe,
/turf/simulated/mineral/floor/ignore_mapgen/vacuum,
/area/mine/explored/belt_miner)

(1,1,1) = {"
a
a
a
a
a
a
"}
(2,1,1) = {"
a
c
e
d
c
a
"}
(3,1,1) = {"
b
b
b
b
e
a
"}
(4,1,1) = {"
b
b
b
b
d
a
"}
(5,1,1) = {"
a
d
e
e
e
a
"}
(6,1,1) = {"
a
a
a
a
a
a
"}
