"a" = (/obj/machinery/door/airlock/sandstone,/turf/simulated/floor/airless,/area/mine/explored/belt_miner)
"b" = (/turf/simulated/wall,/area/mine/explored/belt_miner)
"c" = (/turf/simulated/floor/tiled/dark,/area/mine/explored/belt_miner)
"d" = (/obj/structure/dogbed,/turf/simulated/floor/tiled/dark,/area/mine/explored/belt_miner)
"e" = (/obj/machinery/door/airlock/sandstone,/turf/simulated/floor/tiled/dark,/area/mine/explored/belt_miner)
"f" = (/obj/machinery/mech_recharger,/turf/simulated/floor/tiled/dark,/area/mine/explored/belt_miner)
"g" = (/obj/machinery/light/flicker,/turf/simulated/floor/tiled/dark,/area/mine/explored/belt_miner)
"h" = (/obj/machinery/implantchair,/turf/simulated/floor/tiled/dark,/area/mine/explored/belt_miner)
"i" = (/obj/machinery/compressor,/turf/simulated/floor/tiled/dark,/area/mine/explored/belt_miner)
"j" = (/obj/machinery/auto_cloner,/turf/simulated/floor/tiled/dark,/area/mine/explored/belt_miner)
"k" = (/obj/structure/old_roboprinter,/turf/simulated/floor/tiled/dark,/area/mine/explored/belt_miner)
"l" = (/obj/tether_away_spawner/belt_hard,/turf/simulated/floor/tiled/dark,/area/mine/explored/belt_miner)
"m" = (/obj/tether_away_spawner/asteroid_drone_swarm,/turf/simulated/floor/tiled/dark,/area/mine/explored/belt_miner)
"n" = (/mob/living/simple_mob/vore/aggressive/corrupthound,/turf/simulated/floor/tiled/dark,/area/mine/explored/belt_miner)

(1,1,1) = {"
bbbbaabbbbaabbbb
bcceccbncbccbchb
bncbccbccbccbccb
bicbcccccccceccb
bbbbccccccccbbbb
bkcmccblcbcccccb
bfccgcbdjbcgccfb
bbbbbbbbbbbbbbbb
"}
