"a" = (/mob/living/simple_mob/animal/giant_spider/frost/space,/turf/simulated/mineral/floor/ignore_mapgen/vacuum,/area/mine/explored/belt_miner)
"b" = (/turf/simulated/mineral/ignore_cavegen,/area/mine/explored/belt_miner)
"c" = (/turf/template_noop,/area/mine/explored/belt_miner)
"d" = (/turf/simulated/mineral/floor/ignore_mapgen/vacuum,/area/mine/explored/belt_miner)
"e" = (/obj/effect/spider/spiderling/frost,/turf/simulated/mineral/floor/ignore_mapgen/vacuum,/area/mine/explored/belt_miner)
"f" = (/obj/effect/spider/stickyweb/dark,/turf/simulated/mineral/floor/ignore_mapgen/vacuum,/area/mine/explored/belt_miner)
"g" = (/obj/effect/spider/stickyweb,/turf/simulated/mineral/floor/ignore_mapgen/vacuum,/area/mine/explored/belt_miner)
"h" = (/obj/effect/decal/cleanable/spiderling_remains,/turf/simulated/mineral/floor/ignore_mapgen/vacuum,/area/mine/explored/belt_miner)
"i" = (/obj/effect/spider/eggcluster/small/frost,/turf/simulated/mineral/floor/ignore_mapgen/vacuum,/area/mine/explored/belt_miner)
"j" = (/obj/effect/spider/cocoon,/turf/simulated/mineral/floor/ignore_mapgen/vacuum,/area/mine/explored/belt_miner)

(1,1,1) = {"
bbbbbccccc
badefgcccc
bddddefccc
bddehddgcc
bgdddddegc
bghdadgdfb
bidddddddb
biddddehdb
bdaddgddjb
bbbbbbbbbb
"}
