"a" = (/turf/simulated/mineral/ignore_cavegen,/area/mine/explored/belt_miner)
"b" = (/turf/template_noop,/area/mine/explored/belt_miner)
"c" = (/turf/simulated/mineral/floor/ignore_mapgen/vacuum,/area/mine/explored/belt_miner)
"d" = (/obj/sc_away_spawner/belt_hard,/turf/simulated/mineral/floor/ignore_mapgen/vacuum,/area/mine/explored/belt_miner)

(1,1,1) = {"
aabaa
accca
bcdcb
accca
aabaa
"}
