"a" = (/turf/simulated/mineral/ignore_cavegen,/area/mine/explored/belt_miner)
"b" = (/obj/effect/spider/stickyweb/dark,/turf/simulated/mineral/floor/ignore_mapgen/vacuum,/area/mine/explored/belt_miner)
"c" = (/obj/effect/spider/stickyweb,/turf/simulated/mineral/floor/ignore_mapgen/vacuum,/area/mine/explored/belt_miner)
"d" = (/turf/simulated/mineral/floor/ignore_mapgen/vacuum,/area/mine/explored/belt_miner)
"e" = (/obj/effect/spider/spiderling,/turf/simulated/mineral/floor/ignore_mapgen/vacuum,/area/mine/explored/belt_miner)
"f" = (/mob/living/simple_mob/animal/giant_spider/thermic,/turf/simulated/mineral/floor/ignore_mapgen/vacuum,/area/mine/explored/belt_miner)
"g" = (/obj/effect/spider/eggcluster,/turf/simulated/mineral/floor/ignore_mapgen/vacuum,/area/mine/explored/belt_miner)
"h" = (/obj/effect/spider/cocoon,/turf/simulated/mineral/floor/ignore_mapgen/vacuum,/area/mine/explored/belt_miner)

(1,1,1) = {"
aabbaa
acccca
adedfa
afdega
aehgga
aaaaaa
"}
