"a" = (/turf/simulated/mineral/ignore_cavegen,/area/mine/explored/belt_miner)
"b" = (/turf/template_noop,/area/mine/explored/belt_miner)
"c" = (/turf/simulated/mineral/floor/ignore_mapgen/vacuum,/area/mine/explored/belt_miner)
"d" = (/obj/sc_away_spawner/belt_normal,/turf/simulated/mineral/floor/ignore_mapgen/vacuum,/area/mine/explored/belt_miner)

(1,1,1) = {"
bbbbbbbbacccaaaaaacccabbb
bbbbbbbbacaaaccccacccabbb
bbbbbbbbacadcccccacccabbb
bbbbbbbbacaccacccacccabbb
bbbbbbbbacaaaacaaacccaaaa
aaaaaaaaacaccccccaccccccc
ccccccccccaccccccaacccccc
ccccccccccaccaaaaaaaaaacc
aaaaaaaaccccccccccaaccacc
adccccccccccccccccaaccacc
accccccccccaaaaaacaaccacc
aaaaaaaacccaccccacaaccacc
aaaaaaaacccacddcaccaccccc
cccccccacccaccccaccaccccc
aaaaaccaccaaaaccaccaaaacc
ccccaccaccaccaccccccccacc
ccccaccaccaccaccccacccacc
aaaaacccccaccaccccccccacc
ccccacccccaccaccaaaaaaacc
ccccacccccacccccacccccccc
ccccaaaaaaacccccacccccccc
aaaaacccccccccccacccaaaaa
bbbaacccccccaaaaacccabbbb
bbbaaccaaaccacccccccabbbb
bbbaacccccccacccccccabbbb
"}
