//MAP CONVERTED BY dmm2tgm.py THIS HEADER COMMENT PREVENTS RECONVERSION, DO NOT REMOVE
"a" = (
/turf/simulated/mineral/ignore_cavegen,
/area/mine/explored/belt_miner)
"b" = (
/turf/simulated/mineral/floor/ignore_mapgen/vacuum,
/area/mine/explored/belt_miner)
"c" = (
/turf/simulated/wall,
/area/mine/explored/belt_miner)
"d" = (
/obj/sc_away_spawner/belt_normal,
/turf/simulated/mineral/floor/ignore_mapgen/vacuum,
/area/mine/explored/belt_miner)
"e" = (
/obj/structure/old_roboprinter,
/turf/simulated/floor/airless,
/area/mine/explored/belt_miner)
"f" = (
/turf/simulated/floor/airless,
/area/mine/explored/belt_miner)
"g" = (
/obj/random/unidentified_medicine/combat_medicine,
/turf/simulated/floor/airless,
/area/mine/explored/belt_miner)
"h" = (
/obj/sc_away_spawner/asteroid_drone_swarm,
/turf/simulated/floor/airless,
/area/mine/explored/belt_miner)
"i" = (
/mob/living/simple_mob/animal/giant_spider/frost/space,
/turf/simulated/mineral/floor/ignore_mapgen/vacuum,
/area/mine/explored/belt_miner)

(1,1,1) = {"
a
a
a
a
a
a
a
a
a
a
a
a
a
a
a
a
a
a
a
a
"}
(2,1,1) = {"
a
b
b
b
b
b
b
c
c
c
b
a
a
b
b
a
a
a
a
a
"}
(3,1,1) = {"
a
b
b
b
b
b
b
c
f
c
b
b
b
b
b
b
b
a
a
a
"}
(4,1,1) = {"
a
b
b
a
a
b
b
c
f
c
b
b
b
b
b
b
b
b
b
a
"}
(5,1,1) = {"
a
b
b
a
b
b
b
b
b
b
b
b
c
c
c
c
b
b
b
a
"}
(6,1,1) = {"
a
b
b
a
b
b
b
b
b
b
b
b
c
f
f
c
b
b
b
a
"}
(7,1,1) = {"
a
b
b
a
b
b
b
b
b
b
b
b
c
f
c
c
b
b
b
a
"}
(8,1,1) = {"
a
b
b
a
b
b
b
b
b
b
b
b
b
b
b
b
b
b
b
a
"}
(9,1,1) = {"
b
b
b
a
b
b
b
b
b
b
b
b
b
b
b
b
b
b
b
a
"}
(10,1,1) = {"
a
a
a
a
b
b
c
b
b
b
b
b
b
b
b
b
b
b
b
a
"}
(11,1,1) = {"
a
b
b
b
b
d
c
d
b
b
b
b
b
b
b
c
c
c
c
a
"}
(12,1,1) = {"
b
b
b
b
b
c
c
c
b
b
a
a
a
b
b
c
e
e
e
a
"}
(13,1,1) = {"
a
a
a
a
b
b
b
b
b
b
b
b
a
b
b
c
f
f
f
a
"}
(14,1,1) = {"
a
b
b
b
b
b
b
b
b
b
b
b
b
b
b
c
h
h
h
a
"}
(15,1,1) = {"
a
b
b
a
b
b
a
a
b
b
b
b
b
b
b
c
f
f
f
a
"}
(16,1,1) = {"
a
b
b
a
b
b
b
a
b
b
b
b
b
b
b
f
f
f
f
a
"}
(17,1,1) = {"
a
b
b
a
b
b
b
a
b
b
c
c
c
b
b
c
f
f
f
a
"}
(18,1,1) = {"
a
b
b
a
b
b
a
a
b
b
f
f
c
b
b
c
f
f
f
a
"}
(19,1,1) = {"
a
b
b
a
b
b
a
i
b
b
c
c
c
b
b
c
f
f
g
a
"}
(20,1,1) = {"
a
a
a
a
a
a
a
a
a
a
a
a
a
a
a
a
a
a
a
a
"}
