"a" = (/turf/simulated/mineral/vacuum,/area/mine/explored/belt_miner)
"b" = (/turf/simulated/mineral/floor/cave,/area/mine/explored/belt_miner)
"c" = (/obj/tether_away_spawner/asteroid_drone_swarm,/turf/simulated/mineral/floor/cave,/area/mine/explored/belt_miner)

(1,1,1) = {"
aaaaaa
abbbba
abbcba
abbbba
abbbba
aaaaaa
"}
