//MAP CONVERTED BY dmm2tgm.py THIS HEADER COMMENT PREVENTS RECONVERSION, DO NOT REMOVE
"a" = (
/turf/simulated/wall,
/area/template_noop)
"c" = (
/obj/effect/floor_decal/borderfloorwhite{
	dir = 4
	},
/obj/structure/table/standard,
/obj/random/maintenance/medical,
/obj/random/maintenance/medical,
/obj/effect/decal/cleanable/dirt,
/obj/effect/floor_decal/corner/lime/border{
	dir = 4
	},
/obj/item/radio/intercom/department/medbay{
	dir = 8;
	pixel_x = 21
	},
/turf/simulated/floor/tiled/old_tile/white,
/area/template_noop)
"f" = (
/obj/effect/floor_decal/borderfloorwhite{
	dir = 5
	},
/obj/machinery/light{
	dir = 1
	},
/obj/structure/disposalpipe/trunk{
	dir = 8
	},
/obj/machinery/disposal,
/obj/effect/floor_decal/corner/lime/border{
	dir = 5
	},
/obj/effect/decal/cleanable/cobweb2,
/turf/simulated/floor/tiled/old_tile/white,
/area/template_noop)
"i" = (
/obj/effect/floor_decal/borderfloorwhite{
	dir = 8
	},
/obj/structure/table/standard,
/obj/random/maintenance/medical,
/obj/item/storage/box/syringes,
/obj/effect/floor_decal/corner/lime/border{
	dir = 8
	},
/turf/simulated/floor/tiled/old_tile/white,
/area/template_noop)
"k" = (
/obj/structure/cable/green{
	icon_state = "2-8"
	},
/obj/item/stack/tile/floor/white,
/obj/machinery/atmospherics/pipe/simple/hidden/scrubbers{
	dir = 6
	},
/obj/structure/disposalpipe/broken{
	dir = 1
	},
/obj/effect/decal/cleanable/generic,
/turf/simulated/floor/plating,
/area/template_noop)
"m" = (
/obj/effect/floor_decal/borderfloorwhite{
	dir = 8
	},
/obj/structure/loot_pile/maint/trash,
/obj/effect/decal/cleanable/dirt,
/obj/effect/floor_decal/corner/lime/border{
	dir = 8
	},
/turf/simulated/floor/tiled/old_tile/white,
/area/template_noop)
"p" = (
/obj/machinery/atmospherics/pipe/simple/hidden/supply{
	icon_state = "exposed10-supply"
	},
/obj/structure/disposalpipe/segment,
/obj/item/reagent_containers/syringe{
	icon_state = "broken"
	},
/obj/effect/decal/cleanable/dirt,
/turf/simulated/floor/tiled/old_tile/white,
/area/template_noop)
"q" = (
/obj/effect/floor_decal/borderfloorwhite{
	dir = 8
	},
/obj/machinery/light,
/obj/structure/cable/green{
	dir = 8
	},
/obj/effect/decal/cleanable/ash,
/obj/effect/floor_decal/corner/lime/border{
	dir = 8
	},
/obj/item/frame/apc,
/obj/effect/floor_decal/steeldecal/steel_decals_central7{
	dir = 8
	},
/turf/simulated/floor/tiled/old_tile/white,
/area/template_noop)
"u" = (
/obj/machinery/atmospherics/pipe/simple/hidden/supply{
	dir = 6
	},
/obj/item/ruinedvirusdish,
/obj/structure/disposalpipe/segment,
/obj/effect/decal/cleanable/dirt,
/obj/effect/decal/cleanable/filth,
/turf/simulated/floor/tiled/old_tile/white,
/area/template_noop)
"w" = (
/obj/machinery/atmospherics/pipe/simple/hidden/scrubbers{
	icon_state = "exposed10-scrubbers"
	},
/obj/structure/door_assembly/door_assembly_med,
/obj/item/tape/medical,
/turf/simulated/floor/plating,
/area/template_noop)
"y" = (
/turf/simulated/wall/r_concrete,
/area/template_noop)
"z" = (
/obj/effect/floor_decal/borderfloorwhite{
	dir = 8
	},
/obj/structure/table/standard,
/obj/random/medical,
/obj/item/reagent_containers/blood/empty,
/obj/item/reagent_containers/hypospray/autoinjector/used,
/obj/item/reagent_containers/hypospray/autoinjector/used,
/obj/effect/floor_decal/corner/lime/border{
	dir = 8
	},
/obj/structure/sign/poster/custom{
	dir = 8;
	pixel_x = -32;
	poster_decl = /decl/poster/bay_39
	},
/turf/simulated/floor/tiled/old_tile/white,
/area/template_noop)
"E" = (
/obj/effect/floor_decal/borderfloorwhite{
	dir = 1
	},
/obj/structure/disposalpipe/segment{
	dir = 4;
	icon_state = "pipe-c"
	},
/obj/structure/closet/crate/trashcart,
/obj/item/paper/crumpled/bloody,
/obj/random/maintenance/medical,
/obj/item/reagent_containers/hypospray/autoinjector/used,
/obj/item/reagent_containers/hypospray/autoinjector/biginjector/expired,
/obj/effect/floor_decal/corner/lime/border{
	dir = 1
	},
/obj/machinery/alarm{
	pixel_y = 22
	},
/turf/simulated/floor/tiled/old_tile/white,
/area/template_noop)
"H" = (
/obj/effect/floor_decal/borderfloorwhite{
	dir = 4
	},
/obj/machinery/atmospherics/unary/vent_pump{
	dir = 8
	},
/obj/random/mouseremains,
/obj/effect/floor_decal/corner/lime/border{
	dir = 4
	},
/obj/machinery/firealarm{
	dir = 4;
	pixel_x = 24
	},
/turf/simulated/floor/tiled/old_tile/white,
/area/template_noop)
"J" = (
/obj/effect/floor_decal/borderfloorwhite{
	dir = 4
	},
/obj/machinery/washing_machine,
/obj/random/maintenance/medical,
/obj/effect/floor_decal/corner/lime/border{
	dir = 4
	},
/obj/item/radio/intercom{
	dir = 4;
	pixel_x = 21
	},
/turf/simulated/floor/tiled/old_tile/white,
/area/template_noop)
"K" = (
/obj/effect/floor_decal/borderfloorwhite{
	dir = 9
	},
/obj/structure/table/standard,
/obj/item/bodybag,
/obj/item/usedcryobag,
/obj/random/maintenance/medical,
/obj/effect/decal/cleanable/dirt,
/obj/effect/floor_decal/corner/lime/border{
	dir = 9
	},
/turf/simulated/floor/tiled/old_tile/white,
/area/template_noop)
"O" = (
/obj/machinery/atmospherics/pipe/simple/hidden/supply,
/obj/structure/disposalpipe/segment,
/obj/effect/decal/cleanable/dirt,
/turf/simulated/floor/tiled/old_tile/white,
/area/template_noop)
"R" = (
/turf/simulated/wall/concrete,
/area/template_noop)
"U" = (
/obj/effect/floor_decal/borderfloorwhite{
	dir = 4
	},
/obj/effect/decal/cleanable/dirt,
/obj/machinery/atmospherics/unary/vent_scrubber{
	dir = 8
	},
/obj/random/medical/lite,
/obj/effect/floor_decal/corner/lime/border{
	dir = 4
	},
/obj/structure/sink/generic{
	dir = 8;
	pixel_x = 12;
	pixel_y = -4
	},
/turf/simulated/floor/tiled/old_tile/white,
/area/template_noop)

(1,1,1) = {"
y
R
R
a
R
R
R
"}
(2,1,1) = {"
y
K
i
z
m
q
R
"}
(3,1,1) = {"
y
E
u
O
p
k
w
"}
(4,1,1) = {"
y
f
H
c
J
U
R
"}
(5,1,1) = {"
y
y
y
y
y
y
y
"}
