//MAP CONVERTED BY dmm2tgm.py THIS HEADER COMMENT PREVENTS RECONVERSION, DO NOT REMOVE
"a" = (
/turf/simulated/floor/outdoors/newdirt_nograss/virgo3c{
	outdoors = 0
	},
/area/maintenance/groundbase/poi/caves)
"b" = (
/obj/random/maintenance/misc,
/obj/random/maintenance/misc,
/turf/simulated/floor/outdoors/newdirt_nograss/virgo3c{
	outdoors = 0
	},
/area/maintenance/groundbase/poi/caves)
"g" = (
/turf/template_noop,
/area/template_noop)
"C" = (
/obj/random/trash_pile,
/turf/simulated/floor/outdoors/newdirt_nograss/virgo3c{
	outdoors = 0
	},
/area/maintenance/groundbase/poi/caves)
"Z" = (
/obj/random/maintenance/misc,
/turf/simulated/floor/outdoors/newdirt_nograss/virgo3c{
	outdoors = 0
	},
/area/maintenance/groundbase/poi/caves)

(1,1,1) = {"
a
a
Z
a
a
"}
(2,1,1) = {"
b
a
a
a
a
"}
(3,1,1) = {"
g
a
a
C
g
"}
(4,1,1) = {"
g
g
a
g
g
"}
(5,1,1) = {"
g
g
a
g
g
"}
(6,1,1) = {"
g
g
a
g
g
"}
(7,1,1) = {"
g
a
b
a
g
"}
(8,1,1) = {"
a
a
a
a
a
"}
(9,1,1) = {"
a
a
a
a
Z
"}
