//MAP CONVERTED BY dmm2tgm.py THIS HEADER COMMENT PREVENTS RECONVERSION, DO NOT REMOVE
"a" = (
/turf/template_noop,
/area/template_noop)
"i" = (
/obj/random/maintenance/misc,
/turf/simulated/floor/outdoors/newdirt_nograss{
	outdoors = 0
	},
/area/maintenance/groundbase/poi/caves)
"v" = (
/obj/random/maintenance/misc,
/obj/random/maintenance/misc,
/turf/simulated/floor/outdoors/newdirt_nograss{
	outdoors = 0
	},
/area/maintenance/groundbase/poi/caves)
"z" = (
/turf/simulated/floor/outdoors/newdirt_nograss{
	outdoors = 0
	},
/area/maintenance/groundbase/poi/caves)
"Z" = (
/obj/random/trash_pile,
/turf/simulated/floor/outdoors/newdirt_nograss{
	outdoors = 0
	},
/area/maintenance/groundbase/poi/caves)

(1,1,1) = {"
a
a
a
z
z
a
a
a
a
"}
(2,1,1) = {"
z
a
a
z
z
z
i
a
a
"}
(3,1,1) = {"
z
a
v
z
z
z
z
a
z
"}
(4,1,1) = {"
z
a
z
z
a
Z
z
z
z
"}
(5,1,1) = {"
z
z
z
a
a
a
z
z
z
"}
(6,1,1) = {"
a
z
i
a
a
a
z
v
a
"}
