//MAP CONVERTED BY dmm2tgm.py THIS HEADER COMMENT PREVENTS RECONVERSION, DO NOT REMOVE
"a" = (
/turf/template_noop,
/area/template_noop)
"m" = (
/obj/random/crate,
/turf/simulated/floor/outdoors/newdirt_nograss{
	outdoors = 0
	},
/area/maintenance/groundbase/poi/caves)
"x" = (
/obj/random/maintenance/misc,
/obj/random/maintenance/misc,
/turf/simulated/floor/outdoors/newdirt_nograss{
	outdoors = 0
	},
/area/maintenance/groundbase/poi/caves)
"z" = (
/turf/simulated/floor/outdoors/newdirt_nograss{
	outdoors = 0
	},
/area/maintenance/groundbase/poi/caves)
"K" = (
/obj/random/maintenance/misc,
/turf/simulated/floor/outdoors/newdirt_nograss{
	outdoors = 0
	},
/area/maintenance/groundbase/poi/caves)

(1,1,1) = {"
z
z
z
z
a
a
"}
(2,1,1) = {"
a
K
z
z
z
a
"}
(3,1,1) = {"
a
z
z
z
m
a
"}
(4,1,1) = {"
a
z
z
z
a
a
"}
(5,1,1) = {"
a
z
z
z
x
a
"}
(6,1,1) = {"
a
x
z
z
z
z
"}
(7,1,1) = {"
a
a
a
z
z
z
"}
(8,1,1) = {"
a
a
a
K
z
a
"}
(9,1,1) = {"
a
a
a
a
z
z
"}
