//MAP CONVERTED BY dmm2tgm.py THIS HEADER COMMENT PREVENTS RECONVERSION, DO NOT REMOVE
"a" = (
/turf/simulated/floor/outdoors/newdirt_nograss{
	outdoors = 0
	},
/area/maintenance/groundbase/poi/caves)
"c" = (
/obj/random/trash_pile,
/turf/simulated/floor/outdoors/newdirt_nograss{
	outdoors = 0
	},
/area/maintenance/groundbase/poi/caves)
"l" = (
/turf/template_noop,
/area/template_noop)
"n" = (
/obj/random/maintenance/misc,
/obj/random/maintenance/misc,
/turf/simulated/floor/outdoors/newdirt_nograss{
	outdoors = 0
	},
/area/maintenance/groundbase/poi/caves)
"F" = (
/obj/random/maintenance/misc,
/turf/simulated/floor/outdoors/newdirt_nograss{
	outdoors = 0
	},
/area/maintenance/groundbase/poi/caves)

(1,1,1) = {"
l
l
a
F
a
a
"}
(2,1,1) = {"
l
a
a
l
l
l
"}
(3,1,1) = {"
a
a
n
l
l
l
"}
(4,1,1) = {"
a
c
l
l
l
l
"}
(5,1,1) = {"
l
l
l
l
c
a
"}
(6,1,1) = {"
l
l
n
a
a
a
"}
(7,1,1) = {"
l
l
a
a
a
l
"}
(8,1,1) = {"
l
l
l
a
F
l
"}
(9,1,1) = {"
l
a
a
a
l
l
"}
