//MAP CONVERTED BY dmm2tgm.py THIS HEADER COMMENT PREVENTS RECONVERSION, DO NOT REMOVE
"a" = (
/turf/template_noop,
/area/template_noop)
"r" = (
/turf/simulated/floor/outdoors/newdirt_nograss{
	outdoors = 0
	},
/area/maintenance/groundbase/poi/caves)

(1,1,1) = {"
r
r
r
r
a
a
a
a
"}
(2,1,1) = {"
r
r
r
r
r
a
a
a
"}
(3,1,1) = {"
a
a
r
r
r
r
a
a
"}
(4,1,1) = {"
a
r
r
r
r
r
a
r
"}
(5,1,1) = {"
a
a
r
r
r
r
r
r
"}
(6,1,1) = {"
a
a
a
a
r
r
r
a
"}
