//MAP CONVERTED BY dmm2tgm.py THIS HEADER COMMENT PREVENTS RECONVERSION, DO NOT REMOVE
"a" = (
/turf/template_noop,
/area/template_noop)
"x" = (
/obj/random/maintenance/misc,
/turf/simulated/floor/outdoors/newdirt_nograss/virgo3c{
	outdoors = 0
	},
/area/maintenance/groundbase/poi/caves)
"D" = (
/turf/simulated/floor/outdoors/newdirt_nograss/virgo3c{
	outdoors = 0
	},
/area/maintenance/groundbase/poi/caves)
"F" = (
/obj/random/crate,
/obj/random/maintenance/misc,
/obj/random/maintenance/misc,
/obj/random/maintenance/misc,
/obj/random/maintenance/misc,
/turf/simulated/floor/outdoors/newdirt_nograss/virgo3c{
	outdoors = 0
	},
/area/maintenance/groundbase/poi/caves)
"J" = (
/obj/random/maintenance/misc,
/obj/random/maintenance/misc,
/turf/simulated/floor/outdoors/newdirt_nograss/virgo3c{
	outdoors = 0
	},
/area/maintenance/groundbase/poi/caves)

(1,1,1) = {"
a
a
a
a
J
D
D
a
a
"}
(2,1,1) = {"
a
a
a
D
D
D
x
a
a
"}
(3,1,1) = {"
a
a
D
D
a
a
a
a
D
"}
(4,1,1) = {"
a
D
D
a
a
a
a
D
D
"}
(5,1,1) = {"
a
D
a
a
a
a
D
D
a
"}
(6,1,1) = {"
a
D
a
a
a
x
D
a
a
"}
(7,1,1) = {"
D
D
a
F
D
D
a
a
a
"}
(8,1,1) = {"
a
D
D
D
J
a
a
a
a
"}
