//MAP CONVERTED BY dmm2tgm.py THIS HEADER COMMENT PREVENTS RECONVERSION, DO NOT REMOVE
"a" = (
/turf/template_noop,
/area/template_noop)
"x" = (
/obj/random/trash_pile,
/turf/simulated/floor/outdoors/newdirt_nograss/virgo3c{
	outdoors = 0
	},
/area/maintenance/groundbase/poi/caves)
"U" = (
/turf/simulated/floor/outdoors/newdirt_nograss/virgo3c{
	outdoors = 0
	},
/area/maintenance/groundbase/poi/caves)
"W" = (
/obj/random/maintenance/misc,
/obj/random/maintenance/misc,
/turf/simulated/floor/outdoors/newdirt_nograss/virgo3c{
	outdoors = 0
	},
/area/maintenance/groundbase/poi/caves)
"X" = (
/obj/random/maintenance/misc,
/turf/simulated/floor/outdoors/newdirt_nograss/virgo3c{
	outdoors = 0
	},
/area/maintenance/groundbase/poi/caves)

(1,1,1) = {"
a
X
U
U
U
a
"}
(2,1,1) = {"
a
U
U
U
U
W
"}
(3,1,1) = {"
U
U
U
x
U
U
"}
(4,1,1) = {"
a
W
U
U
U
U
"}
(5,1,1) = {"
a
a
a
U
X
a
"}
