//MAP CONVERTED BY dmm2tgm.py THIS HEADER COMMENT PREVENTS RECONVERSION, DO NOT REMOVE
"a" = (
/turf/template_noop,
/area/template_noop)
"d" = (
/turf/simulated/floor/outdoors/newdirt_nograss{
	outdoors = 0
	},
/area/maintenance/groundbase/poi/caves)
"j" = (
/obj/random/maintenance/misc,
/obj/random/maintenance/misc,
/turf/simulated/floor/outdoors/newdirt_nograss{
	outdoors = 0
	},
/area/maintenance/groundbase/poi/caves)
"L" = (
/obj/random/maintenance/misc,
/turf/simulated/floor/outdoors/newdirt_nograss{
	outdoors = 0
	},
/area/maintenance/groundbase/poi/caves)
"Q" = (
/obj/random/trash_pile,
/turf/simulated/floor/outdoors/newdirt_nograss{
	outdoors = 0
	},
/area/maintenance/groundbase/poi/caves)

(1,1,1) = {"
a
a
a
a
d
d
d
a
"}
(2,1,1) = {"
a
a
d
d
d
L
d
a
"}
(3,1,1) = {"
a
a
d
Q
d
d
d
a
"}
(4,1,1) = {"
a
a
d
d
d
d
d
a
"}
(5,1,1) = {"
a
a
j
a
d
d
a
a
"}
(6,1,1) = {"
a
a
a
a
a
d
d
j
"}
(7,1,1) = {"
a
a
a
a
a
d
a
d
"}
(8,1,1) = {"
d
d
d
d
d
d
d
d
"}
(9,1,1) = {"
a
L
d
d
a
d
d
a
"}
