//MAP CONVERTED BY dmm2tgm.py THIS HEADER COMMENT PREVENTS RECONVERSION, DO NOT REMOVE
"a" = (
/turf/template_noop,
/area/template_noop)
"m" = (
/obj/random/trash_pile,
/turf/simulated/floor/outdoors/newdirt_nograss{
	outdoors = 0
	},
/area/maintenance/groundbase/poi/caves)
"q" = (
/obj/random/maintenance/misc,
/turf/simulated/floor/outdoors/newdirt_nograss{
	outdoors = 0
	},
/area/maintenance/groundbase/poi/caves)
"z" = (
/obj/random/maintenance/misc,
/obj/random/maintenance/misc,
/turf/simulated/floor/outdoors/newdirt_nograss{
	outdoors = 0
	},
/area/maintenance/groundbase/poi/caves)
"B" = (
/turf/simulated/floor/outdoors/newdirt_nograss{
	outdoors = 0
	},
/area/maintenance/groundbase/poi/caves)

(1,1,1) = {"
a
B
B
B
q
B
a
"}
(2,1,1) = {"
B
q
a
a
a
B
B
"}
(3,1,1) = {"
B
a
a
B
a
a
B
"}
(4,1,1) = {"
B
a
B
m
B
a
z
"}
(5,1,1) = {"
B
a
a
B
a
a
B
"}
(6,1,1) = {"
B
B
a
a
a
B
B
"}
(7,1,1) = {"
a
z
B
B
B
B
a
"}
