//MAP CONVERTED BY dmm2tgm.py THIS HEADER COMMENT PREVENTS RECONVERSION, DO NOT REMOVE
"a" = (
/turf/template_noop,
/area/template_noop)
"B" = (
/turf/simulated/floor/outdoors/newdirt_nograss{
	outdoors = 0
	},
/area/maintenance/groundbase/poi/caves)

(1,1,1) = {"
a
B
B
B
B
B
a
"}
(2,1,1) = {"
B
B
a
a
a
B
B
"}
(3,1,1) = {"
B
a
a
B
a
a
B
"}
(4,1,1) = {"
B
a
B
B
B
a
B
"}
(5,1,1) = {"
B
a
a
B
a
a
B
"}
(6,1,1) = {"
B
B
a
a
a
B
B
"}
(7,1,1) = {"
a
B
B
B
B
B
a
"}
