//MAP CONVERTED BY dmm2tgm.py THIS HEADER COMMENT PREVENTS RECONVERSION, DO NOT REMOVE
"a" = (
/turf/template_noop,
/area/template_noop)
"o" = (
/turf/simulated/floor/outdoors/newdirt_nograss/virgo3c{
	outdoors = 0
	},
/area/maintenance/groundbase/poi/caves)

(1,1,1) = {"
a
a
a
a
o
o
a
a
a
"}
(2,1,1) = {"
o
o
o
o
o
o
o
a
a
"}
(3,1,1) = {"
o
o
o
o
o
a
o
o
a
"}
(4,1,1) = {"
a
o
a
a
o
o
o
o
o
"}
(5,1,1) = {"
a
a
a
a
a
o
o
o
a
"}
