//MAP CONVERTED BY dmm2tgm.py THIS HEADER COMMENT PREVENTS RECONVERSION, DO NOT REMOVE
"a" = (
/turf/template_noop,
/area/template_noop)
"G" = (
/obj/random/maintenance/misc,
/turf/simulated/floor/outdoors/newdirt_nograss/virgo3c{
	outdoors = 0
	},
/area/maintenance/groundbase/poi/caves)
"J" = (
/obj/random/crate,
/obj/random/maintenance/misc,
/obj/random/maintenance/misc,
/obj/random/maintenance/misc,
/obj/random/maintenance/misc,
/turf/simulated/floor/outdoors/newdirt_nograss/virgo3c{
	outdoors = 0
	},
/area/maintenance/groundbase/poi/caves)
"M" = (
/turf/simulated/floor/outdoors/newdirt_nograss/virgo3c{
	outdoors = 0
	},
/area/maintenance/groundbase/poi/caves)
"T" = (
/obj/random/maintenance/misc,
/obj/random/maintenance/misc,
/turf/simulated/floor/outdoors/newdirt_nograss/virgo3c{
	outdoors = 0
	},
/area/maintenance/groundbase/poi/caves)

(1,1,1) = {"
a
M
M
M
M
a
a
a
a
"}
(2,1,1) = {"
G
M
M
M
M
M
T
a
a
"}
(3,1,1) = {"
a
a
a
a
M
M
a
a
a
"}
(4,1,1) = {"
a
a
a
M
M
a
a
a
M
"}
(5,1,1) = {"
a
a
M
M
a
a
T
M
M
"}
(6,1,1) = {"
a
J
M
a
a
M
M
M
a
"}
(7,1,1) = {"
a
M
M
M
M
G
a
a
a
"}
(8,1,1) = {"
a
M
M
M
M
a
a
a
a
"}
(9,1,1) = {"
a
a
M
M
a
a
a
a
a
"}
