//MAP CONVERTED BY dmm2tgm.py THIS HEADER COMMENT PREVENTS RECONVERSION, DO NOT REMOVE
"a" = (
/turf/simulated/floor/outdoors/newdirt_nograss/virgo3c{
	outdoors = 0
	},
/area/maintenance/groundbase/poi/caves)
"D" = (
/obj/random/maintenance/misc,
/obj/random/maintenance/misc,
/obj/random/maintenance/misc,
/obj/random/maintenance/misc,
/obj/random/crate,
/turf/simulated/floor/outdoors/newdirt_nograss/virgo3c{
	outdoors = 0
	},
/area/maintenance/groundbase/poi/caves)
"G" = (
/obj/random/maintenance/misc,
/turf/simulated/floor/outdoors/newdirt_nograss/virgo3c{
	outdoors = 0
	},
/area/maintenance/groundbase/poi/caves)
"X" = (
/turf/template_noop,
/area/template_noop)

(1,1,1) = {"
X
X
X
X
X
a
a
"}
(2,1,1) = {"
X
a
a
a
a
a
a
"}
(3,1,1) = {"
X
a
a
G
X
X
X
"}
(4,1,1) = {"
a
a
X
X
X
D
X
"}
(5,1,1) = {"
a
X
X
X
G
a
X
"}
(6,1,1) = {"
a
X
X
X
a
a
X
"}
(7,1,1) = {"
G
a
a
a
a
G
X
"}
(8,1,1) = {"
X
X
a
a
X
X
X
"}
