//MAP CONVERTED BY dmm2tgm.py THIS HEADER COMMENT PREVENTS RECONVERSION, DO NOT REMOVE
"a" = (
/turf/template_noop,
/area/template_noop)
"l" = (
/obj/random/trash_pile,
/turf/simulated/floor/outdoors/newdirt_nograss/virgo3c{
	outdoors = 0
	},
/area/maintenance/groundbase/poi/caves)
"y" = (
/obj/random/maintenance/misc,
/turf/simulated/floor/outdoors/newdirt_nograss/virgo3c{
	outdoors = 0
	},
/area/maintenance/groundbase/poi/caves)
"D" = (
/obj/random/maintenance/misc,
/obj/random/maintenance/misc,
/turf/simulated/floor/outdoors/newdirt_nograss/virgo3c{
	outdoors = 0
	},
/area/maintenance/groundbase/poi/caves)
"I" = (
/turf/simulated/floor/outdoors/newdirt_nograss/virgo3c{
	outdoors = 0
	},
/area/maintenance/groundbase/poi/caves)

(1,1,1) = {"
a
a
a
a
a
I
a
a
a
"}
(2,1,1) = {"
a
a
a
I
I
I
y
a
I
"}
(3,1,1) = {"
I
D
I
I
I
I
I
I
I
"}
(4,1,1) = {"
a
a
I
I
a
I
I
I
a
"}
(5,1,1) = {"
a
a
I
I
l
a
I
I
a
"}
(6,1,1) = {"
a
a
I
I
a
I
I
I
a
"}
(7,1,1) = {"
I
I
I
I
I
I
I
D
I
"}
(8,1,1) = {"
a
a
a
y
I
I
I
a
I
"}
(9,1,1) = {"
a
a
a
a
a
I
a
a
a
"}
