//MAP CONVERTED BY dmm2tgm.py THIS HEADER COMMENT PREVENTS RECONVERSION, DO NOT REMOVE
"a" = (
/turf/template_noop,
/area/template_noop)
"y" = (
/obj/random/maintenance/misc,
/obj/random/maintenance/misc,
/turf/simulated/floor/outdoors/newdirt_nograss{
	outdoors = 0
	},
/area/maintenance/groundbase/poi/caves)
"z" = (
/turf/simulated/floor/outdoors/newdirt_nograss{
	outdoors = 0
	},
/area/maintenance/groundbase/poi/caves)
"E" = (
/obj/random/maintenance/misc,
/turf/simulated/floor/outdoors/newdirt_nograss{
	outdoors = 0
	},
/area/maintenance/groundbase/poi/caves)
"F" = (
/obj/random/trash_pile,
/turf/simulated/floor/outdoors/newdirt_nograss{
	outdoors = 0
	},
/area/maintenance/groundbase/poi/caves)

(1,1,1) = {"
z
z
z
z
a
a
"}
(2,1,1) = {"
a
z
z
z
E
a
"}
(3,1,1) = {"
a
z
z
z
z
a
"}
(4,1,1) = {"
a
y
z
z
a
a
"}
(5,1,1) = {"
a
z
z
z
z
a
"}
(6,1,1) = {"
a
F
z
z
z
z
"}
(7,1,1) = {"
a
a
a
z
z
y
"}
(8,1,1) = {"
a
a
a
E
z
a
"}
(9,1,1) = {"
a
a
a
a
z
z
"}
