//MAP CONVERTED BY dmm2tgm.py THIS HEADER COMMENT PREVENTS RECONVERSION, DO NOT REMOVE
"a" = (
/turf/simulated/floor/outdoors/newdirt_nograss/virgo3c{
	outdoors = 0
	},
/area/maintenance/groundbase/poi/caves)
"u" = (
/obj/random/maintenance/misc,
/turf/simulated/floor/outdoors/newdirt_nograss/virgo3c{
	outdoors = 0
	},
/area/maintenance/groundbase/poi/caves)
"K" = (
/turf/template_noop,
/area/template_noop)
"Q" = (
/obj/random/maintenance/misc,
/obj/random/maintenance/misc,
/obj/random/maintenance/misc,
/obj/random/maintenance/misc,
/obj/random/crate,
/turf/simulated/floor/outdoors/newdirt_nograss/virgo3c{
	outdoors = 0
	},
/area/maintenance/groundbase/poi/caves)
"X" = (
/obj/random/maintenance/misc,
/obj/random/maintenance/misc,
/turf/simulated/floor/outdoors/newdirt_nograss/virgo3c{
	outdoors = 0
	},
/area/maintenance/groundbase/poi/caves)

(1,1,1) = {"
K
K
a
K
K
K
a
u
"}
(2,1,1) = {"
K
a
a
a
K
K
K
a
"}
(3,1,1) = {"
a
a
K
a
a
X
K
a
"}
(4,1,1) = {"
a
K
K
a
Q
a
K
a
"}
(5,1,1) = {"
a
K
K
u
a
K
K
a
"}
(6,1,1) = {"
a
a
K
K
K
K
a
a
"}
(7,1,1) = {"
a
a
a
K
K
a
a
a
"}
(8,1,1) = {"
K
X
a
a
a
a
a
K
"}
