//MAP CONVERTED BY dmm2tgm.py THIS HEADER COMMENT PREVENTS RECONVERSION, DO NOT REMOVE
"a" = (
/turf/template_noop,
/area/template_noop)
"l" = (
/obj/random/maintenance/misc,
/turf/simulated/floor/outdoors/newdirt_nograss/virgo3c{
	outdoors = 0
	},
/area/maintenance/groundbase/poi/caves)
"s" = (
/obj/random/maintenance/misc,
/obj/random/maintenance/misc,
/turf/simulated/floor/outdoors/newdirt_nograss/virgo3c{
	outdoors = 0
	},
/area/maintenance/groundbase/poi/caves)
"t" = (
/obj/random/crate,
/obj/random/maintenance/misc,
/obj/random/maintenance/misc,
/obj/random/maintenance/misc,
/obj/random/maintenance/misc,
/turf/simulated/floor/outdoors/newdirt_nograss/virgo3c{
	outdoors = 0
	},
/area/maintenance/groundbase/poi/caves)
"U" = (
/turf/simulated/floor/outdoors/newdirt_nograss/virgo3c{
	outdoors = 0
	},
/area/maintenance/groundbase/poi/caves)

(1,1,1) = {"
a
U
U
U
U
a
"}
(2,1,1) = {"
a
t
U
s
U
U
"}
(3,1,1) = {"
l
U
U
U
U
l
"}
(4,1,1) = {"
a
U
U
s
U
U
"}
(5,1,1) = {"
a
a
a
U
U
a
"}
