//MAP CONVERTED BY dmm2tgm.py THIS HEADER COMMENT PREVENTS RECONVERSION, DO NOT REMOVE
"a" = (
/turf/simulated/floor/outdoors/newdirt_nograss/virgo3c{
	outdoors = 0
	},
/area/maintenance/groundbase/poi/caves)
"g" = (
/turf/template_noop,
/area/template_noop)
"z" = (
/obj/random/maintenance/misc,
/obj/random/maintenance/misc,
/obj/random/maintenance/misc,
/obj/random/maintenance/misc,
/obj/random/crate,
/turf/simulated/floor/outdoors/newdirt_nograss/virgo3c{
	outdoors = 0
	},
/area/maintenance/groundbase/poi/caves)
"R" = (
/obj/random/maintenance/misc,
/turf/simulated/floor/outdoors/newdirt_nograss/virgo3c{
	outdoors = 0
	},
/area/maintenance/groundbase/poi/caves)
"T" = (
/obj/random/maintenance/misc,
/obj/random/maintenance/misc,
/turf/simulated/floor/outdoors/newdirt_nograss/virgo3c{
	outdoors = 0
	},
/area/maintenance/groundbase/poi/caves)

(1,1,1) = {"
g
g
g
g
g
g
g
g
a
"}
(2,1,1) = {"
g
g
g
g
g
g
g
R
a
"}
(3,1,1) = {"
g
g
g
g
g
g
z
a
a
"}
(4,1,1) = {"
g
g
g
g
a
a
a
a
a
"}
(5,1,1) = {"
g
R
a
a
a
T
a
a
a
"}
(6,1,1) = {"
a
a
a
a
a
a
a
a
a
"}
(7,1,1) = {"
g
g
g
g
g
g
g
R
a
"}
(8,1,1) = {"
g
g
g
g
g
g
g
a
g
"}
