//MAP CONVERTED BY dmm2tgm.py THIS HEADER COMMENT PREVENTS RECONVERSION, DO NOT REMOVE
"a" = (
/turf/template_noop,
/area/template_noop)
"E" = (
/obj/random/maintenance/misc,
/obj/random/maintenance/misc,
/turf/simulated/floor/outdoors/newdirt_nograss{
	outdoors = 0
	},
/area/maintenance/groundbase/poi/caves)
"L" = (
/obj/random/trash_pile,
/turf/simulated/floor/outdoors/newdirt_nograss{
	outdoors = 0
	},
/area/maintenance/groundbase/poi/caves)
"S" = (
/turf/simulated/floor/outdoors/newdirt_nograss{
	outdoors = 0
	},
/area/maintenance/groundbase/poi/caves)
"Y" = (
/obj/random/maintenance/misc,
/turf/simulated/floor/outdoors/newdirt_nograss{
	outdoors = 0
	},
/area/maintenance/groundbase/poi/caves)

(1,1,1) = {"
a
S
S
a
a
a
S
a
a
"}
(2,1,1) = {"
S
S
a
a
a
E
S
a
a
"}
(3,1,1) = {"
S
S
a
a
S
S
S
a
a
"}
(4,1,1) = {"
a
S
a
L
S
S
S
a
a
"}
(5,1,1) = {"
a
Y
S
S
S
S
S
Y
a
"}
(6,1,1) = {"
a
a
a
S
S
a
a
S
a
"}
(7,1,1) = {"
a
a
S
S
E
a
a
S
S
"}
(8,1,1) = {"
a
S
S
a
a
a
a
a
S
"}
(9,1,1) = {"
a
S
a
a
a
a
a
a
a
"}
