//MAP CONVERTED BY dmm2tgm.py THIS HEADER COMMENT PREVENTS RECONVERSION, DO NOT REMOVE
"a" = (
/turf/simulated/floor/outdoors/newdirt_nograss/virgo3c{
	outdoors = 0
	},
/area/maintenance/groundbase/poi/caves)
"j" = (
/obj/random/maintenance/misc,
/turf/simulated/floor/outdoors/newdirt_nograss/virgo3c{
	outdoors = 0
	},
/area/maintenance/groundbase/poi/caves)
"t" = (
/obj/random/maintenance/misc,
/obj/random/maintenance/misc,
/turf/simulated/floor/outdoors/newdirt_nograss/virgo3c{
	outdoors = 0
	},
/area/maintenance/groundbase/poi/caves)
"Q" = (
/turf/template_noop,
/area/template_noop)
"T" = (
/obj/random/crate,
/obj/random/maintenance/misc,
/obj/random/maintenance/misc,
/obj/random/maintenance/misc,
/obj/random/maintenance/misc,
/obj/random/maintenance/misc,
/turf/simulated/floor/outdoors/newdirt_nograss/virgo3c{
	outdoors = 0
	},
/area/maintenance/groundbase/poi/caves)

(1,1,1) = {"
Q
Q
Q
Q
Q
Q
a
a
a
"}
(2,1,1) = {"
Q
Q
Q
t
a
a
a
j
Q
"}
(3,1,1) = {"
Q
a
Q
a
a
a
Q
Q
Q
"}
(4,1,1) = {"
a
a
a
a
a
Q
Q
Q
Q
"}
(5,1,1) = {"
a
j
a
a
Q
Q
Q
Q
Q
"}
(6,1,1) = {"
a
a
a
a
T
Q
Q
Q
Q
"}
(7,1,1) = {"
Q
Q
Q
a
a
a
Q
Q
Q
"}
(8,1,1) = {"
Q
Q
Q
Q
Q
a
t
a
Q
"}
(9,1,1) = {"
Q
Q
Q
Q
Q
Q
a
a
a
"}
