//MAP CONVERTED BY dmm2tgm.py THIS HEADER COMMENT PREVENTS RECONVERSION, DO NOT REMOVE
"a" = (
/turf/simulated/floor/outdoors/newdirt_nograss/virgo3c{
	outdoors = 0
	},
/area/maintenance/groundbase/poi/caves)
"q" = (
/obj/random/crate,
/turf/simulated/floor/outdoors/newdirt_nograss/virgo3c{
	outdoors = 0
	},
/area/maintenance/groundbase/poi/caves)
"t" = (
/turf/template_noop,
/area/template_noop)
"T" = (
/obj/random/maintenance/misc,
/obj/random/maintenance/misc,
/turf/simulated/floor/outdoors/newdirt_nograss/virgo3c{
	outdoors = 0
	},
/area/maintenance/groundbase/poi/caves)
"Z" = (
/obj/random/maintenance/misc,
/turf/simulated/floor/outdoors/newdirt_nograss/virgo3c{
	outdoors = 0
	},
/area/maintenance/groundbase/poi/caves)

(1,1,1) = {"
t
t
T
a
a
"}
(2,1,1) = {"
t
t
t
a
a
"}
(3,1,1) = {"
t
t
a
a
a
"}
(4,1,1) = {"
Z
a
a
q
t
"}
(5,1,1) = {"
a
a
a
t
t
"}
(6,1,1) = {"
t
a
a
Z
t
"}
(7,1,1) = {"
t
a
a
t
t
"}
(8,1,1) = {"
a
a
a
t
t
"}
(9,1,1) = {"
a
a
a
T
t
"}
