//MAP CONVERTED BY dmm2tgm.py THIS HEADER COMMENT PREVENTS RECONVERSION, DO NOT REMOVE
"a" = (
/turf/template_noop,
/area/template_noop)
"y" = (
/turf/simulated/floor/outdoors/newdirt_nograss/virgo3c{
	outdoors = 0
	},
/area/maintenance/groundbase/poi/caves)

(1,1,1) = {"
a
y
y
y
a
a
"}
(2,1,1) = {"
a
y
a
y
y
a
"}
(3,1,1) = {"
y
y
a
y
y
a
"}
(4,1,1) = {"
a
y
y
y
y
y
"}
