//MAP CONVERTED BY dmm2tgm.py THIS HEADER COMMENT PREVENTS RECONVERSION, DO NOT REMOVE
"a" = (
/turf/simulated/floor/outdoors/newdirt_nograss/virgo3c{
	outdoors = 0
	},
/area/maintenance/groundbase/poi/caves)
"o" = (
/obj/random/trash_pile,
/turf/simulated/floor/outdoors/newdirt_nograss/virgo3c{
	outdoors = 0
	},
/area/maintenance/groundbase/poi/caves)
"w" = (
/obj/random/maintenance/misc,
/turf/simulated/floor/outdoors/newdirt_nograss/virgo3c{
	outdoors = 0
	},
/area/maintenance/groundbase/poi/caves)
"y" = (
/obj/random/maintenance/misc,
/obj/random/maintenance/misc,
/turf/simulated/floor/outdoors/newdirt_nograss/virgo3c{
	outdoors = 0
	},
/area/maintenance/groundbase/poi/caves)
"B" = (
/turf/template_noop,
/area/template_noop)

(1,1,1) = {"
B
B
B
B
B
a
a
"}
(2,1,1) = {"
B
B
a
a
a
y
B
"}
(3,1,1) = {"
B
B
o
a
a
B
B
"}
(4,1,1) = {"
B
B
B
a
a
a
B
"}
(5,1,1) = {"
B
w
a
a
a
B
B
"}
(6,1,1) = {"
B
a
a
a
a
B
B
"}
(7,1,1) = {"
B
B
a
a
w
B
B
"}
(8,1,1) = {"
B
y
a
a
B
B
B
"}
(9,1,1) = {"
a
a
a
a
B
B
B
"}
