//MAP CONVERTED BY dmm2tgm.py THIS HEADER COMMENT PREVENTS RECONVERSION, DO NOT REMOVE
"a" = (
/turf/template_noop,
/area/template_noop)
"r" = (
/obj/random/trash_pile,
/turf/simulated/floor/outdoors/newdirt_nograss{
	outdoors = 0
	},
/area/maintenance/groundbase/poi/caves)
"w" = (
/obj/random/maintenance/misc,
/turf/simulated/floor/outdoors/newdirt_nograss{
	outdoors = 0
	},
/area/maintenance/groundbase/poi/caves)
"z" = (
/turf/simulated/floor/outdoors/newdirt_nograss{
	outdoors = 0
	},
/area/maintenance/groundbase/poi/caves)
"P" = (
/obj/random/maintenance/misc,
/obj/random/maintenance/misc,
/turf/simulated/floor/outdoors/newdirt_nograss{
	outdoors = 0
	},
/area/maintenance/groundbase/poi/caves)

(1,1,1) = {"
a
z
w
z
a
"}
(2,1,1) = {"
a
z
a
z
a
"}
(3,1,1) = {"
a
P
z
z
z
"}
(4,1,1) = {"
z
z
r
z
z
"}
(5,1,1) = {"
w
a
a
a
P
"}
