//MAP CONVERTED BY dmm2tgm.py THIS HEADER COMMENT PREVENTS RECONVERSION, DO NOT REMOVE
"a" = (
/turf/simulated/floor/outdoors/newdirt_nograss{
	outdoors = 0
	},
/area/maintenance/groundbase/poi/caves)
"d" = (
/turf/template_noop,
/area/template_noop)
"g" = (
/obj/random/trash_pile,
/turf/simulated/floor/outdoors/newdirt_nograss{
	outdoors = 0
	},
/area/maintenance/groundbase/poi/caves)
"n" = (
/obj/random/maintenance/misc,
/obj/random/maintenance/misc,
/turf/simulated/floor/outdoors/newdirt_nograss{
	outdoors = 0
	},
/area/maintenance/groundbase/poi/caves)
"U" = (
/obj/random/maintenance/misc,
/turf/simulated/floor/outdoors/newdirt_nograss{
	outdoors = 0
	},
/area/maintenance/groundbase/poi/caves)

(1,1,1) = {"
a
a
a
d
d
d
a
a
a
"}
(2,1,1) = {"
d
a
a
U
d
d
n
a
a
"}
(3,1,1) = {"
d
a
a
a
d
d
d
a
d
"}
(4,1,1) = {"
d
a
a
a
d
d
d
a
d
"}
(5,1,1) = {"
d
a
g
a
d
d
d
a
d
"}
(6,1,1) = {"
d
n
a
a
d
d
a
a
d
"}
(7,1,1) = {"
d
a
a
a
a
a
a
d
d
"}
(8,1,1) = {"
d
a
a
a
U
a
d
d
d
"}
