//MAP CONVERTED BY dmm2tgm.py THIS HEADER COMMENT PREVENTS RECONVERSION, DO NOT REMOVE
"a" = (
/turf/simulated/floor/outdoors/newdirt_nograss{
	outdoors = 0
	},
/area/maintenance/groundbase/poi/caves)
"f" = (
/obj/random/maintenance/misc,
/turf/simulated/floor/outdoors/newdirt_nograss{
	outdoors = 0
	},
/area/maintenance/groundbase/poi/caves)
"k" = (
/obj/random/maintenance/misc,
/obj/random/maintenance/misc,
/turf/simulated/floor/outdoors/newdirt_nograss{
	outdoors = 0
	},
/area/maintenance/groundbase/poi/caves)
"n" = (
/obj/random/trash_pile,
/turf/simulated/floor/outdoors/newdirt_nograss{
	outdoors = 0
	},
/area/maintenance/groundbase/poi/caves)
"K" = (
/turf/template_noop,
/area/template_noop)

(1,1,1) = {"
K
K
a
K
K
K
a
a
"}
(2,1,1) = {"
K
f
a
a
K
K
K
a
"}
(3,1,1) = {"
a
a
K
a
a
k
K
a
"}
(4,1,1) = {"
a
K
K
a
n
a
K
a
"}
(5,1,1) = {"
a
K
K
f
a
K
K
a
"}
(6,1,1) = {"
a
a
K
K
K
K
a
a
"}
(7,1,1) = {"
a
a
a
K
K
a
a
k
"}
(8,1,1) = {"
K
a
a
a
a
a
a
K
"}
