//MAP CONVERTED BY dmm2tgm.py THIS HEADER COMMENT PREVENTS RECONVERSION, DO NOT REMOVE
"a" = (
/turf/simulated/floor/outdoors/newdirt_nograss/virgo3c{
	outdoors = 0
	},
/area/maintenance/groundbase/poi/caves)
"j" = (
/turf/template_noop,
/area/template_noop)

(1,1,1) = {"
j
j
j
j
a
a
a
"}
(2,1,1) = {"
j
a
a
a
a
a
a
"}
(3,1,1) = {"
a
a
a
a
a
a
a
"}
(4,1,1) = {"
j
a
a
a
a
a
a
"}
(5,1,1) = {"
j
j
j
j
a
a
a
"}
