//MAP CONVERTED BY dmm2tgm.py THIS HEADER COMMENT PREVENTS RECONVERSION, DO NOT REMOVE
"a" = (
/turf/simulated/floor/outdoors/newdirt_nograss{
	outdoors = 0
	},
/area/maintenance/groundbase/poi/caves)
"f" = (
/obj/random/maintenance/misc,
/obj/random/maintenance/misc,
/turf/simulated/floor/outdoors/newdirt_nograss{
	outdoors = 0
	},
/area/maintenance/groundbase/poi/caves)
"t" = (
/obj/random/maintenance/misc,
/turf/simulated/floor/outdoors/newdirt_nograss{
	outdoors = 0
	},
/area/maintenance/groundbase/poi/caves)
"F" = (
/obj/random/trash_pile,
/turf/simulated/floor/outdoors/newdirt_nograss{
	outdoors = 0
	},
/area/maintenance/groundbase/poi/caves)
"Q" = (
/turf/template_noop,
/area/template_noop)

(1,1,1) = {"
Q
Q
Q
Q
Q
Q
a
a
a
"}
(2,1,1) = {"
Q
Q
Q
a
a
a
a
a
Q
"}
(3,1,1) = {"
Q
f
Q
a
a
f
Q
Q
Q
"}
(4,1,1) = {"
a
a
a
a
a
Q
Q
Q
Q
"}
(5,1,1) = {"
a
a
a
a
Q
Q
Q
Q
Q
"}
(6,1,1) = {"
a
a
a
a
t
Q
Q
Q
Q
"}
(7,1,1) = {"
Q
Q
Q
F
a
a
Q
Q
Q
"}
(8,1,1) = {"
Q
Q
Q
Q
Q
a
a
t
Q
"}
(9,1,1) = {"
Q
Q
Q
Q
Q
Q
a
a
a
"}
