//MAP CONVERTED BY dmm2tgm.py THIS HEADER COMMENT PREVENTS RECONVERSION, DO NOT REMOVE
"a" = (
/turf/template_noop,
/area/template_noop)
"v" = (
/obj/random/maintenance/misc,
/obj/random/maintenance/misc,
/turf/simulated/floor/outdoors/newdirt_nograss{
	outdoors = 0
	},
/area/maintenance/groundbase/poi/caves)
"F" = (
/obj/random/maintenance/misc,
/turf/simulated/floor/outdoors/newdirt_nograss{
	outdoors = 0
	},
/area/maintenance/groundbase/poi/caves)
"S" = (
/obj/random/crate,
/obj/random/maintenance/misc,
/obj/random/maintenance/misc,
/obj/random/maintenance/misc,
/obj/random/maintenance/misc,
/turf/simulated/floor/outdoors/newdirt_nograss{
	outdoors = 0
	},
/area/maintenance/groundbase/poi/caves)
"Z" = (
/turf/simulated/floor/outdoors/newdirt_nograss{
	outdoors = 0
	},
/area/maintenance/groundbase/poi/caves)

(1,1,1) = {"
a
a
Z
Z
Z
a
a
a
"}
(2,1,1) = {"
a
Z
Z
Z
v
a
a
a
"}
(3,1,1) = {"
a
a
Z
Z
Z
a
a
a
"}
(4,1,1) = {"
Z
Z
Z
Z
Z
S
a
a
"}
(5,1,1) = {"
Z
a
F
Z
Z
Z
Z
a
"}
(6,1,1) = {"
a
a
a
a
Z
Z
Z
a
"}
(7,1,1) = {"
a
a
a
a
a
a
Z
F
"}
(8,1,1) = {"
a
a
a
a
a
a
Z
Z
"}
(9,1,1) = {"
a
a
a
a
a
a
v
a
"}
