//MAP CONVERTED BY dmm2tgm.py THIS HEADER COMMENT PREVENTS RECONVERSION, DO NOT REMOVE
"a" = (
/turf/template_noop,
/area/template_noop)
"q" = (
/obj/random/trash_pile,
/turf/simulated/floor/outdoors/newdirt_nograss{
	outdoors = 0
	},
/area/maintenance/groundbase/poi/caves)
"y" = (
/turf/simulated/floor/outdoors/newdirt_nograss{
	outdoors = 0
	},
/area/maintenance/groundbase/poi/caves)
"E" = (
/obj/random/maintenance/misc,
/obj/random/maintenance/misc,
/turf/simulated/floor/outdoors/newdirt_nograss{
	outdoors = 0
	},
/area/maintenance/groundbase/poi/caves)
"W" = (
/obj/random/maintenance/misc,
/turf/simulated/floor/outdoors/newdirt_nograss{
	outdoors = 0
	},
/area/maintenance/groundbase/poi/caves)

(1,1,1) = {"
a
y
y
W
a
a
"}
(2,1,1) = {"
a
W
a
y
q
a
"}
(3,1,1) = {"
y
y
a
E
y
a
"}
(4,1,1) = {"
a
y
y
y
y
E
"}
