//MAP CONVERTED BY dmm2tgm.py THIS HEADER COMMENT PREVENTS RECONVERSION, DO NOT REMOVE
"a" = (
/turf/simulated/floor/outdoors/newdirt_nograss/virgo3c{
	outdoors = 0
	},
/area/maintenance/groundbase/poi/caves)
"D" = (
/turf/template_noop,
/area/template_noop)
"H" = (
/obj/random/maintenance/misc,
/obj/random/maintenance/misc,
/turf/simulated/floor/outdoors/newdirt_nograss/virgo3c{
	outdoors = 0
	},
/area/maintenance/groundbase/poi/caves)
"N" = (
/obj/random/maintenance/misc,
/turf/simulated/floor/outdoors/newdirt_nograss/virgo3c{
	outdoors = 0
	},
/area/maintenance/groundbase/poi/caves)
"R" = (
/obj/random/maintenance/misc,
/obj/random/maintenance/misc,
/obj/random/maintenance/misc,
/obj/random/maintenance/misc,
/obj/random/crate,
/turf/simulated/floor/outdoors/newdirt_nograss/virgo3c{
	outdoors = 0
	},
/area/maintenance/groundbase/poi/caves)

(1,1,1) = {"
D
D
D
D
a
a
"}
(2,1,1) = {"
D
R
a
a
N
a
"}
(3,1,1) = {"
D
D
D
H
a
a
"}
(4,1,1) = {"
D
D
D
a
a
D
"}
(5,1,1) = {"
D
D
D
D
a
D
"}
(6,1,1) = {"
D
D
D
D
a
H
"}
(7,1,1) = {"
D
D
D
D
a
a
"}
(8,1,1) = {"
a
a
N
a
a
D
"}
(9,1,1) = {"
D
a
a
a
D
D
"}
