//MAP CONVERTED BY dmm2tgm.py THIS HEADER COMMENT PREVENTS RECONVERSION, DO NOT REMOVE
"a" = (
/turf/template_noop,
/area/template_noop)
"U" = (
/turf/simulated/floor/outdoors/newdirt_nograss{
	outdoors = 0
	},
/area/maintenance/groundbase/poi/caves)

(1,1,1) = {"
a
U
U
U
U
a
"}
(2,1,1) = {"
a
U
U
U
U
U
"}
(3,1,1) = {"
U
U
U
U
U
U
"}
(4,1,1) = {"
a
U
U
U
U
U
"}
(5,1,1) = {"
a
a
a
U
U
a
"}
