//MAP CONVERTED BY dmm2tgm.py THIS HEADER COMMENT PREVENTS RECONVERSION, DO NOT REMOVE
"a" = (
/turf/simulated/floor/outdoors/newdirt_nograss{
	outdoors = 0
	},
/area/maintenance/groundbase/poi/caves)
"b" = (
/turf/template_noop,
/area/template_noop)
"f" = (
/obj/random/maintenance/misc,
/obj/random/maintenance/misc,
/turf/simulated/floor/outdoors/newdirt_nograss{
	outdoors = 0
	},
/area/maintenance/groundbase/poi/caves)
"n" = (
/obj/random/maintenance/misc,
/turf/simulated/floor/outdoors/newdirt_nograss{
	outdoors = 0
	},
/area/maintenance/groundbase/poi/caves)
"H" = (
/obj/random/trash_pile,
/turf/simulated/floor/outdoors/newdirt_nograss{
	outdoors = 0
	},
/area/maintenance/groundbase/poi/caves)

(1,1,1) = {"
b
b
a
a
b
b
b
a
a
"}
(2,1,1) = {"
b
a
a
a
b
b
n
a
b
"}
(3,1,1) = {"
a
a
f
b
b
b
a
a
b
"}
(4,1,1) = {"
a
a
b
b
b
b
b
a
a
"}
(5,1,1) = {"
a
b
b
b
b
b
b
b
a
"}
(6,1,1) = {"
a
b
b
b
b
n
b
b
a
"}
(7,1,1) = {"
b
b
b
b
a
a
a
b
b
"}
(8,1,1) = {"
b
b
b
f
a
H
a
a
b
"}
(9,1,1) = {"
b
a
a
a
b
b
b
a
a
"}
