//MAP CONVERTED BY dmm2tgm.py THIS HEADER COMMENT PREVENTS RECONVERSION, DO NOT REMOVE
"a" = (
/turf/template_noop,
/area/template_noop)
"c" = (
/obj/structure/table/bench/sifwooden,
/turf/simulated/floor/outdoors/newdirt/virgo3c,
/area/groundbase/poi/outdoor)
"j" = (
/turf/simulated/floor/outdoors/newdirt/virgo3c,
/area/groundbase/poi/outdoor)
"l" = (
/obj/structure/flora/tree/bigtree,
/turf/simulated/floor/outdoors/newdirt/virgo3c,
/area/groundbase/poi/outdoor)
"Q" = (
/turf/simulated/floor/outdoors/grass/virgo3c,
/area/groundbase/poi/outdoor)

(1,1,1) = {"
a
a
Q
a
a
"}
(2,1,1) = {"
a
Q
j
Q
a
"}
(3,1,1) = {"
Q
c
c
c
Q
"}
(4,1,1) = {"
Q
c
l
c
Q
"}
(5,1,1) = {"
Q
c
c
c
Q
"}
(6,1,1) = {"
a
Q
j
Q
a
"}
(7,1,1) = {"
a
a
Q
a
a
"}
