//MAP CONVERTED BY dmm2tgm.py THIS HEADER COMMENT PREVENTS RECONVERSION, DO NOT REMOVE
"a" = (
/turf/template_noop,
/area/template_noop)
"b" = (
/turf/simulated/wall/wood,
/area/submap/groundbase/poi/outdoor/cabin4)
"d" = (
/turf/simulated/floor/outdoors/grass/seasonal/notrees_nomobs,
/area/submap/groundbase/poi/outdoor)
"l" = (
/obj/structure/bed/chair/sofa/left/brown,
/turf/simulated/floor/wood,
/area/submap/groundbase/poi/outdoor/cabin4)
"q" = (
/obj/structure/grille,
/obj/structure/window/reinforced/full,
/turf/simulated/floor,
/area/submap/groundbase/poi/outdoor/cabin4)
"s" = (
/obj/structure/bed/chair/sofa/right/brown,
/turf/simulated/floor/wood,
/area/submap/groundbase/poi/outdoor/cabin4)
"u" = (
/obj/structure/bed/chair/sofa/right/brown{
	dir = 4
	},
/turf/simulated/floor/wood,
/area/submap/groundbase/poi/outdoor/cabin4)
"x" = (
/obj/structure/table/glass,
/turf/simulated/floor/wood,
/area/submap/groundbase/poi/outdoor/cabin4)
"D" = (
/obj/random/maintenance/misc,
/obj/random/maintenance/misc,
/obj/structure/table/rack/steel,
/turf/simulated/floor/wood,
/area/submap/groundbase/poi/outdoor/cabin4)
"F" = (
/obj/structure/bed/chair/sofa/left/brown{
	dir = 4
	},
/turf/simulated/floor/wood,
/area/submap/groundbase/poi/outdoor/cabin4)
"Q" = (
/obj/structure/table/glass,
/obj/item/device/flashlight/lamp/green{
	pixel_x = 1;
	pixel_y = 5
	},
/turf/simulated/floor/wood,
/area/submap/groundbase/poi/outdoor/cabin4)
"V" = (
/obj/structure/table/glass,
/obj/random/maintenance/misc,
/turf/simulated/floor/wood,
/area/submap/groundbase/poi/outdoor/cabin4)
"W" = (
/turf/simulated/floor/wood,
/area/submap/groundbase/poi/outdoor/cabin4)
"X" = (
/obj/structure/simple_door/wood,
/turf/simulated/floor,
/area/submap/groundbase/poi/outdoor/cabin4)

(1,1,1) = {"
a
b
q
q
q
b
a
a
"}
(2,1,1) = {"
b
b
F
u
W
b
b
a
"}
(3,1,1) = {"
q
s
V
x
W
D
b
d
"}
(4,1,1) = {"
q
l
Q
V
W
W
X
d
"}
(5,1,1) = {"
q
W
W
W
W
D
b
d
"}
(6,1,1) = {"
b
b
V
V
V
b
b
a
"}
(7,1,1) = {"
a
b
q
q
q
b
a
a
"}
