//MAP CONVERTED BY dmm2tgm.py THIS HEADER COMMENT PREVENTS RECONVERSION, DO NOT REMOVE
"a" = (
/obj/item/reagent_containers/food/snacks/chip/nacho/cheese,
/turf/simulated/floor/outdoors/grass/seasonal/nomobs,
/area/template_noop)
"b" = (
/obj/item/reagent_containers/food/snacks/chip/nacho/salsa,
/turf/simulated/floor/outdoors/grass/seasonal/nomobs,
/area/template_noop)
"c" = (
/obj/random/drinkbottle,
/turf/simulated/floor/outdoors/grass/seasonal/nomobs,
/area/template_noop)
"d" = (
/obj/structure/table/wooden_reinforced,
/obj/structure/picnic_blanket_deployed/for_mapping_use{
	desc = "An old and worn picnic blanket. Its colours appear bleached from being outside too much.";
	folded_desc = "A worn picnic blanket with a rough texture. One could swear it seems to be covered in strange, otter-like fur";
	name = "weathered picnic blanket"
	},
/obj/item/storage/toolbox/lunchbox/cat/filled{
	pixel_x = 6;
	pixel_y = 9
	},
/obj/item/reagent_containers/food/snacks/fruitsalad,
/turf/simulated/floor/outdoors/grass/seasonal/notrees_nomobs_nosnow,
/area/template_noop)
"h" = (
/obj/structure/table/bench/wooden,
/obj/effect/decal/cleanable/filth,
/obj/random/mob/wildscugs{
	newdesc = "A wild catslug enjoying the simpler things in life: a picnic!";
	newname = list("happy catslug", "rotund catslug", "anxious catslug", "angry Catslug", "content Catslug", "sad catslug")
	},
/turf/simulated/floor/outdoors/grass/seasonal/notrees_nomobs_nosnow,
/area/template_noop)
"i" = (
/obj/structure/table/wooden_reinforced,
/obj/random/pizzabox,
/obj/item/storage/toolbox/lunchbox/mars/filled{
	pixel_x = -7;
	pixel_y = 11
	},
/obj/random/mug{
	pixel_x = 10;
	pixel_y = 9
	},
/turf/simulated/floor/outdoors/grass/seasonal/notrees_nomobs_nosnow,
/area/template_noop)
"k" = (
/obj/random/drinkbottle,
/turf/simulated/floor/outdoors/grass/seasonal/notrees_nomobs_lowsnow,
/area/template_noop)
"m" = (
/obj/random/coin,
/turf/simulated/floor/outdoors/grass/seasonal/nomobs,
/area/template_noop)
"n" = (
/obj/effect/decal/cleanable/filth,
/turf/simulated/floor/outdoors/grass/seasonal/notrees_nomobs_lowsnow,
/area/template_noop)
"s" = (
/obj/structure/table/bench/wooden,
/obj/random/mob/wildscugs{
	newdesc = "A wild catslug enjoying the simpler things in life: a picnic!";
	newname = list("happy catslug", "rotund catslug", "anxious catslug", "angry Catslug", "content Catslug", "sad catslug")
	},
/obj/item/ore/diamond{
	name = "porl"
	},
/turf/simulated/floor/outdoors/grass/seasonal/notrees_nomobs_nosnow,
/area/template_noop)
"t" = (
/obj/item/pizzavoucher,
/turf/simulated/floor/outdoors/grass/seasonal/nomobs,
/area/template_noop)
"w" = (
/obj/item/trash/chipbasket,
/turf/simulated/floor/outdoors/grass/seasonal/nomobs,
/area/template_noop)
"z" = (
/obj/random/drinksoft,
/turf/simulated/floor/outdoors/grass/seasonal/notrees_nomobs_lowsnow,
/area/template_noop)
"A" = (
/turf/simulated/floor/outdoors/grass/seasonal/nomobs,
/area/template_noop)
"F" = (
/obj/structure/table/bench/wooden,
/obj/random/mob/wildscugs{
	newdesc = "A wild catslug enjoying the simpler things in life: a picnic!";
	newname = list("happy catslug", "rotund catslug", "anxious catslug", "angry Catslug", "content Catslug", "sad catslug")
	},
/obj/item/material/twohanded/spear/foam{
	desc = "The only way you can hunt things with this is by tickling them to death.";
	name = "squishy foam spear"
	},
/turf/simulated/floor/outdoors/grass/seasonal/notrees_nomobs_nosnow,
/area/template_noop)
"J" = (
/obj/structure/table/bench/wooden,
/obj/random/mob/wildscugs{
	newdesc = "A wild catslug enjoying the simpler things in life: a picnic!";
	newname = list("happy catslug", "rotund catslug", "anxious catslug", "angry Catslug", "content Catslug", "sad catslug")
	},
/turf/simulated/floor/outdoors/grass/seasonal/notrees_nomobs_nosnow,
/area/template_noop)
"L" = (
/obj/effect/decal/remains/lizard,
/turf/simulated/floor/outdoors/grass/seasonal/nomobs,
/area/template_noop)
"N" = (
/obj/structure/table/wooden_reinforced,
/obj/item/storage/toolbox/lunchbox/heart/filled{
	pixel_x = -4;
	pixel_y = -6
	},
/obj/random/mug{
	pixel_x = 10;
	pixel_y = 9
	},
/obj/effect/decal/cleanable/tomato_smudge,
/turf/simulated/floor/outdoors/grass/seasonal/notrees_nomobs_nosnow,
/area/template_noop)
"O" = (
/obj/structure/table/bench/wooden,
/obj/random/mob/wildscugs{
	newdesc = "A wild catslug enjoying the simpler things in life: a picnic!";
	newname = list("happy catslug", "rotund catslug", "anxious catslug", "angry Catslug", "content Catslug", "sad catslug")
	},
/obj/random/mug,
/turf/simulated/floor/outdoors/grass/seasonal/notrees_nomobs_nosnow,
/area/template_noop)
"S" = (
/obj/structure/table/bench/wooden,
/obj/item/towel/random,
/obj/random/mob/wildscugs{
	newdesc = "A wild catslug enjoying the simpler things in life: a picnic!";
	newname = list("happy catslug", "rotund catslug", "anxious catslug", "angry Catslug", "content Catslug", "sad catslug")
	},
/turf/simulated/floor/outdoors/grass/seasonal/notrees_nomobs_nosnow,
/area/template_noop)
"T" = (
/turf/simulated/floor/outdoors/grass/seasonal/notrees_nomobs_lowsnow,
/area/template_noop)
"Y" = (
/obj/random/drinksoft,
/turf/simulated/floor/outdoors/grass/seasonal/nomobs,
/area/template_noop)

(1,1,1) = {"
c
A
A
A
A
"}
(2,1,1) = {"
a
T
n
T
Y
"}
(3,1,1) = {"
A
s
h
J
w
"}
(4,1,1) = {"
A
N
d
i
b
"}
(5,1,1) = {"
t
F
O
S
m
"}
(6,1,1) = {"
L
z
T
k
A
"}
(7,1,1) = {"
A
A
A
A
A
"}
