//MAP CONVERTED BY dmm2tgm.py THIS HEADER COMMENT PREVENTS RECONVERSION, DO NOT REMOVE
"a" = (
/obj/structure/fence/corner{
	dir = 10
	},
/turf/simulated/floor/outdoors/grass/virgo3c,
/area/submap/groundbase/poi/outdoor)
"n" = (
/obj/structure/fence{
	dir = 4
	},
/turf/simulated/floor/outdoors/grass/virgo3c,
/area/submap/groundbase/poi/outdoor)
"q" = (
/obj/machinery/portable_atmospherics/hydroponics/soil,
/turf/simulated/floor/outdoors/newdirt/virgo3c,
/area/submap/groundbase/poi/outdoor)
"u" = (
/obj/structure/fence/corner,
/turf/simulated/floor/outdoors/grass/virgo3c,
/area/submap/groundbase/poi/outdoor)
"D" = (
/obj/structure/fence/corner{
	dir = 8
	},
/turf/simulated/floor/outdoors/grass/virgo3c,
/area/submap/groundbase/poi/outdoor)
"F" = (
/obj/structure/fence/door,
/turf/simulated/floor/outdoors/grass/virgo3c,
/area/submap/groundbase/poi/outdoor)
"K" = (
/obj/structure/fence/corner{
	dir = 5
	},
/turf/simulated/floor/outdoors/grass/virgo3c,
/area/submap/groundbase/poi/outdoor)
"L" = (
/obj/structure/fence,
/turf/simulated/floor/outdoors/grass/virgo3c,
/area/submap/groundbase/poi/outdoor)
"O" = (
/turf/simulated/floor/outdoors/grass/virgo3c,
/area/submap/groundbase/poi/outdoor)

(1,1,1) = {"
D
L
L
L
L
L
L
L
a
"}
(2,1,1) = {"
n
q
q
q
O
q
q
q
n
"}
(3,1,1) = {"
n
O
O
O
O
O
O
O
F
"}
(4,1,1) = {"
n
q
q
q
O
q
q
q
n
"}
(5,1,1) = {"
n
O
O
O
O
O
O
O
F
"}
(6,1,1) = {"
n
q
q
q
O
q
q
q
n
"}
(7,1,1) = {"
K
L
L
L
L
L
L
L
u
"}
