//MAP CONVERTED BY dmm2tgm.py THIS HEADER COMMENT PREVENTS RECONVERSION, DO NOT REMOVE
"a" = (
/turf/simulated/shuttle/wall/voidcraft/survival,
/area/survivalpod/redspace)
"d" = (
/obj/structure/sign/mining,
/turf/simulated/shuttle/wall/voidcraft/survival,
/area/survivalpod/redspace)
"e" = (
/obj/structure/table/hardwoodtable,
/obj/item/reagent_containers/food/snacks/mint{
	pixel_x = 2;
	pixel_y = 7
	},
/obj/item/flame/candle/everburn{
	pixel_x = -9;
	pixel_y = -2
	},
/turf/simulated/floor/wood/alt/parquet,
/area/survivalpod/redspace)
"g" = (
/obj/machinery/light/small/fairylights{
	pixel_y = 38
	},
/obj/structure/closet/secure_closet/personal,
/turf/simulated/floor/wood/alt/parquet,
/area/survivalpod/redspace)
"j" = (
/obj/effect/floor_decal/spline/plain{
	dir = 1
	},
/turf/simulated/floor/carpet/brown,
/area/survivalpod/redspace)
"m" = (
/obj/structure/sign/mining/survival,
/turf/simulated/shuttle/wall/voidcraft/survival,
/area/survivalpod/redspace)
"n" = (
/obj/structure/bed/chair/wood{
	dir = 8
	},
/obj/effect/floor_decal/spline/plain{
	dir = 4
	},
/turf/simulated/floor/carpet/brown,
/area/survivalpod/redspace)
"q" = (
/obj/structure/sign/mining/survival{
	dir = 4
	},
/turf/simulated/shuttle/wall/voidcraft/survival,
/area/survivalpod/redspace)
"w" = (
/obj/structure/table/fancyblack,
/obj/item/flame/candle/candelabra/everburn{
	pixel_y = 17
	},
/obj/item/reagent_containers/food/snacks/meatballspagetti{
	pixel_y = 4
	},
/obj/item/material/kitchen/utensil/fork{
	pixel_y = 5;
	pixel_x = -10
	},
/obj/item/material/kitchen/utensil/fork{
	pixel_y = 5;
	pixel_x = 12
	},
/turf/simulated/floor/carpet/brown,
/area/survivalpod/redspace)
"x" = (
/obj/effect/floor_decal/spline/plain{
	dir = 10
	},
/turf/simulated/floor/carpet/brown,
/area/survivalpod/redspace)
"z" = (
/obj/effect/floor_decal/spline/plain{
	dir = 5
	},
/turf/simulated/floor/carpet/brown,
/area/survivalpod/redspace)
"A" = (
/obj/structure/table/hardwoodtable,
/obj/machinery/light/small/fairylights{
	pixel_y = 38
	},
/obj/item/flame/candle/everburn{
	pixel_y = 10;
	pixel_x = -10
	},
/obj/item/instrument/piano_synth{
	pixel_y = 5;
	pixel_x = 1
	},
/obj/item/instrument/violin{
	pixel_y = 8;
	pixel_x = 8
	},
/turf/simulated/floor/wood/alt/parquet,
/area/survivalpod/redspace)
"B" = (
/obj/structure/disposalpipe/segment{
	dir = 4;
	icon_state = "pipe-c"
	},
/obj/structure/sign/mining/survival{
	dir = 4
	},
/turf/simulated/shuttle/wall/voidcraft/survival,
/area/survivalpod/redspace)
"C" = (
/obj/structure/fans/tiny,
/obj/machinery/door/airlock/voidcraft/survival_pod,
/obj/effect/floor_decal/industrial/danger/full,
/turf/simulated/shuttle/floor/voidcraft,
/area/survivalpod/redspace)
"G" = (
/obj/machinery/smartfridge/survival_pod{
	pixel_y = 28
	},
/obj/item/clothing/under/dress/black_corset,
/obj/item/clothing/under/dress/blacktango,
/obj/item/clothing/under/dress/blacktango/alt,
/obj/item/clothing/under/dress/cbridesmaid,
/obj/item/clothing/under/dress/cdress_fire,
/obj/item/clothing/under/dress/cswoopdress,
/obj/item/clothing/under/dress/flamenco,
/obj/item/clothing/under/dress/littleblackdress,
/obj/item/clothing/under/dress/gothic2,
/obj/item/clothing/under/dress/redeveninggown,
/obj/item/clothing/under/suit_jacket,
/obj/item/clothing/under/suit_jacket/burgundy,
/obj/item/clothing/under/suit_jacket/burgundy/skirt,
/obj/item/clothing/under/suit_jacket/female,
/obj/item/clothing/under/suit_jacket/really_black,
/obj/item/clothing/under/suit_jacket/really_black/skirt,
/obj/item/clothing/shoes/black,
/obj/item/clothing/shoes/black,
/obj/item/clothing/shoes/dress,
/obj/item/clothing/shoes/dress,
/turf/simulated/floor/wood/alt/parquet,
/area/survivalpod/redspace)
"H" = (
/turf/simulated/shuttle/wall/voidcraft/red,
/area/survivalpod/redspace)
"K" = (
/turf/simulated/floor/wood/alt/parquet,
/area/survivalpod/redspace)
"N" = (
/obj/structure/table/hardwoodtable,
/obj/item/flame/candle/everburn{
	pixel_x = 10
	},
/obj/item/reagent_containers/food/drinks/bottle/champagne{
	pixel_y = 19;
	pixel_x = -6
	},
/obj/item/reagent_containers/food/drinks/glass2/wine{
	pixel_x = -11;
	pixel_y = 1
	},
/obj/item/reagent_containers/food/drinks/glass2/wine{
	pixel_x = 1;
	pixel_y = 1
	},
/turf/simulated/floor/wood/alt/parquet,
/area/survivalpod/redspace)
"O" = (
/obj/effect/floor_decal/spline/plain{
	dir = 9
	},
/turf/simulated/floor/carpet/brown,
/area/survivalpod/redspace)
"Q" = (
/obj/structure/bed/chair/wood{
	dir = 4
	},
/obj/effect/floor_decal/spline/plain{
	dir = 8
	},
/turf/simulated/floor/carpet/brown,
/area/survivalpod/redspace)
"R" = (
/obj/effect/floor_decal/spline/plain,
/turf/simulated/floor/carpet/brown,
/area/survivalpod/redspace)
"U" = (
/obj/structure/sign/mining/survival{
	dir = 8
	},
/turf/simulated/shuttle/wall/voidcraft/survival,
/area/survivalpod/redspace)
"V" = (
/obj/structure/fans{
	pixel_y = 32
	},
/turf/simulated/floor/wood/alt/parquet,
/area/survivalpod/redspace)
"W" = (
/obj/effect/floor_decal/spline/plain{
	dir = 6
	},
/turf/simulated/floor/carpet/brown,
/area/survivalpod/redspace)
"X" = (
/obj/machinery/disposal/wall{
	dir = 8
	},
/obj/structure/disposalpipe/trunk{
	dir = 4
	},
/turf/simulated/floor/wood/alt/parquet,
/area/survivalpod/redspace)
"Z" = (
/obj/structure/disposalpipe/segment{
	dir = 8;
	icon_state = "pipe-c"
	},
/turf/simulated/shuttle/wall/voidcraft/survival,
/area/survivalpod/redspace)

(1,1,1) = {"
a
U
a
U
a
U
a
"}
(2,1,1) = {"
a
A
K
K
K
e
m
"}
(3,1,1) = {"
a
g
O
Q
x
K
H
"}
(4,1,1) = {"
a
g
j
w
R
K
C
"}
(5,1,1) = {"
a
V
z
n
W
K
a
"}
(6,1,1) = {"
a
G
K
K
X
N
d
"}
(7,1,1) = {"
a
q
a
B
Z
q
a
"}
