//MAP CONVERTED BY dmm2tgm.py THIS HEADER COMMENT PREVENTS RECONVERSION, DO NOT REMOVE
"a" = (
/turf/simulated/floor/wood,
/area/survivalpod/redspace)
"b" = (
/obj/structure/bed/chair/comfy/black{
	dir = 1
	},
/turf/simulated/floor/wood,
/area/survivalpod/redspace)
"e" = (
/obj/machinery/smartfridge/survival_pod,
/obj/item/deck/tarot,
/obj/item/deck/wizoff,
/obj/item/storage/pill_bottle/dice_nerd,
/obj/item/reagent_containers/food/drinks/cans/waterbottle,
/obj/item/reagent_containers/food/drinks/cans/waterbottle,
/obj/item/reagent_containers/food/drinks/cans/waterbottle,
/obj/item/deck/wizoff,
/obj/item/toy/character/wizard,
/obj/item/toy/character/wizard,
/obj/item/toy/character/wizard,
/obj/item/toy/character/wizard,
/obj/item/toy/character/wizard,
/obj/item/toy/character/warrior,
/obj/item/toy/character/warrior,
/obj/item/toy/character/warrior,
/obj/item/toy/character/warrior,
/obj/item/toy/character/warrior,
/obj/item/toy/character/thief,
/obj/item/toy/character/thief,
/obj/item/toy/character/lich,
/obj/item/toy/character/lich,
/obj/item/toy/character/lich,
/obj/item/toy/character/lich,
/obj/item/toy/character/lich,
/obj/item/toy/character/cleric,
/obj/item/toy/character/cleric,
/obj/item/toy/character/cleric,
/obj/item/toy/character/cleric,
/obj/item/toy/character/cleric,
/obj/item/toy/griffin,
/obj/item/reagent_containers/pill/diet,
/obj/item/reagent_containers/pill/diet,
/obj/item/bedsheet/pillow/exercise,
/obj/item/entrepreneur/dumbbell,
/obj/item/entrepreneur/dumbbell,
/obj/item/dice,
/obj/item/dice,
/obj/item/dice,
/obj/item/dice,
/obj/item/dice,
/obj/item/dice,
/obj/item/dice/d10,
/obj/item/dice/d10,
/obj/item/dice/d10,
/obj/item/dice/d10,
/obj/item/dice/d10,
/obj/item/dice/d10,
/obj/item/dice/d100,
/obj/item/dice/d100,
/obj/item/dice/d100,
/obj/item/dice/d100,
/obj/item/dice/d100,
/obj/item/dice/d100,
/obj/item/dice/d12,
/obj/item/dice/d12,
/obj/item/dice/d12,
/obj/item/dice/d12,
/obj/item/dice/d12,
/obj/item/dice/d12,
/obj/item/dice/d20,
/obj/item/dice/d20,
/obj/item/dice/d20,
/obj/item/dice/d20,
/obj/item/dice/d20,
/obj/item/dice/d20,
/obj/item/dice/d4,
/obj/item/dice/d4,
/obj/item/dice/d4,
/obj/item/dice/d4,
/obj/item/dice/d4,
/obj/item/dice/d4,
/obj/item/dice/d8,
/obj/item/dice/d8,
/obj/item/dice/d8,
/obj/item/dice/d8,
/obj/item/dice/d8,
/obj/item/dice/d8,
/obj/item/storage/mre/menu9,
/obj/item/storage/mre/menu9,
/obj/item/storage/mre/menu10,
/obj/item/storage/mre/menu10,
/obj/item/storage/mre/random,
/obj/item/storage/mre/random,
/obj/item/storage/mre/random,
/obj/item/storage/mre/random,
/obj/item/storage/mre/random,
/obj/item/storage/firstaid/regular,
/obj/item/storage/dicecup,
/obj/item/storage/box/donkpockets,
/turf/simulated/floor/wood,
/area/survivalpod/redspace)
"f" = (
/obj/structure/closet/crate/bin,
/obj/item/trash/chips,
/turf/simulated/floor/wood,
/area/survivalpod/redspace)
"g" = (
/obj/structure/sign/mining/survival{
	dir = 4
	},
/turf/simulated/shuttle/wall/voidcraft/survival,
/area/survivalpod/redspace)
"j" = (
/obj/structure/sign/mining/survival{
	dir = 8
	},
/turf/simulated/shuttle/wall/voidcraft/survival,
/area/survivalpod/redspace)
"k" = (
/obj/machinery/door/window/survival_pod{
	dir = 1;
	icon_state = "windoor"
	},
/turf/simulated/floor/tiled/white,
/area/survivalpod/redspace)
"l" = (
/turf/simulated/shuttle/wall/voidcraft/survival,
/area/survivalpod/redspace)
"m" = (
/obj/structure/table/hardwoodtable,
/obj/item/reagent_containers/spray/cleaner{
	pixel_y = 11;
	pixel_x = 10
	},
/turf/simulated/floor/wood,
/area/survivalpod/redspace)
"o" = (
/obj/structure/fans/tiny,
/obj/machinery/door/airlock/voidcraft/survival_pod,
/obj/effect/floor_decal/industrial/danger/full,
/turf/simulated/shuttle/floor/voidcraft,
/area/survivalpod/redspace)
"p" = (
/obj/machinery/shower{
	dir = 4;
	pixel_y = -4
	},
/obj/item/soap,
/turf/simulated/floor/tiled/white,
/area/survivalpod/redspace)
"q" = (
/obj/structure/window/reinforced/survival_pod{
	dir = 4
	},
/turf/simulated/floor/tiled/white,
/area/survivalpod/redspace)
"t" = (
/obj/structure/sink{
	dir = 8;
	pixel_x = -12
	},
/obj/structure/mirror{
	dir = 4;
	pixel_x = -26;
	pixel_y = 5
	},
/turf/simulated/floor/wood,
/area/survivalpod/redspace)
"u" = (
/obj/structure/window/reinforced/survival_pod{
	dir = 8
	},
/obj/structure/window/reinforced/survival_pod{
	dir = 4
	},
/obj/structure/window/reinforced/survival_pod{
	dir = 1
	},
/obj/structure/grille,
/obj/structure/window/reinforced/survival_pod,
/turf/simulated/shuttle/floor/voidcraft/dark,
/area/survivalpod/redspace)
"v" = (
/obj/structure/window/reinforced/survival_pod{
	dir = 8
	},
/obj/structure/window/reinforced/survival_pod{
	dir = 4
	},
/obj/structure/window/reinforced/survival_pod,
/obj/structure/grille,
/turf/simulated/shuttle/floor/voidcraft/dark,
/area/survivalpod/redspace)
"y" = (
/turf/simulated/floor/carpet/blue2,
/area/survivalpod/redspace)
"C" = (
/obj/structure/sign/mining,
/turf/simulated/shuttle/wall/voidcraft/survival,
/area/survivalpod/redspace)
"E" = (
/obj/structure/window/reinforced/survival_pod{
	dir = 4
	},
/obj/structure/window/reinforced/survival_pod{
	dir = 1
	},
/turf/simulated/floor/tiled/white,
/area/survivalpod/redspace)
"G" = (
/obj/structure/table/woodentable,
/obj/machinery/microwave{
	pixel_y = 6
	},
/obj/machinery/light{
	dir = 4
	},
/turf/simulated/floor/wood,
/area/survivalpod/redspace)
"J" = (
/obj/structure/bed/pod,
/obj/item/bedsheet/green,
/obj/machinery/light{
	dir = 1
	},
/turf/simulated/floor/carpet/blue2,
/area/survivalpod/redspace)
"L" = (
/obj/structure/sign/mining/survival{
	dir = 1
	},
/turf/simulated/shuttle/wall/voidcraft/survival,
/area/survivalpod/redspace)
"M" = (
/obj/structure/table/hardwoodtable,
/obj/machinery/computer/security/telescreen/entertainment{
	pixel_y = 9
	},
/turf/simulated/floor/wood,
/area/survivalpod/redspace)
"P" = (
/obj/structure/sign/mining/survival,
/turf/simulated/shuttle/wall/voidcraft/survival,
/area/survivalpod/redspace)
"Q" = (
/obj/machinery/fitness/heavy/treadmill,
/turf/simulated/floor/wood,
/area/survivalpod/redspace)
"R" = (
/obj/structure/fans,
/turf/simulated/floor/carpet/blue2,
/area/survivalpod/redspace)
"V" = (
/obj/structure/window/reinforced/survival_pod{
	dir = 8
	},
/obj/structure/window/reinforced/survival_pod{
	dir = 4
	},
/obj/structure/window/reinforced/survival_pod{
	dir = 1
	},
/obj/structure/grille,
/turf/simulated/shuttle/floor/voidcraft/dark,
/area/survivalpod/redspace)

(1,1,1) = {"
l
j
u
l
l
j
l
"}
(2,1,1) = {"
L
J
y
t
k
p
P
"}
(3,1,1) = {"
l
R
y
a
E
q
l
"}
(4,1,1) = {"
L
e
a
a
a
a
o
"}
(5,1,1) = {"
l
m
a
a
a
f
l
"}
(6,1,1) = {"
L
M
b
Q
a
G
C
"}
(7,1,1) = {"
l
g
l
V
v
g
l
"}
