//MAP CONVERTED BY dmm2tgm.py THIS HEADER COMMENT PREVENTS RECONVERSION, DO NOT REMOVE
"a" = (
/turf/unsimulated/fake_space,
/area/survivalpod/redspace)
"b" = (
/obj/item/reagent_containers/food/snacks/snackplanet/virgo3b,
/turf/unsimulated/fake_space,
/area/survivalpod/redspace)
"e" = (
/obj/structure/sign/mining,
/turf/simulated/shuttle/wall/voidcraft/survival,
/area/survivalpod/redspace)
"g" = (
/obj/machinery/light{
	dir = 1;
	stat = 0
	},
/turf/unsimulated/fake_space,
/area/survivalpod/redspace)
"i" = (
/obj/item/reagent_containers/food/snacks/snackplanet/virgoprime{
	name = "Ringed planet"
	},
/turf/unsimulated/fake_space,
/area/survivalpod/redspace)
"j" = (
/obj/machinery/light{
	dir = 8
	},
/turf/unsimulated/fake_space,
/area/survivalpod/redspace)
"l" = (
/obj/machinery/smartfridge/survival_pod,
/obj/structure/fans/tiny,
/obj/item/clothing/head/helmet/space,
/obj/item/clothing/head/helmet/space,
/obj/item/clothing/head/helmet/space,
/obj/item/clothing/head/helmet/space,
/obj/item/clothing/head/helmet/space,
/obj/structure/window/reinforced/survival_pod{
	dir = 1
	},
/turf/simulated/shuttle/floor/voidcraft,
/area/survivalpod/redspace)
"m" = (
/turf/simulated/shuttle/wall/voidcraft/survival,
/area/survivalpod/redspace)
"u" = (
/obj/structure/sign/mining/survival{
	dir = 1
	},
/turf/simulated/shuttle/wall/voidcraft/survival,
/area/survivalpod/redspace)
"G" = (
/obj/machinery/light{
	dir = 4
	},
/turf/unsimulated/fake_space,
/area/survivalpod/redspace)
"L" = (
/obj/structure/sign/mining/survival{
	dir = 8
	},
/turf/simulated/shuttle/wall/voidcraft/survival,
/area/survivalpod/redspace)
"P" = (
/obj/item/reagent_containers/food/snacks/snackplanet/moon,
/turf/unsimulated/fake_space,
/area/survivalpod/redspace)
"R" = (
/obj/structure/sign/mining/survival,
/turf/simulated/shuttle/wall/voidcraft/survival,
/area/survivalpod/redspace)
"V" = (
/obj/structure/fans/tiny,
/obj/machinery/door/airlock/voidcraft/survival_pod,
/obj/effect/floor_decal/industrial/danger/full,
/turf/simulated/shuttle/floor/voidcraft,
/area/survivalpod/redspace)
"X" = (
/obj/structure/sign/mining/survival{
	dir = 4
	},
/turf/simulated/shuttle/wall/voidcraft/survival,
/area/survivalpod/redspace)

(1,1,1) = {"
m
L
m
L
m
L
m
"}
(2,1,1) = {"
u
a
a
j
a
a
R
"}
(3,1,1) = {"
m
a
a
a
a
a
m
"}
(4,1,1) = {"
u
g
a
i
a
a
V
"}
(5,1,1) = {"
m
a
a
a
b
a
l
"}
(6,1,1) = {"
u
P
a
G
a
a
e
"}
(7,1,1) = {"
m
X
m
X
m
X
m
"}
