//MAP CONVERTED BY dmm2tgm.py THIS HEADER COMMENT PREVENTS RECONVERSION, DO NOT REMOVE
"a" = (
/turf/simulated/shuttle/wall/voidcraft,
/area/survivalpod)
"b" = (
/obj/machinery/button/remote/airlock/survival_pod{
	dir = 10;
	pixel_y = -24;
	pixel_x = 32
	},
/turf/simulated/shuttle/floor/voidcraft,
/area/survivalpod)
"g" = (
/obj/structure/fans/tiny,
/obj/machinery/door/airlock/voidcraft/survival_pod,
/obj/effect/floor_decal/industrial/danger/full,
/turf/simulated/shuttle/floor/voidcraft,
/area/survivalpod)
"h" = (
/obj/item/gps/computer{
	pixel_y = 0;
	density = 0
	},
/obj/structure/tubes,
/turf/simulated/shuttle/floor/voidcraft,
/area/survivalpod)
"k" = (
/obj/structure/bed/chair/comfy/black{
	dir = 1
	},
/turf/simulated/shuttle/floor/voidcraft,
/area/survivalpod)
"m" = (
/obj/machinery/smartfridge/survival_pod{
	pixel_y = 28;
	density = 0
	},
/obj/item/storage/mre/random,
/obj/item/storage/mre/random,
/obj/item/storage/mre/random,
/obj/item/storage/mre/menu11,
/obj/item/fbp_backup_cell,
/obj/item/fbp_backup_cell,
/obj/item/fbp_backup_cell,
/obj/item/fbp_backup_cell,
/obj/item/fbp_backup_cell,
/obj/item/storage/pill_bottle/dice_nerd,
/obj/item/storage/firstaid/regular,
/turf/simulated/shuttle/floor/voidcraft,
/area/survivalpod)
"q" = (
/obj/machinery/light_switch/survival_pod{
	dir = 1;
	pixel_x = -9;
	pixel_y = -23
	},
/obj/structure/closet/cabinet,
/turf/simulated/shuttle/floor/voidcraft,
/area/survivalpod)
"s" = (
/obj/structure/sign/mining/survival{
	dir = 8
	},
/turf/simulated/shuttle/wall/voidcraft,
/area/survivalpod)
"x" = (
/obj/machinery/light/small{
	dir = 4;
	pixel_y = 19
	},
/obj/structure/bed/double/padded,
/obj/item/bedsheet/hopdouble,
/turf/simulated/shuttle/floor/voidcraft,
/area/survivalpod)
"B" = (
/obj/structure/sign/mining/survival{
	dir = 1;
	layer = 2.8
	},
/turf/simulated/shuttle/wall/voidcraft,
/area/survivalpod)
"D" = (
/obj/structure/table/reinforced,
/obj/item/deck/cards{
	pixel_y = 4;
	pixel_x = -4
	},
/turf/simulated/shuttle/floor/voidcraft,
/area/survivalpod)
"G" = (
/obj/structure/fans{
	pixel_y = 32;
	density = 0
	},
/obj/structure/bed/chair/comfy/black,
/turf/simulated/shuttle/floor/voidcraft,
/area/survivalpod)
"J" = (
/obj/structure/sign/mining/survival,
/turf/simulated/shuttle/wall/voidcraft,
/area/survivalpod)
"O" = (
/turf/simulated/shuttle/floor/voidcraft,
/area/survivalpod)
"Q" = (
/obj/structure/sign/mining,
/turf/simulated/shuttle/wall/voidcraft,
/area/survivalpod)
"W" = (
/obj/structure/sign/mining/survival{
	dir = 4
	},
/turf/simulated/shuttle/wall/voidcraft,
/area/survivalpod)

(1,1,1) = {"
a
a
s
a
a
"}
(2,1,1) = {"
a
G
D
k
J
"}
(3,1,1) = {"
B
m
O
b
g
"}
(4,1,1) = {"
a
h
x
q
Q
"}
(5,1,1) = {"
a
a
W
a
a
"}
