//MAP CONVERTED BY dmm2tgm.py THIS HEADER COMMENT PREVENTS RECONVERSION, DO NOT REMOVE
"a" = (
/turf/simulated/shuttle/wall/voidcraft,
/area/survivalpod)
"b" = (
/obj/structure/bed/chair/office/light,
/obj/structure/barricade/cutout/greytide,
/turf/simulated/floor/tiled/white,
/area/survivalpod)
"h" = (
/obj/structure/table/standard,
/obj/machinery/light{
	dir = 4;
	light_color = "#DDFFD3"
	},
/turf/simulated/floor/tiled/white,
/area/survivalpod)
"k" = (
/obj/structure/fans/tiny,
/obj/machinery/door/airlock/voidcraft/survival_pod,
/obj/effect/floor_decal/industrial/danger/full,
/turf/simulated/shuttle/floor/voidcraft,
/area/survivalpod)
"p" = (
/obj/structure/barricade/cutout/greytide,
/turf/simulated/floor/tiled/white,
/area/survivalpod)
"y" = (
/obj/structure/table/standard,
/turf/simulated/floor/tiled/white,
/area/survivalpod)
"z" = (
/turf/simulated/floor/tiled/white,
/area/survivalpod)
"H" = (
/obj/structure/sign/greencross,
/turf/simulated/shuttle/wall/voidcraft,
/area/survivalpod)
"I" = (
/obj/structure/fans/tiny,
/obj/effect/floor_decal/industrial/danger/full,
/obj/machinery/door/airlock/voidcraft/survival_pod/vertical,
/turf/simulated/shuttle/floor/voidcraft,
/area/survivalpod)

(1,1,1) = {"
H
a
I
a
a
"}
(2,1,1) = {"
a
z
z
z
a
"}
(3,1,1) = {"
a
y
y
z
k
"}
(4,1,1) = {"
a
b
h
p
a
"}
(5,1,1) = {"
H
a
a
a
H
"}
