//MAP CONVERTED BY dmm2tgm.py THIS HEADER COMMENT PREVENTS RECONVERSION, DO NOT REMOVE
"a" = (
/turf/simulated/shuttle/wall/voidcraft,
/area/survivalpod)
"i" = (
/turf/simulated/floor/tiled/white,
/area/survivalpod)
"t" = (
/obj/structure/barricade/cutout/greytide,
/turf/simulated/floor/tiled/white,
/area/survivalpod)
"y" = (
/obj/machinery/light{
	dir = 1
	},
/turf/simulated/floor/tiled/white,
/area/survivalpod)
"z" = (
/obj/structure/sign/greencross,
/turf/simulated/shuttle/wall/voidcraft,
/area/survivalpod)
"D" = (
/obj/structure/fans/tiny,
/obj/machinery/door/airlock/voidcraft/survival_pod,
/obj/effect/floor_decal/industrial/danger/full,
/turf/simulated/shuttle/floor/voidcraft,
/area/survivalpod)
"L" = (
/obj/structure/fans/tiny,
/obj/effect/floor_decal/industrial/danger/full,
/obj/machinery/door/airlock/voidcraft/survival_pod/vertical,
/turf/simulated/shuttle/floor/voidcraft,
/area/survivalpod)

(1,1,1) = {"
z
a
L
a
z
"}
(2,1,1) = {"
a
i
i
i
a
"}
(3,1,1) = {"
D
i
t
i
D
"}
(4,1,1) = {"
a
y
i
i
a
"}
(5,1,1) = {"
z
a
L
a
a
"}
