//MAP CONVERTED BY dmm2tgm.py THIS HEADER COMMENT PREVENTS RECONVERSION, DO NOT REMOVE
"a" = (
/turf/simulated/wall/r_concrete,
/area/template_noop)
"b" = (
/turf/simulated/floor/tiled,
/area/template_noop)
"c" = (
/obj/effect/floor_decal/borderfloor,
/obj/effect/floor_decal/corner/brown/border,
/obj/structure/largecrate,
/turf/simulated/floor/tiled/steel_dirty,
/area/template_noop)
"d" = (
/obj/machinery/firealarm{
	pixel_y = 24
	},
/turf/simulated/floor/tiled/steel_dirty,
/area/template_noop)
"f" = (
/obj/effect/floor_decal/borderfloor{
	dir = 4
	},
/obj/effect/floor_decal/corner/brown/border{
	dir = 4
	},
/obj/structure/closet/crate/freezer/centauri,
/obj/random/snack,
/obj/random/snack,
/obj/random/snack,
/obj/random/snack,
/turf/simulated/floor/tiled/steel_dirty,
/area/template_noop)
"g" = (
/obj/random/crate{
	dir = 8
	},
/obj/random/maintenance/clean,
/obj/random/maintenance/clean,
/turf/simulated/floor/tiled/monotile,
/area/template_noop)
"h" = (
/obj/structure/cable/green{
	d1 = 4;
	d2 = 8;
	icon_state = "4-8"
	},
/obj/effect/floor_decal/steeldecal/steel_decals4{
	dir = 1
	},
/obj/effect/floor_decal/steeldecal/steel_decals4{
	dir = 6
	},
/obj/machinery/atmospherics/pipe/manifold/hidden/supply,
/obj/machinery/atmospherics/pipe/manifold/hidden/scrubbers{
	dir = 1
	},
/turf/simulated/floor/tiled,
/area/template_noop)
"i" = (
/obj/effect/floor_decal/borderfloor,
/obj/effect/floor_decal/corner/brown/border,
/obj/structure/closet/crate/ward{
	dir = 8
	},
/obj/item/weapon/weldingtool/electric,
/obj/item/weapon/weldingtool/electric,
/obj/item/weapon/weldingtool/electric,
/obj/machinery/alarm{
	dir = 1;
	pixel_y = -22
	},
/turf/simulated/floor/tiled/steel_dirty,
/area/template_noop)
"j" = (
/turf/template_noop,
/area/template_noop)
"l" = (
/obj/structure/largecrate,
/obj/machinery/atmospherics/pipe/simple/hidden/supply,
/turf/simulated/floor/tiled,
/area/template_noop)
"m" = (
/obj/machinery/atmospherics/pipe/simple/hidden/scrubbers{
	dir = 4
	},
/obj/machinery/atmospherics/pipe/simple/hidden/supply{
	dir = 4
	},
/turf/simulated/floor/tiled,
/area/template_noop)
"n" = (
/obj/structure/cable/green{
	d1 = 1;
	d2 = 8;
	icon_state = "1-8"
	},
/obj/machinery/atmospherics/pipe/simple/hidden/scrubbers{
	dir = 4
	},
/obj/machinery/atmospherics/pipe/simple/hidden/supply{
	dir = 4
	},
/turf/simulated/floor/tiled,
/area/template_noop)
"o" = (
/obj/random/crate,
/obj/random/maintenance/clean,
/obj/random/maintenance/clean,
/obj/random/maintenance/clean,
/turf/simulated/floor/tiled/monotile,
/area/template_noop)
"p" = (
/obj/effect/floor_decal/borderfloor,
/obj/effect/floor_decal/corner/brown/border,
/obj/structure/closet/crate/morpheus{
	dir = 8
	},
/turf/simulated/floor/tiled/steel_dirty,
/area/template_noop)
"q" = (
/obj/effect/floor_decal/borderfloor,
/obj/effect/floor_decal/corner/brown/border,
/obj/structure/closet/crate/oculum{
	dir = 2
	},
/obj/item/weapon/pack/cardemon,
/obj/item/weapon/pack/cardemon,
/obj/item/weapon/pack/spaceball,
/obj/item/weapon/pack/spaceball,
/obj/item/weapon/pack/cardemon,
/turf/simulated/floor/tiled/steel_dirty,
/area/template_noop)
"r" = (
/obj/structure/cable/green{
	d1 = 4;
	d2 = 8;
	icon_state = "4-8"
	},
/obj/machinery/atmospherics/pipe/simple/hidden/scrubbers{
	dir = 4
	},
/obj/machinery/atmospherics/pipe/simple/hidden/supply{
	dir = 4
	},
/turf/simulated/floor/tiled,
/area/template_noop)
"s" = (
/obj/effect/floor_decal/borderfloor,
/obj/effect/floor_decal/corner/brown/border,
/obj/structure/ore_box,
/turf/simulated/floor/tiled/steel_dirty,
/area/template_noop)
"t" = (
/turf/simulated/wall/concrete,
/area/template_noop)
"u" = (
/obj/effect/floor_decal/borderfloor{
	dir = 8
	},
/obj/effect/floor_decal/corner/brown/border{
	dir = 8
	},
/obj/machinery/light{
	dir = 8
	},
/obj/structure/ore_box,
/turf/simulated/floor/tiled/steel_dirty,
/area/template_noop)
"v" = (
/obj/structure/cable/green{
	d2 = 2;
	icon_state = "0-2"
	},
/obj/item/frame/apc,
/turf/simulated/floor/plating,
/area/template_noop)
"x" = (
/obj/machinery/power/port_gen/pacman,
/obj/machinery/atmospherics/unary/vent_pump{
	dir = 1
	},
/turf/simulated/floor/tiled,
/area/template_noop)
"y" = (
/obj/effect/floor_decal/corner_steel_grid{
	dir = 5
	},
/obj/effect/floor_decal/steeldecal/steel_decals5,
/obj/effect/floor_decal/steeldecal/steel_decals_central4,
/obj/effect/floor_decal/spline/plain,
/obj/random/junk,
/turf/simulated/floor/tiled,
/area/template_noop)
"z" = (
/obj/random/obstruction,
/turf/simulated/floor/plating,
/area/template_noop)
"A" = (
/obj/effect/floor_decal/borderfloor{
	dir = 6
	},
/obj/effect/floor_decal/corner/brown/border{
	dir = 6
	},
/obj/structure/closet/crate/einstein,
/obj/item/weapon/cell,
/obj/item/weapon/cell,
/obj/random/powercell,
/obj/random/powercell,
/turf/simulated/floor/tiled/steel_dirty,
/area/template_noop)
"B" = (
/obj/effect/floor_decal/steeldecal/steel_decals4{
	dir = 9
	},
/obj/effect/floor_decal/steeldecal/steel_decals4{
	dir = 4
	},
/turf/simulated/floor/tiled,
/area/template_noop)
"D" = (
/obj/structure/closet/crate/centauri,
/obj/random/mre,
/obj/random/mre,
/obj/random/mre,
/obj/random/mre,
/obj/random/mre,
/turf/simulated/floor/tiled/monotile,
/area/template_noop)
"E" = (
/obj/effect/floor_decal/borderfloor/corner{
	dir = 1
	},
/obj/effect/floor_decal/corner/brown/bordercorner{
	dir = 1
	},
/obj/structure/loot_pile/maint/junk,
/obj/machinery/atmospherics/unary/vent_pump,
/turf/simulated/floor/tiled,
/area/template_noop)
"G" = (
/obj/effect/floor_decal/borderfloor{
	dir = 8
	},
/obj/effect/floor_decal/corner/brown/border{
	dir = 8
	},
/obj/structure/closet/crate/large/secure/heph,
/obj/item/weapon/cell/device/weapon/empty,
/obj/item/weapon/cell/device/weapon/empty,
/obj/item/weapon/cell/device/weapon,
/turf/simulated/floor/tiled/steel_dirty,
/area/template_noop)
"H" = (
/obj/effect/floor_decal/borderfloor{
	dir = 10
	},
/obj/effect/floor_decal/corner/brown/border{
	dir = 10
	},
/obj/structure/closet/crate/zenghu,
/obj/item/weapon/storage/box/autoinjectors,
/obj/random/medical/pillbottle,
/turf/simulated/floor/tiled/steel_dirty,
/area/template_noop)
"I" = (
/obj/effect/floor_decal/borderfloor{
	dir = 8
	},
/obj/effect/floor_decal/corner/brown/border{
	dir = 8
	},
/obj/effect/decal/cleanable/cobweb,
/obj/structure/closet/crate/carp,
/obj/item/seeds/random,
/obj/item/seeds/random,
/obj/item/seeds/random,
/obj/item/seeds/libertymycelium,
/obj/item/seeds/reishimycelium,
/obj/item/seeds/ambrosiavulgarisseed,
/turf/simulated/floor/tiled/steel_dirty,
/area/template_noop)
"J" = (
/obj/structure/reagent_dispensers/watertank,
/obj/machinery/atmospherics/pipe/simple/hidden/scrubbers,
/turf/simulated/floor/tiled,
/area/template_noop)
"K" = (
/obj/structure/closet/crate/solar,
/obj/machinery/atmospherics/pipe/simple/hidden/scrubbers,
/turf/simulated/floor/tiled,
/area/template_noop)
"M" = (
/obj/machinery/atmospherics/unary/vent_scrubber,
/turf/simulated/floor/tiled,
/area/template_noop)
"N" = (
/obj/effect/floor_decal/borderfloor/corner{
	dir = 1
	},
/obj/effect/floor_decal/corner/brown/bordercorner{
	dir = 1
	},
/turf/simulated/floor/tiled,
/area/template_noop)
"O" = (
/obj/effect/floor_decal/borderfloor/corner{
	dir = 4
	},
/obj/effect/floor_decal/corner/brown/bordercorner{
	dir = 4
	},
/obj/item/stack/tile/floor,
/obj/machinery/light_construct{
	dir = 1
	},
/turf/simulated/floor/tiled,
/area/template_noop)
"P" = (
/obj/effect/floor_decal/borderfloor,
/obj/effect/floor_decal/corner/brown/border,
/obj/random/crate,
/obj/random/maintenance/cargo,
/obj/random/maintenance/cargo,
/obj/random/maintenance/cargo,
/turf/simulated/floor/tiled/steel_dirty,
/area/template_noop)
"Q" = (
/obj/structure/closet/crate/large/aether,
/obj/random/tank,
/obj/random/tank,
/obj/random/tank,
/obj/random/tank,
/obj/item/clothing/mask/breath,
/obj/item/clothing/mask/breath,
/obj/item/clothing/mask/breath,
/obj/item/clothing/mask/breath,
/obj/machinery/atmospherics/unary/vent_scrubber{
	dir = 1
	},
/turf/simulated/floor/tiled,
/area/template_noop)
"R" = (
/obj/machinery/atmospherics/pipe/simple/hidden/supply,
/turf/simulated/floor/tiled,
/area/template_noop)
"S" = (
/obj/machinery/atmospherics/pipe/cap/hidden/scrubbers{
	dir = 4
	},
/obj/machinery/atmospherics/pipe/cap/hidden/supply{
	dir = 4
	},
/turf/simulated/wall/concrete,
/area/template_noop)
"T" = (
/turf/simulated/floor/tiled/monotile,
/area/template_noop)
"U" = (
/obj/structure/grille,
/obj/structure/window/reinforced/full,
/obj/machinery/status_display/supply_display,
/turf/simulated/floor/plating,
/area/template_noop)
"V" = (
/obj/machinery/atmospherics/pipe/simple/hidden/scrubbers{
	dir = 9
	},
/obj/machinery/atmospherics/pipe/simple/hidden/supply{
	dir = 10
	},
/turf/simulated/floor/tiled,
/area/template_noop)
"X" = (
/obj/effect/floor_decal/borderfloor{
	dir = 4
	},
/obj/effect/floor_decal/corner/brown/border{
	dir = 4
	},
/obj/machinery/light{
	dir = 4
	},
/obj/structure/closet/crate/freezer/centauri,
/obj/random/drinksoft,
/obj/random/drinksoft,
/obj/random/drinksoft,
/obj/random/drinksoft,
/turf/simulated/floor/tiled/steel_dirty,
/area/template_noop)
"Y" = (
/obj/structure/closet/crate/large/xion,
/obj/random/tech_supply/nofail,
/obj/random/tech_supply/nofail,
/obj/random/tech_supply,
/obj/random/tech_supply,
/obj/random/tech_supply,
/obj/random/tech_supply,
/turf/simulated/floor/tiled/monotile,
/area/template_noop)

(1,1,1) = {"
t
t
j
j
a
a
a
a
a
"}
(2,1,1) = {"
a
a
a
S
a
I
u
H
a
"}
(3,1,1) = {"
j
a
E
h
K
J
Q
P
a
"}
(4,1,1) = {"
j
t
B
r
T
T
b
c
a
"}
(5,1,1) = {"
j
a
O
r
D
o
b
i
a
"}
(6,1,1) = {"
a
a
v
n
g
Y
b
p
a
"}
(7,1,1) = {"
a
G
N
m
T
T
b
q
a
"}
(8,1,1) = {"
a
d
M
V
l
R
x
s
a
"}
(9,1,1) = {"
a
y
z
z
U
f
X
A
a
"}
(10,1,1) = {"
a
a
a
a
a
a
a
a
a
"}
