//MAP CONVERTED BY dmm2tgm.py THIS HEADER COMMENT PREVENTS RECONVERSION, DO NOT REMOVE
"a" = (
/turf/simulated/shuttle/wall/voidcraft/survival,
/area/survivalpod)
"b" = (
/obj/structure/bed/chair/comfy/brown{
	dir = 4
	},
/turf/simulated/floor/wood,
/area/survivalpod)
"f" = (
/obj/structure/table/woodentable,
/obj/item/reagent_containers/food/drinks/bottle/wine,
/obj/item/reagent_containers/food/drinks/drinkingglass{
	pixel_x = 4
	},
/obj/item/reagent_containers/food/drinks/drinkingglass{
	pixel_x = -4
	},
/turf/simulated/floor/wood,
/area/survivalpod)
"m" = (
/obj/structure/table/woodentable,
/obj/machinery/status_display{
	pixel_y = 32
	},
/obj/item/reagent_containers/food/snacks/pastatomato,
/obj/item/reagent_containers/food/snacks/pastatomato,
/turf/simulated/floor/wood,
/area/survivalpod)
"u" = (
/obj/structure/bed/double/padded,
/obj/item/bedsheet/browndouble,
/turf/simulated/floor/wood,
/area/survivalpod)
"v" = (
/obj/structure/window/reinforced/survival_pod{
	dir = 8
	},
/obj/machinery/washing_machine,
/turf/simulated/floor/tiled/white,
/area/survivalpod)
"w" = (
/obj/machinery/door/airlock/voidcraft/survival_pod{
	destroy_hits = 100;
	glass = 0;
	id_tag = "shelter_gamma"
	},
/obj/effect/floor_decal/industrial/danger/full,
/obj/structure/fans/tiny,
/turf/simulated/shuttle/floor/voidcraft,
/area/survivalpod)
"x" = (
/obj/structure/bed/chair/comfy/brown{
	dir = 8
	},
/obj/machinery/light{
	dir = 1
	},
/turf/simulated/floor/wood,
/area/survivalpod)
"z" = (
/obj/structure/sink{
	dir = 4;
	pixel_x = 11
	},
/obj/structure/mirror{
	dir = 4;
	pixel_x = 24
	},
/obj/structure/window/reinforced/survival_pod{
	dir = 1
	},
/turf/simulated/floor/tiled/white,
/area/survivalpod)
"F" = (
/obj/machinery/door/window/survival_pod{
	dir = 8
	},
/obj/machinery/door/window/survival_pod{
	dir = 1
	},
/turf/simulated/floor/tiled/white,
/area/survivalpod)
"M" = (
/obj/machinery/light{
	dir = 4
	},
/obj/structure/closet/secure_closet/personal,
/obj/item/towel/random,
/turf/simulated/floor/wood,
/area/survivalpod)
"N" = (
/obj/structure/table/woodentable,
/obj/item/storage/box/donkpockets,
/obj/item/storage/box/donkpockets{
	pixel_x = 3;
	pixel_y = -3
	},
/obj/machinery/button/remote/airlock/survival_pod{
	dir = 10;
	id = "shelter_gamma";
	pixel_y = -24
	},
/turf/simulated/floor/wood,
/area/survivalpod)
"P" = (
/obj/structure/bed/chair/comfy/brown{
	dir = 8
	},
/turf/simulated/floor/wood,
/area/survivalpod)
"Q" = (
/obj/machinery/shower{
	dir = 1
	},
/obj/structure/curtain,
/obj/random/soap,
/turf/simulated/floor/tiled/white,
/area/survivalpod)
"R" = (
/obj/structure/table/woodentable,
/obj/item/toy/plushie/kitten,
/turf/simulated/floor/wood,
/area/survivalpod)
"S" = (
/turf/simulated/floor/wood,
/area/survivalpod)
"V" = (
/obj/machinery/light{
	dir = 8
	},
/turf/simulated/floor/wood,
/area/survivalpod)
"W" = (
/obj/structure/table/woodentable,
/obj/machinery/microwave,
/turf/simulated/floor/wood,
/area/survivalpod)

(1,1,1) = {"
a
a
a
a
a
a
a
"}
(2,1,1) = {"
a
b
b
V
S
W
a
"}
(3,1,1) = {"
a
m
f
S
S
N
a
"}
(4,1,1) = {"
a
x
P
S
S
S
w
"}
(5,1,1) = {"
a
S
S
S
F
v
a
"}
(6,1,1) = {"
a
R
u
M
z
Q
a
"}
(7,1,1) = {"
a
a
a
a
a
a
a
"}
