//MAP CONVERTED BY dmm2tgm.py THIS HEADER COMMENT PREVENTS RECONVERSION, DO NOT REMOVE
"a" = (
/obj/structure/sign/mining/survival{
	dir = 4
	},
/turf/simulated/shuttle/wall/voidcraft/survival,
/area/survivalpod)
"b" = (
/obj/structure/sign/mining/survival{
	dir = 8
	},
/turf/simulated/shuttle/wall/voidcraft/survival,
/area/survivalpod)
"d" = (
/turf/simulated/shuttle/wall/voidcraft/survival,
/area/survivalpod)
"f" = (
/obj/structure/closet/secure_closet/freezer/meat,
/obj/effect/floor_decal/industrial/warning/dust{
	dir = 10
	},
/turf/simulated/shuttle/floor/voidcraft/light,
/area/survivalpod)
"g" = (
/obj/structure/disposalpipe/segment{
	dir = 1;
	icon_state = "pipe-c"
	},
/turf/simulated/floor/tiled/eris/cafe,
/area/survivalpod)
"h" = (
/obj/structure/fans/tiny,
/obj/machinery/door/airlock/voidcraft/survival_pod/vertical,
/obj/effect/floor_decal/industrial/danger/full,
/turf/simulated/shuttle/floor/voidcraft,
/area/survivalpod)
"i" = (
/obj/structure/disposalpipe/segment{
	dir = 4;
	icon_state = "pipe-c"
	},
/turf/simulated/floor/tiled/eris/cafe,
/area/survivalpod)
"m" = (
/obj/structure/disposalpipe/segment{
	dir = 8;
	icon_state = "pipe-c"
	},
/turf/simulated/floor/tiled/eris/cafe,
/area/survivalpod)
"n" = (
/obj/structure/fans/tiny,
/obj/machinery/door/airlock/voidcraft/survival_pod,
/obj/effect/floor_decal/industrial/danger/full,
/turf/simulated/shuttle/floor/voidcraft,
/area/survivalpod)
"p" = (
/obj/structure/table/reinforced,
/obj/machinery/microwave{
	pixel_y = 6
	},
/obj/machinery/light,
/obj/effect/floor_decal/industrial/warning/dust{
	dir = 4
	},
/turf/simulated/shuttle/floor/voidcraft/light,
/area/survivalpod)
"q" = (
/obj/structure/closet/secure_closet/freezer/fridge,
/obj/machinery/light{
	dir = 4
	},
/obj/fruitspawner/tomato,
/obj/fruitspawner/tomato,
/obj/fruitspawner/tomato,
/obj/fruitspawner/tomato,
/obj/fruitspawner/apple,
/obj/fruitspawner/apple,
/obj/fruitspawner/apple,
/obj/fruitspawner/apple,
/obj/effect/floor_decal/industrial/warning/dust/corner{
	dir = 8
	},
/turf/simulated/shuttle/floor/voidcraft/light,
/area/survivalpod)
"r" = (
/obj/structure/sign/mining,
/turf/simulated/shuttle/wall/voidcraft/survival,
/area/survivalpod)
"v" = (
/obj/machinery/disposal/wall{
	dir = 1
	},
/obj/structure/disposalpipe/trunk{
	dir = 1
	},
/turf/simulated/floor/tiled/eris/cafe,
/area/survivalpod)
"y" = (
/obj/structure/table/reinforced,
/obj/machinery/reagentgrinder{
	pixel_y = 9
	},
/obj/item/reagent_containers/dropper{
	pixel_y = -9;
	pixel_x = -3
	},
/obj/effect/floor_decal/industrial/warning/dust{
	dir = 9
	},
/turf/simulated/shuttle/floor/voidcraft/light,
/area/survivalpod)
"z" = (
/obj/structure/sink/kitchen{
	dir = 8;
	pixel_x = -13
	},
/turf/simulated/floor/tiled/eris/cafe,
/area/survivalpod)
"A" = (
/obj/effect/floor_decal/industrial/warning/dust{
	dir = 5
	},
/obj/machinery/vending/dinnerware{
	dir = 4
	},
/turf/simulated/shuttle/floor/voidcraft/light,
/area/survivalpod)
"C" = (
/obj/structure/disposalpipe/segment{
	dir = 8;
	icon_state = "pipe-c"
	},
/turf/simulated/shuttle/wall/voidcraft/survival,
/area/survivalpod)
"D" = (
/obj/machinery/button/remote/airlock/survival_pod/bolts{
	pixel_y = -24;
	pixel_x = 21
	},
/turf/simulated/floor/tiled/eris/cafe,
/area/survivalpod)
"F" = (
/obj/structure/disposalpipe/segment{
	dir = 4;
	icon_state = "pipe-c"
	},
/turf/simulated/shuttle/wall/voidcraft/survival,
/area/survivalpod)
"G" = (
/obj/structure/table/reinforced,
/obj/item/material/kitchen/rollingpin{
	pixel_y = 23;
	pixel_x = 3
	},
/obj/item/reagent_containers/food/condiment/enzyme{
	layer = 5;
	pixel_x = -9;
	pixel_y = 22
	},
/obj/item/material/knife/butch{
	pixel_y = 15;
	pixel_x = 4
	},
/obj/item/book/manual/chef_recipes{
	pixel_x = -9;
	pixel_y = -3
	},
/obj/item/book/manual/cook_guide{
	pixel_x = 6;
	pixel_y = -3
	},
/obj/machinery/light,
/obj/effect/floor_decal/industrial/warning/dust{
	dir = 8
	},
/turf/simulated/shuttle/floor/voidcraft/light,
/area/survivalpod)
"H" = (
/obj/structure/table/reinforced,
/obj/structure/disposalpipe/segment{
	dir = 8;
	icon_state = "pipe-c"
	},
/turf/simulated/floor/tiled/eris/cafe,
/area/survivalpod)
"I" = (
/obj/structure/table/reinforced,
/obj/structure/disposalpipe/segment{
	dir = 2;
	icon_state = "pipe-c"
	},
/turf/simulated/floor/tiled/eris/cafe,
/area/survivalpod)
"J" = (
/obj/machinery/button/remote/airlock/survival_pod/bolts{
	pixel_y = -21;
	pixel_x = -24;
	dir = 8
	},
/turf/simulated/floor/tiled/eris/cafe,
/area/survivalpod)
"N" = (
/obj/machinery/button/remote/airlock/survival_pod/bolts{
	pixel_y = -21;
	pixel_x = 24;
	dir = 4
	},
/turf/simulated/floor/tiled/eris/cafe,
/area/survivalpod)
"O" = (
/turf/simulated/floor/tiled/eris/cafe,
/area/survivalpod)
"P" = (
/obj/effect/floor_decal/industrial/warning/dust,
/obj/machinery/appliance/cooker/fryer,
/obj/structure/disposalpipe/segment{
	dir = 2;
	icon_state = "pipe-c"
	},
/turf/simulated/shuttle/floor/voidcraft/light,
/area/survivalpod)
"S" = (
/obj/structure/table/reinforced,
/obj/item/reagent_containers/food/condiment/carton/flour,
/obj/item/reagent_containers/food/condiment/carton/flour,
/obj/item/reagent_containers/food/condiment/carton/flour,
/obj/item/reagent_containers/food/condiment/carton/flour,
/obj/item/reagent_containers/food/condiment/carton/flour,
/obj/item/reagent_containers/food/condiment/carton/flour,
/obj/item/reagent_containers/food/condiment/carton/flour,
/obj/item/reagent_containers/food/condiment/carton/flour,
/obj/item/reagent_containers/food/condiment/spacespice,
/obj/item/reagent_containers/food/condiment/spacespice,
/obj/item/reagent_containers/food/condiment/carton/sugar,
/obj/item/reagent_containers/food/condiment/carton/sugar,
/obj/item/reagent_containers/food/condiment/small/saltshaker,
/obj/item/reagent_containers/food/condiment/small/saltshaker,
/obj/item/reagent_containers/food/condiment/small/peppermill,
/obj/item/reagent_containers/food/condiment/small/peppermill,
/obj/random/donkpocketbox,
/obj/item/storage/box/beakers{
	name = "box of measuring cups";
	pixel_x = 2;
	pixel_y = 3;
	starts_with = list(/obj/item/reagent_containers/glass/beaker/measuring_cup = 7)
	},
/obj/structure/closet/walllocker_double/kitchen/north,
/obj/effect/floor_decal/industrial/warning/dust,
/turf/simulated/shuttle/floor/voidcraft/light,
/area/survivalpod)
"U" = (
/obj/structure/sign/mining/survival{
	dir = 1
	},
/turf/simulated/shuttle/wall/voidcraft/survival,
/area/survivalpod)
"V" = (
/obj/machinery/appliance/cooker/grill,
/obj/effect/floor_decal/industrial/warning/dust,
/obj/structure/disposalpipe/segment{
	dir = 1;
	icon_state = "pipe-c"
	},
/turf/simulated/shuttle/floor/voidcraft/light,
/area/survivalpod)
"Y" = (
/obj/structure/sign/mining/survival,
/turf/simulated/shuttle/wall/voidcraft/survival,
/area/survivalpod)
"Z" = (
/obj/machinery/appliance/cooker/oven,
/obj/effect/floor_decal/industrial/warning/dust,
/turf/simulated/shuttle/floor/voidcraft/light,
/area/survivalpod)

(1,1,1) = {"
d
b
d
h
d
b
d
"}
(2,1,1) = {"
U
Z
z
J
A
p
Y
"}
(3,1,1) = {"
F
V
i
g
i
v
d
"}
(4,1,1) = {"
C
P
m
I
H
D
n
"}
(5,1,1) = {"
d
S
O
O
O
O
d
"}
(6,1,1) = {"
U
q
f
N
y
G
r
"}
(7,1,1) = {"
d
a
d
h
d
a
d
"}
