//MAP CONVERTED BY dmm2tgm.py THIS HEADER COMMENT PREVENTS RECONVERSION, DO NOT REMOVE
"a" = (
/obj/structure/sign/poster/custom{
	dir = 1;
	pixel_y = 32;
	poster_decl = /decl/poster/nanotrasen/pol_6
	},
/turf/template_noop,
/area/template_noop)
"e" = (
/obj/effect/floor_decal/borderfloor{
	dir = 1
	},
/obj/effect/floor_decal/corner/purple/border{
	dir = 1
	},
/obj/structure/table/steel,
/obj/random/maintenance/clean,
/obj/random/maintenance/clean,
/obj/random/maintenance/clean,
/obj/random/maintenance/engineering,
/obj/effect/spider/stickyweb,
/obj/machinery/requests_console{
	department = "Janitorial";
	departmentType = 1;
	name = "Janitorial RC";
	pixel_y = 24
	},
/turf/simulated/floor/tiled/steel_dirty,
/area/template_noop)
"j" = (
/obj/effect/floor_decal/borderfloor/corner,
/obj/effect/floor_decal/corner/purple/bordercorner,
/obj/machinery/light_construct{
	dir = 4
	},
/obj/structure/mopbucket,
/obj/item/mop,
/obj/effect/spider/stickyweb,
/turf/simulated/floor/tiled/steel_dirty,
/area/template_noop)
"l" = (
/obj/effect/floor_decal/borderfloor/corner{
	dir = 4
	},
/obj/effect/floor_decal/corner/purple/bordercorner{
	dir = 4
	},
/obj/item/reagent_containers/glass/bucket,
/obj/structure/sink/generic{
	dir = 8;
	pixel_x = 12;
	pixel_y = -4
	},
/obj/effect/spider/stickyweb,
/turf/simulated/floor/tiled,
/area/template_noop)
"o" = (
/turf/simulated/wall/concrete,
/area/template_noop)
"p" = (
/obj/effect/floor_decal/borderfloor/corner{
	dir = 1
	},
/obj/effect/floor_decal/corner/purple/bordercorner{
	dir = 1
	},
/obj/machinery/light{
	dir = 8
	},
/obj/effect/spider/stickyweb,
/turf/simulated/floor/tiled/steel_dirty,
/area/template_noop)
"q" = (
/obj/effect/floor_decal/borderfloor{
	dir = 6
	},
/obj/effect/floor_decal/corner/purple/border{
	dir = 6
	},
/obj/item/camera_assembly,
/obj/effect/spider/stickyweb,
/turf/simulated/floor/tiled/steel_dirty,
/area/template_noop)
"r" = (
/obj/effect/spider/stickyweb,
/obj/machinery/atmospherics/pipe/simple/hidden/scrubbers{
	dir = 4
	},
/turf/simulated/floor/tiled/steel_dirty,
/area/template_noop)
"t" = (
/obj/effect/spider/stickyweb,
/obj/machinery/atmospherics/unary/vent_pump,
/turf/simulated/floor/tiled/steel_dirty,
/area/template_noop)
"u" = (
/obj/effect/spider/stickyweb,
/obj/machinery/atmospherics/pipe/simple/hidden/supply{
	dir = 9
	},
/obj/machinery/atmospherics/pipe/cap/hidden/scrubbers{
	dir = 4
	},
/turf/simulated/floor/tiled/steel_dirty,
/area/template_noop)
"y" = (
/obj/item/stool{
	dir = 1
	},
/obj/effect/spider/stickyweb,
/turf/simulated/floor/tiled/steel_dirty,
/area/template_noop)
"z" = (
/obj/effect/floor_decal/borderfloor/corner{
	dir = 8
	},
/obj/effect/floor_decal/corner/purple/bordercorner{
	dir = 8
	},
/obj/effect/decal/remains/mouse,
/obj/effect/spider/stickyweb,
/turf/simulated/floor/tiled/steel_dirty,
/area/template_noop)
"C" = (
/turf/simulated/wall/r_concrete,
/area/template_noop)
"D" = (
/obj/effect/decal/cleanable/cobweb2{
	icon_state = "spiderling";
	name = "dead spider"
	},
/obj/effect/spider/stickyweb,
/obj/machinery/atmospherics/unary/vent_scrubber{
	dir = 1
	},
/turf/simulated/floor/tiled/steel_dirty,
/area/template_noop)
"G" = (
/obj/effect/floor_decal/borderfloor{
	dir = 9
	},
/obj/effect/floor_decal/corner/purple/border{
	dir = 9
	},
/obj/item/stool/padded{
	dir = 8
	},
/obj/random/plushie,
/obj/effect/spider/stickyweb,
/obj/machinery/firealarm{
	pixel_y = 24
	},
/turf/simulated/floor/tiled/steel_dirty,
/area/template_noop)
"H" = (
/obj/effect/spider/stickyweb,
/obj/machinery/atmospherics/pipe/simple/hidden/scrubbers{
	dir = 10
	},
/turf/simulated/floor/tiled/steel_dirty,
/area/template_noop)
"I" = (
/obj/effect/floor_decal/borderfloor,
/obj/effect/floor_decal/corner/purple/border,
/obj/structure/loot_pile/maint/trash,
/obj/effect/spider/stickyweb,
/turf/simulated/floor/tiled/steel_dirty,
/area/template_noop)
"J" = (
/obj/effect/floor_decal/borderfloor{
	dir = 1
	},
/obj/effect/floor_decal/corner/purple/border{
	dir = 1
	},
/obj/structure/table/steel,
/obj/item/storage/box/mousetraps,
/obj/item/storage/box/lights/mixed,
/obj/item/reagent_containers/spray/cleaner{
	pixel_x = 2;
	pixel_y = 2
	},
/obj/effect/spider/stickyweb,
/obj/machinery/newscaster{
	pixel_y = 26
	},
/turf/simulated/floor/tiled/steel_dirty,
/area/template_noop)
"K" = (
/obj/effect/decal/cleanable/cobweb2{
	icon_state = "spiderling";
	name = "dead spider"
	},
/obj/effect/floor_decal/steeldecal/steel_decals4{
	dir = 1
	},
/obj/effect/floor_decal/steeldecal/steel_decals4{
	dir = 6
	},
/obj/structure/cable{
	d1 = 2;
	d2 = 8;
	icon_state = "2-8"
	},
/obj/effect/spider/stickyweb,
/obj/effect/catwalk_plated,
/obj/machinery/atmospherics/pipe/cap/hidden/supply{
	dir = 4
	},
/turf/simulated/floor/plating,
/area/template_noop)
"L" = (
/obj/effect/floor_decal/borderfloor{
	dir = 10
	},
/obj/effect/floor_decal/corner/purple/border{
	dir = 10
	},
/obj/structure/closet/jcloset,
/obj/item/clothing/mask/gas/clear,
/obj/random/soap,
/obj/effect/spider/stickyweb,
/turf/simulated/floor/tiled/steel_dirty,
/area/template_noop)
"M" = (
/obj/effect/floor_decal/steeldecal/steel_decals4,
/obj/effect/floor_decal/steeldecal/steel_decals4{
	dir = 10
	},
/obj/effect/spider/stickyweb,
/turf/simulated/floor/tiled/steel_dirty,
/area/template_noop)
"N" = (
/obj/effect/floor_decal/borderfloor{
	dir = 5
	},
/obj/effect/floor_decal/corner/purple/border{
	dir = 5
	},
/obj/machinery/disposal,
/obj/effect/spider/stickyweb,
/turf/simulated/floor/tiled/steel_dirty,
/area/template_noop)
"O" = (
/obj/effect/floor_decal/borderfloor,
/obj/effect/floor_decal/corner/purple/border,
/obj/effect/floor_decal/steeldecal/steel_decals_central7,
/obj/structure/cable,
/obj/effect/spider/stickyweb,
/obj/structure/sign/poster/nanotrasen{
	dir = 8;
	pixel_x = -32;
	poster_decl = /decl/poster/nanotrasen/pol_7
	},
/obj/machinery/power/apc{
	name = "south bump";
	operating = 0;
	pixel_y = -24
	},
/obj/machinery/light_switch{
	dir = 1;
	pixel_x = -12;
	pixel_y = -24
	},
/turf/simulated/floor/tiled/steel_dirty,
/area/template_noop)
"P" = (
/obj/effect/floor_decal/borderfloor{
	dir = 1
	},
/obj/effect/floor_decal/corner/purple/border{
	dir = 1
	},
/obj/structure/table/steel,
/obj/item/paper_bin,
/obj/item/pen,
/obj/effect/decal/cleanable/cobweb2{
	icon_state = "spiderling";
	name = "dead spider"
	},
/obj/effect/spider/stickyweb,
/obj/item/radio/intercom{
	dir = 1;
	pixel_y = 21
	},
/turf/simulated/floor/tiled/steel_dirty,
/area/template_noop)
"Q" = (
/obj/effect/floor_decal/borderfloor,
/obj/effect/floor_decal/corner/purple/border,
/obj/structure/closet/crate/trashcart,
/obj/random/contraband,
/obj/random/maintenance,
/obj/random/maintenance,
/obj/random/junk,
/obj/effect/spider/stickyweb,
/obj/machinery/alarm{
	dir = 1;
	pixel_y = -22
	},
/turf/simulated/floor/tiled/steel_dirty,
/area/template_noop)
"T" = (
/turf/simulated/wall/concrete{
	can_open = 1
	},
/area/template_noop)
"W" = (
/obj/random/trash,
/obj/effect/spider/stickyweb,
/turf/simulated/floor/tiled/steel_dirty,
/area/template_noop)
"X" = (
/obj/effect/decal/cleanable/spiderling_remains,
/obj/effect/spider/stickyweb,
/turf/simulated/floor/tiled/steel_grid,
/area/template_noop)
"Z" = (
/obj/effect/spider/stickyweb,
/turf/simulated/floor/tiled/steel_dirty,
/area/template_noop)

(1,1,1) = {"
o
o
o
T
o
o
a
"}
(2,1,1) = {"
C
G
p
K
O
o
o
"}
(3,1,1) = {"
C
J
t
u
z
L
o
"}
(4,1,1) = {"
C
P
y
r
Z
I
o
"}
(5,1,1) = {"
C
e
W
H
D
Q
o
"}
(6,1,1) = {"
C
N
l
M
j
q
o
"}
(7,1,1) = {"
C
o
o
X
o
o
o
"}
