//MAP CONVERTED BY dmm2tgm.py THIS HEADER COMMENT PREVENTS RECONVERSION, DO NOT REMOVE
"aq" = (
/obj/machinery/light/small{
	dir = 8
	},
/turf/simulated/floor/airless,
/area/shuttle/mackerel_lc_wreck)
"az" = (
/obj/machinery/shipsensors/weak{
	desc = "Miniaturized gravity scanner with various other sensors, used to detect irregularities in surrounding space. Can only run in vacuum to protect delicate quantum bluespace elements. Appears to be slightly damaged, but it should still work.";
	dir = 1;
	name = "damaged sensors suite"
	},
/turf/simulated/floor/airless,
/area/shuttle/mackerel_lc_wreck)
"aF" = (
/obj/machinery/door/firedoor/glass,
/obj/structure/grille,
/obj/structure/window/reinforced{
	dir = 8
	},
/obj/structure/window/reinforced{
	dir = 1
	},
/obj/item/material/shard,
/turf/simulated/floor/airless,
/area/shuttle/mackerel_lc_wreck)
"bw" = (
/obj/machinery/computer/ship/helm{
	req_one_access = list()
	},
/turf/simulated/floor/tiled/techmaint/airless,
/area/shuttle/mackerel_lc_wreck)
"bI" = (
/obj/machinery/atmospherics/pipe/simple/visible/yellow{
	dir = 6
	},
/turf/simulated/floor/airless,
/area/shuttle/mackerel_lc_wreck)
"bY" = (
/obj/machinery/atmospherics/pipe/manifold/hidden/scrubbers{
	dir = 4
	},
/obj/structure/cable{
	icon_state = "1-2"
	},
/turf/simulated/floor/tiled/techmaint,
/area/shuttle/mackerel_lc_wreck)
"ca" = (
/obj/machinery/atmospherics/pipe/simple/visible/yellow{
	dir = 4
	},
/obj/structure/girder,
/turf/simulated/floor/airless,
/area/shuttle/mackerel_lc_wreck)
"cg" = (
/obj/machinery/door/firedoor/glass,
/obj/structure/cable{
	icon_state = "1-2"
	},
/obj/machinery/door/airlock/hatch{
	req_one_access = list()
	},
/turf/simulated/floor/tiled/techmaint,
/area/shuttle/mackerel_lc_wreck)
"cv" = (
/obj/machinery/computer/shuttle_control/explore/mackerel_lc_wreck,
/obj/item/material/shard,
/turf/simulated/floor/tiled/techmaint/airless,
/area/shuttle/mackerel_lc_wreck)
"cD" = (
/obj/effect/floor_decal/industrial/warning,
/obj/item/material/shard/shrapnel,
/obj/item/material/shard/shrapnel,
/turf/simulated/floor/tiled/techmaint/airless,
/area/shuttle/mackerel_lc_wreck)
"dG" = (
/obj/machinery/atmospherics/pipe/manifold/visible/yellow,
/turf/simulated/floor/airless,
/area/shuttle/mackerel_lc_wreck)
"fL" = (
/obj/machinery/atmospherics/portables_connector,
/obj/effect/floor_decal/industrial/outline/yellow,
/obj/machinery/portable_atmospherics/canister/empty/phoron,
/turf/simulated/floor/airless,
/area/shuttle/mackerel_lc_wreck)
"gT" = (
/obj/machinery/atmospherics/unary/vent_scrubber/on,
/obj/structure/bed/chair/bay/shuttle{
	dir = 1
	},
/obj/item/material/shard,
/obj/item/material/shard/shrapnel,
/turf/simulated/floor/tiled/techmaint/airless,
/area/shuttle/mackerel_lc_wreck)
"ju" = (
/obj/machinery/light/small/flicker{
	dir = 1
	},
/turf/simulated/floor/airless,
/area/shuttle/mackerel_lc_wreck)
"ka" = (
/turf/simulated/wall/shull,
/area/shuttle/mackerel_lc_wreck)
"kf" = (
/obj/structure/hull_corner{
	dir = 1
	},
/turf/template_noop,
/area/shuttle/mackerel_lc_wreck)
"kU" = (
/obj/machinery/atmospherics/pipe/simple/visible/yellow,
/obj/machinery/light/small{
	dir = 8
	},
/turf/simulated/floor/airless,
/area/shuttle/mackerel_lc_wreck)
"lo" = (
/obj/machinery/atmospherics/pipe/simple/hidden/supply,
/obj/effect/floor_decal/industrial/warning/corner{
	dir = 4
	},
/obj/structure/railing/grey{
	dir = 1
	},
/obj/random/empty_or_lootable_crate,
/turf/simulated/floor/tiled/techfloor,
/area/shuttle/mackerel_lc_wreck)
"lC" = (
/obj/machinery/atmospherics/pipe/simple/hidden/scrubbers,
/obj/structure/closet/walllocker/emerglocker/west,
/obj/effect/floor_decal/industrial/warning/corner,
/obj/item/material/shard,
/obj/machinery/light/flicker,
/turf/simulated/floor/tiled/techmaint/airless,
/area/shuttle/mackerel_lc_wreck)
"lT" = (
/obj/machinery/atmospherics/pipe/simple/hidden/supply,
/obj/effect/floor_decal/industrial/warning/corner,
/obj/structure/extinguisher_cabinet{
	dir = 8;
	pixel_x = 30
	},
/obj/structure/railing/grey,
/obj/machinery/light{
	dir = 4
	},
/obj/random/empty_or_lootable_crate,
/turf/simulated/floor/tiled/techfloor,
/area/shuttle/mackerel_lc_wreck)
"mf" = (
/obj/machinery/atmospherics/pipe/simple/hidden/supply,
/obj/machinery/alarm/alarms_hidden{
	dir = 8;
	pixel_x = 26
	},
/obj/effect/floor_decal/industrial/warning/corner{
	dir = 8
	},
/obj/item/tank/oxygen,
/obj/item/material/shard,
/obj/machinery/light,
/turf/simulated/floor/tiled/techmaint/airless,
/area/shuttle/mackerel_lc_wreck)
"mi" = (
/obj/structure/shuttle/engine/heater,
/obj/machinery/atmospherics/pipe/simple/visible/yellow,
/turf/simulated/floor/airless,
/area/shuttle/mackerel_lc_wreck)
"mw" = (
/obj/structure/handrail,
/obj/machinery/atmospherics/unary/vent_pump{
	dir = 1
	},
/obj/effect/map_helper/airlock/sensor/chamber_sensor,
/obj/effect/map_helper/airlock/atmos/chamber_pump,
/obj/effect/floor_decal/industrial/warning{
	dir = 4
	},
/obj/effect/floor_decal/industrial/warning{
	dir = 8
	},
/obj/machinery/airlock_sensor{
	pixel_x = -8;
	pixel_y = 21
	},
/obj/machinery/light,
/obj/machinery/embedded_controller/radio/airlock/docking_port_multi{
	id_tag = "mackerel_lc_wreck_docking_port";
	name = "Port Airlock Control";
	pixel_x = 8;
	pixel_y = 22
	},
/turf/simulated/floor/tiled/techmaint,
/area/shuttle/mackerel_lc_wreck)
"nu" = (
/obj/structure/grille/broken,
/turf/simulated/floor/airless,
/area/shuttle/mackerel_lc_wreck)
"nD" = (
/obj/structure/closet/crate/engineering/electrical,
/obj/item/tank/phoron,
/turf/simulated/floor/tiled/techfloor,
/area/shuttle/mackerel_lc_wreck)
"oe" = (
/obj/structure/lattice,
/turf/template_noop,
/area/shuttle/mackerel_lc_wreck)
"oq" = (
/turf/simulated/floor/airless,
/area/shuttle/mackerel_lc_wreck)
"oG" = (
/turf/template_noop,
/area/shuttle/mackerel_lc_wreck)
"pi" = (
/obj/structure/handrail{
	dir = 4
	},
/turf/simulated/floor/airless,
/area/shuttle/mackerel_lc_wreck)
"pT" = (
/obj/machinery/door/firedoor/glass,
/obj/structure/grille/broken,
/turf/simulated/floor/airless,
/area/shuttle/mackerel_lc_wreck)
"pZ" = (
/obj/machinery/door/airlock/hatch,
/obj/effect/map_helper/airlock/door/ext_door,
/obj/effect/map_helper/airlock/sensor/ext_sensor,
/obj/machinery/airlock_sensor/airlock_exterior/shuttle{
	dir = 10;
	pixel_x = -8;
	pixel_y = 26
	},
/obj/machinery/door/firedoor/glass,
/turf/simulated/floor/tiled/techmaint,
/area/shuttle/mackerel_lc_wreck)
"rc" = (
/obj/machinery/atmospherics/pipe/simple/hidden/scrubbers{
	dir = 6
	},
/obj/effect/floor_decal/industrial/warning/corner{
	dir = 1
	},
/obj/structure/railing/grey{
	dir = 1
	},
/obj/random/empty_or_lootable_crate,
/turf/simulated/floor/tiled/techfloor,
/area/shuttle/mackerel_lc_wreck)
"rr" = (
/obj/machinery/atmospherics/pipe/simple/hidden/supply,
/obj/effect/floor_decal/industrial/warning/corner{
	dir = 8
	},
/obj/effect/floor_decal/industrial/warning{
	dir = 4
	},
/obj/machinery/embedded_controller/radio/docking_port_multi{
	child_names_txt = "Port Airlock Control;Starboard Airlock Control";
	child_tags_txt = "mackerel_lc_wreck_docking_port;mackerel_lc_wreck_docking_star";
	dir = 1;
	id_tag = "mackerel_lc_wreck_docking";
	pixel_y = -22
	},
/turf/simulated/floor/tiled/techfloor,
/area/shuttle/mackerel_lc_wreck)
"rQ" = (
/obj/machinery/light/small/flicker{
	dir = 4
	},
/obj/machinery/atmospherics/pipe/simple/visible/yellow,
/turf/simulated/floor/airless,
/area/shuttle/mackerel_lc_wreck)
"rX" = (
/obj/machinery/door/firedoor/glass,
/obj/structure/grille,
/obj/structure/window/reinforced{
	dir = 1
	},
/obj/structure/window/reinforced{
	dir = 4
	},
/obj/item/material/shard,
/obj/item/material/shard,
/turf/simulated/floor/airless,
/area/shuttle/mackerel_lc_wreck)
"sg" = (
/obj/machinery/atmospherics/pipe/simple/visible/yellow{
	dir = 4
	},
/obj/machinery/atmospherics/pipe/simple/hidden/supply,
/obj/effect/floor_decal/industrial/warning/corner{
	dir = 1
	},
/obj/structure/cable{
	icon_state = "0-8"
	},
/obj/item/frame/apc,
/obj/item/trash/material/circuit,
/turf/simulated/floor/tiled/techfloor,
/area/shuttle/mackerel_lc_wreck)
"sL" = (
/obj/machinery/atmospherics/pipe/simple/hidden/supply,
/obj/machinery/airlock_sensor{
	pixel_x = 24
	},
/obj/effect/map_helper/airlock/sensor/int_sensor,
/obj/effect/floor_decal/industrial/warning/corner,
/obj/structure/railing/grey,
/obj/random/empty_or_lootable_crate,
/turf/simulated/floor/tiled/techfloor,
/area/shuttle/mackerel_lc_wreck)
"sX" = (
/turf/simulated/floor/tiled/techmaint,
/area/shuttle/mackerel_lc_wreck)
"sZ" = (
/obj/machinery/atmospherics/pipe/simple/hidden/scrubbers,
/turf/simulated/wall/rshull,
/area/shuttle/mackerel_lc_wreck)
"tV" = (
/obj/machinery/atmospherics/pipe/simple/visible/yellow{
	dir = 4
	},
/turf/simulated/wall/shull,
/area/shuttle/mackerel_lc_wreck)
"ue" = (
/obj/structure/closet/crate/engineering,
/obj/item/storage/toolbox/mechanical,
/obj/item/storage/toolbox/electrical,
/obj/item/module/power_control,
/turf/simulated/floor/tiled/techfloor,
/area/shuttle/mackerel_lc_wreck)
"ug" = (
/obj/machinery/door/firedoor/glass,
/obj/machinery/door/airlock/hatch{
	req_one_access = list()
	},
/turf/simulated/floor/tiled/techmaint,
/area/shuttle/mackerel_lc_wreck)
"um" = (
/obj/machinery/atmospherics/unary/vent_scrubber/on{
	dir = 1
	},
/obj/machinery/light/flicker{
	dir = 8
	},
/obj/structure/closet/walllocker/emerglocker/west,
/turf/simulated/floor/tiled/techfloor,
/area/shuttle/mackerel_lc_wreck)
"ut" = (
/obj/machinery/atmospherics/pipe/simple/hidden/scrubbers,
/obj/effect/floor_decal/industrial/warning/corner,
/obj/effect/floor_decal/industrial/warning{
	dir = 8
	},
/obj/structure/closet/walllocker/emerglocker/south,
/turf/simulated/floor/tiled/techfloor,
/area/shuttle/mackerel_lc_wreck)
"uR" = (
/obj/machinery/atmospherics/pipe/manifold/hidden/supply{
	dir = 8
	},
/turf/simulated/wall/rshull,
/area/shuttle/mackerel_lc_wreck)
"we" = (
/obj/structure/shuttle/engine/heater,
/obj/machinery/atmospherics/pipe/simple/visible/yellow,
/turf/simulated/floor/tiled/techfloor,
/area/shuttle/mackerel_lc_wreck)
"wF" = (
/obj/machinery/atmospherics/pipe/simple/hidden/scrubbers,
/obj/structure/cable{
	icon_state = "4-8"
	},
/obj/effect/floor_decal/industrial/warning/corner{
	dir = 8
	},
/obj/structure/railing/grey,
/obj/random/empty_or_lootable_crate,
/turf/simulated/floor/tiled/techfloor,
/area/shuttle/mackerel_lc_wreck)
"wN" = (
/obj/machinery/atmospherics/pipe/simple/hidden,
/turf/simulated/wall/shull,
/area/shuttle/mackerel_lc_wreck)
"wQ" = (
/obj/structure/grille,
/turf/simulated/floor/airless,
/area/shuttle/mackerel_lc_wreck)
"xd" = (
/obj/machinery/atmospherics/pipe/simple/hidden/supply,
/obj/effect/floor_decal/industrial/warning{
	dir = 4
	},
/turf/simulated/floor/tiled/techmaint,
/area/shuttle/mackerel_lc_wreck)
"xB" = (
/obj/machinery/atmospherics/pipe/simple/hidden/supply{
	dir = 4
	},
/turf/simulated/wall/rshull,
/area/shuttle/mackerel_lc_wreck)
"yH" = (
/obj/structure/handrail,
/turf/simulated/floor/airless,
/area/shuttle/mackerel_lc_wreck)
"zo" = (
/obj/machinery/atmospherics/portables_connector,
/obj/effect/floor_decal/industrial/outline/yellow,
/obj/machinery/portable_atmospherics/canister/phoron,
/turf/simulated/floor/airless,
/area/shuttle/mackerel_lc_wreck)
"zq" = (
/obj/structure/cable{
	icon_state = "4-8"
	},
/turf/simulated/wall/rshull,
/area/shuttle/mackerel_lc_wreck)
"zr" = (
/obj/machinery/atmospherics/pipe/simple/hidden/scrubbers,
/obj/structure/cable{
	icon_state = "1-2"
	},
/turf/simulated/floor/tiled/techmaint,
/area/shuttle/mackerel_lc_wreck)
"BB" = (
/obj/item/material/shard/shrapnel,
/turf/template_noop,
/area/template_noop)
"BN" = (
/obj/machinery/atmospherics/pipe/simple/hidden/supply,
/turf/simulated/wall/rshull,
/area/shuttle/mackerel_lc_wreck)
"BP" = (
/obj/machinery/atmospherics/pipe/manifold/visible/yellow{
	dir = 1
	},
/obj/structure/cable{
	icon_state = "1-4"
	},
/obj/effect/floor_decal/industrial/warning{
	dir = 1
	},
/obj/machinery/meter,
/turf/simulated/floor/tiled/techfloor,
/area/shuttle/mackerel_lc_wreck)
"Cf" = (
/obj/structure/handrail{
	dir = 8
	},
/turf/simulated/floor/airless,
/area/shuttle/mackerel_lc_wreck)
"Ck" = (
/obj/machinery/atmospherics/pipe/simple/hidden/scrubbers,
/obj/effect/floor_decal/industrial/warning/corner{
	dir = 8
	},
/obj/structure/extinguisher_cabinet{
	dir = 4;
	pixel_x = -30
	},
/obj/structure/railing/grey,
/obj/machinery/light/flicker{
	dir = 8
	},
/obj/random/empty_or_lootable_crate,
/turf/simulated/floor/tiled/techfloor,
/area/shuttle/mackerel_lc_wreck)
"Da" = (
/obj/machinery/atmospherics/portables_connector{
	dir = 8
	},
/obj/effect/floor_decal/industrial/outline/blue,
/turf/simulated/floor/airless,
/area/shuttle/mackerel_lc_wreck)
"Dl" = (
/obj/machinery/atmospherics/unary/vent_pump/on{
	dir = 4
	},
/obj/structure/cable{
	icon_state = "2-8"
	},
/turf/simulated/floor/tiled/techmaint,
/area/shuttle/mackerel_lc_wreck)
"Do" = (
/obj/machinery/light/small{
	dir = 4
	},
/turf/simulated/floor/airless,
/area/shuttle/mackerel_lc_wreck)
"EC" = (
/obj/machinery/atmospherics/pipe/simple/hidden/scrubbers,
/obj/effect/floor_decal/industrial/warning{
	dir = 8
	},
/obj/effect/floor_decal/industrial/warning/corner{
	dir = 4
	},
/obj/structure/closet/walllocker/emerglocker/north,
/turf/simulated/floor/tiled/techfloor,
/area/shuttle/mackerel_lc_wreck)
"EK" = (
/obj/machinery/atmospherics/pipe/simple/hidden/supply,
/obj/effect/floor_decal/industrial/warning{
	dir = 4
	},
/obj/machinery/alarm/alarms_hidden{
	pixel_y = 26
	},
/obj/effect/floor_decal/industrial/warning/corner{
	dir = 1
	},
/turf/simulated/floor/tiled/techfloor,
/area/shuttle/mackerel_lc_wreck)
"EL" = (
/obj/structure/symbol/maint,
/turf/simulated/wall/rshull{
	can_open = 1
	},
/area/shuttle/mackerel_lc_wreck)
"FH" = (
/obj/machinery/atmospherics/pipe/simple/hidden/scrubbers,
/obj/effect/floor_decal/industrial/warning/corner{
	dir = 1
	},
/obj/structure/railing/grey{
	dir = 1
	},
/obj/machinery/light{
	dir = 8
	},
/obj/random/empty_or_lootable_crate,
/turf/simulated/floor/tiled/techfloor,
/area/shuttle/mackerel_lc_wreck)
"FL" = (
/obj/effect/map_helper/airlock/door/ext_door,
/obj/effect/map_helper/airlock/sensor/ext_sensor,
/obj/machinery/airlock_sensor/airlock_exterior/shuttle{
	dir = 6;
	pixel_x = 7;
	pixel_y = 26
	},
/obj/machinery/door/firedoor/glass,
/obj/machinery/door/airlock/hatch{
	density = 0;
	icon_state = "door_open";
	opacity = 0
	},
/turf/simulated/floor/tiled/techmaint/airless,
/area/shuttle/mackerel_lc_wreck)
"FS" = (
/obj/machinery/atmospherics/pipe/simple/visible/yellow,
/obj/machinery/computer/ship/engines{
	dir = 1
	},
/turf/simulated/floor/tiled/techfloor,
/area/shuttle/mackerel_lc_wreck)
"Gm" = (
/obj/machinery/atmospherics/unary/engine{
	dir = 1
	},
/obj/structure/window/reinforced{
	dir = 1
	},
/turf/simulated/floor/airless,
/area/shuttle/mackerel_lc_wreck)
"GF" = (
/obj/machinery/power/smes/buildable,
/obj/structure/cable{
	icon_state = "0-4"
	},
/turf/simulated/floor/airless,
/area/shuttle/mackerel_lc_wreck)
"GK" = (
/obj/machinery/atmospherics/pipe/manifold/hidden/supply{
	dir = 4
	},
/obj/effect/floor_decal/industrial/warning/corner,
/obj/structure/railing/grey,
/obj/random/empty_or_lootable_crate,
/turf/simulated/floor/tiled/techfloor,
/area/shuttle/mackerel_lc_wreck)
"He" = (
/obj/machinery/computer/ship/sensors,
/turf/simulated/floor/tiled/techmaint/airless,
/area/shuttle/mackerel_lc_wreck)
"HI" = (
/obj/machinery/atmospherics/pipe/simple/hidden/supply,
/obj/effect/floor_decal/industrial/warning/corner{
	dir = 4
	},
/obj/structure/railing/grey{
	dir = 1
	},
/obj/machinery/light{
	dir = 4
	},
/obj/random/empty_or_lootable_crate,
/turf/simulated/floor/tiled/techfloor,
/area/shuttle/mackerel_lc_wreck)
"Ib" = (
/obj/effect/map_helper/airlock/door/int_door,
/obj/machinery/door/airlock/hatch,
/turf/simulated/floor/tiled/techmaint,
/area/shuttle/mackerel_lc_wreck)
"Iu" = (
/obj/structure/prop/blackbox/mackerel_wreck,
/turf/simulated/floor/airless,
/area/shuttle/mackerel_lc_wreck)
"Jq" = (
/obj/machinery/atmospherics/pipe/simple/hidden/scrubbers{
	dir = 6
	},
/turf/simulated/wall/rshull,
/area/shuttle/mackerel_lc_wreck)
"JG" = (
/obj/structure/handrail{
	dir = 4
	},
/obj/machinery/atmospherics/valve,
/turf/simulated/floor/airless,
/area/shuttle/mackerel_lc_wreck)
"JP" = (
/obj/effect/floor_decal/industrial/warning{
	dir = 1
	},
/turf/simulated/floor/tiled/techmaint,
/area/shuttle/mackerel_lc_wreck)
"Kb" = (
/obj/machinery/atmospherics/unary/vent_scrubber/on{
	dir = 1
	},
/obj/structure/cable{
	icon_state = "1-2"
	},
/turf/simulated/floor/tiled/techmaint,
/area/shuttle/mackerel_lc_wreck)
"Ko" = (
/turf/simulated/wall/rshull,
/area/shuttle/mackerel_lc_wreck)
"KZ" = (
/obj/structure/handrail{
	dir = 8
	},
/obj/machinery/atmospherics/valve,
/turf/simulated/floor/airless,
/area/shuttle/mackerel_lc_wreck)
"Ly" = (
/obj/machinery/atmospherics/unary/vent_pump/on,
/obj/item/material/shard/shrapnel,
/turf/simulated/floor/tiled/techmaint/airless,
/area/shuttle/mackerel_lc_wreck)
"LU" = (
/obj/machinery/atmospherics/portables_connector{
	dir = 8
	},
/obj/machinery/portable_atmospherics/canister/empty,
/obj/effect/floor_decal/industrial/outline/red,
/turf/simulated/floor/airless,
/area/shuttle/mackerel_lc_wreck)
"LW" = (
/obj/machinery/atmospherics/pipe/simple/hidden/supply,
/obj/random/empty_or_lootable_crate,
/turf/simulated/floor/tiled/techfloor,
/area/shuttle/mackerel_lc_wreck)
"Mk" = (
/obj/machinery/atmospherics/pipe/simple/visible/yellow{
	dir = 4
	},
/turf/simulated/floor/airless,
/area/shuttle/mackerel_lc_wreck)
"Nr" = (
/obj/machinery/power/terminal{
	dir = 1
	},
/obj/machinery/light/small{
	dir = 8
	},
/turf/simulated/floor/airless,
/area/shuttle/mackerel_lc_wreck)
"NI" = (
/obj/structure/girder,
/turf/simulated/floor/airless,
/area/shuttle/mackerel_lc_wreck)
"NN" = (
/obj/machinery/atmospherics/pipe/simple/hidden/scrubbers{
	dir = 5
	},
/obj/effect/floor_decal/industrial/warning{
	dir = 8
	},
/turf/simulated/floor/tiled/techfloor,
/area/shuttle/mackerel_lc_wreck)
"Pc" = (
/obj/machinery/atmospherics/pipe/simple/hidden/scrubbers{
	dir = 4
	},
/obj/machinery/atmospherics/pipe/simple/hidden/supply,
/obj/effect/floor_decal/industrial/warning{
	dir = 4
	},
/turf/simulated/floor/tiled/techfloor,
/area/shuttle/mackerel_lc_wreck)
"PI" = (
/obj/machinery/atmospherics/pipe/simple/hidden/scrubbers{
	dir = 9
	},
/obj/structure/symbol/maint,
/turf/simulated/wall/rshull{
	can_open = 1
	},
/area/shuttle/mackerel_lc_wreck)
"PL" = (
/obj/effect/map_helper/airlock/door/int_door,
/obj/machinery/door/airlock/hatch{
	density = 0;
	icon_state = "door_open";
	opacity = 0
	},
/turf/simulated/floor/tiled/techmaint,
/area/shuttle/mackerel_lc_wreck)
"Qq" = (
/obj/structure/hull_corner{
	dir = 4
	},
/turf/template_noop,
/area/shuttle/mackerel_lc_wreck)
"Qu" = (
/obj/machinery/atmospherics/pipe/simple/hidden/scrubbers,
/obj/random/empty_or_lootable_crate,
/turf/simulated/floor/tiled/techfloor,
/area/shuttle/mackerel_lc_wreck)
"RB" = (
/obj/machinery/light/small/flicker{
	dir = 4
	},
/turf/simulated/floor/airless,
/area/shuttle/mackerel_lc_wreck)
"RT" = (
/obj/structure/handrail{
	dir = 4
	},
/obj/machinery/portable_atmospherics/canister/air/airlock,
/obj/machinery/atmospherics/portables_connector,
/obj/effect/floor_decal/industrial/outline/blue,
/turf/simulated/floor/airless,
/area/shuttle/mackerel_lc_wreck)
"RV" = (
/obj/machinery/atmospherics/pipe/simple/visible/yellow{
	dir = 4
	},
/obj/machinery/atmospherics/pipe/simple/hidden/scrubbers,
/obj/machinery/alarm/alarms_hidden{
	dir = 4;
	pixel_x = -26
	},
/obj/effect/floor_decal/industrial/warning/corner{
	dir = 4
	},
/obj/structure/fuel_port/empty{
	pixel_y = 26
	},
/turf/simulated/floor/tiled/techfloor,
/area/shuttle/mackerel_lc_wreck)
"So" = (
/obj/machinery/atmospherics/pipe/simple/hidden/supply,
/obj/effect/floor_decal/industrial/warning/corner{
	dir = 4
	},
/obj/structure/railing/grey{
	dir = 1
	},
/obj/machinery/light/flicker{
	dir = 4
	},
/obj/random/empty_or_lootable_crate,
/turf/simulated/floor/tiled/techfloor,
/area/shuttle/mackerel_lc_wreck)
"Td" = (
/obj/machinery/airlock_sensor{
	pixel_x = -25
	},
/obj/effect/map_helper/airlock/sensor/int_sensor,
/obj/effect/floor_decal/industrial/warning/corner{
	dir = 8
	},
/obj/structure/railing/grey,
/obj/random/empty_or_lootable_crate,
/turf/simulated/floor/tiled/techfloor,
/area/shuttle/mackerel_lc_wreck)
"TC" = (
/obj/item/material/shard/shrapnel,
/turf/template_noop,
/area/shuttle/mackerel_lc_wreck)
"UY" = (
/obj/machinery/atmospherics/unary/engine{
	dir = 1
	},
/turf/simulated/floor/airless,
/area/shuttle/mackerel_lc_wreck)
"Vs" = (
/obj/machinery/atmospherics/unary/vent_pump{
	dir = 1
	},
/obj/structure/handrail,
/obj/effect/map_helper/airlock/sensor/chamber_sensor,
/obj/effect/map_helper/airlock/atmos/chamber_pump,
/obj/effect/floor_decal/industrial/warning{
	dir = 4
	},
/obj/effect/floor_decal/industrial/warning{
	dir = 8
	},
/obj/effect/shuttle_landmark/shuttle_initializer/mackerel_lc_wreck,
/obj/effect/overmap/visitable/ship/landable/mackerel_lc_wreck,
/obj/machinery/airlock_sensor{
	pixel_x = 7;
	pixel_y = 21
	},
/obj/machinery/light/flicker,
/obj/machinery/embedded_controller/radio/airlock/docking_port_multi{
	id_tag = "mackerel_lc_wreck_docking_star";
	name = "Starboard Airlock Control";
	pixel_x = -8;
	pixel_y = 22
	},
/turf/simulated/floor/tiled/techmaint/airless,
/area/shuttle/mackerel_lc_wreck)
"Wj" = (
/obj/effect/floor_decal/industrial/warning,
/obj/structure/cable{
	icon_state = "1-2"
	},
/turf/simulated/floor/tiled/techmaint,
/area/shuttle/mackerel_lc_wreck)
"Wr" = (
/obj/effect/floor_decal/industrial/warning/corner{
	dir = 1
	},
/obj/structure/railing/grey{
	dir = 1
	},
/obj/machinery/light{
	dir = 8
	},
/obj/random/empty_or_lootable_crate,
/turf/simulated/floor/tiled/techfloor,
/area/shuttle/mackerel_lc_wreck)
"Wv" = (
/obj/structure/sign/warning/airlock,
/turf/simulated/wall/rshull,
/area/shuttle/mackerel_lc_wreck)
"WN" = (
/obj/structure/grille/broken,
/obj/item/material/shard/shrapnel,
/turf/template_noop,
/area/shuttle/mackerel_lc_wreck)
"WP" = (
/turf/template_noop,
/area/template_noop)
"WW" = (
/obj/machinery/atmospherics/pipe/manifold/hidden/scrubbers{
	dir = 1
	},
/obj/structure/cable{
	icon_state = "1-2"
	},
/turf/simulated/floor/tiled/techmaint,
/area/shuttle/mackerel_lc_wreck)
"Xn" = (
/obj/structure/handrail{
	dir = 8
	},
/obj/machinery/portable_atmospherics/canister/air/airlock,
/obj/machinery/atmospherics/portables_connector,
/obj/effect/floor_decal/industrial/outline/blue,
/turf/simulated/floor/airless,
/area/shuttle/mackerel_lc_wreck)
"Zb" = (
/obj/effect/decal/cleanable/blood/oil,
/turf/simulated/floor/airless,
/area/shuttle/mackerel_lc_wreck)
"Zp" = (
/obj/effect/decal/cleanable/blood,
/obj/effect/landmark/corpse/vintage/pilot,
/turf/simulated/floor/tiled/techmaint/airless,
/area/shuttle/mackerel_lc_wreck)
"ZJ" = (
/obj/machinery/atmospherics/unary/vent_pump/on{
	dir = 1
	},
/obj/structure/extinguisher_cabinet{
	dir = 8;
	pixel_x = 30
	},
/obj/machinery/light{
	dir = 4
	},
/turf/simulated/floor/tiled/techfloor,
/area/shuttle/mackerel_lc_wreck)
"ZK" = (
/obj/effect/floor_decal/industrial/warning{
	dir = 8
	},
/turf/simulated/floor/tiled/techmaint,
/area/shuttle/mackerel_lc_wreck)

(1,1,1) = {"
WP
WP
WP
WP
WP
WP
WP
WP
WP
WP
WP
WP
WP
WP
WP
WP
WP
BB
WP
WP
WP
WP
WP
"}
(2,1,1) = {"
WP
WP
WP
WP
WP
BB
WP
WP
WP
WP
WP
WP
WP
WP
WP
TC
oG
oe
ka
ka
ka
Qq
WP
"}
(3,1,1) = {"
WP
WP
BB
WP
WP
WP
WP
WP
WP
WP
WP
WP
WP
BB
WP
oG
oe
Zb
bI
mi
UY
WP
WP
"}
(4,1,1) = {"
WP
WP
WP
oe
nu
wQ
NI
WP
ka
wQ
wQ
ka
WP
WP
BB
oG
NI
oq
tV
ka
ka
kf
WP
"}
(5,1,1) = {"
WP
BB
WP
oe
BB
WP
oq
WP
oq
WP
WP
oq
WP
WP
WP
WP
WP
NI
tV
yH
WP
WP
WP
"}
(6,1,1) = {"
WP
WP
BB
oe
oe
Zb
NI
ka
ka
ka
ka
ka
ka
pZ
ka
ka
ka
ka
tV
ka
ka
WP
WP
"}
(7,1,1) = {"
WP
az
NI
ka
ju
oq
oq
aq
pi
GF
Nr
RT
wN
mw
ka
fL
JG
kU
dG
Iu
ka
WP
WP
"}
(8,1,1) = {"
WP
ka
ka
Ko
Ko
Ko
EL
Ko
Ko
zq
EL
Ko
Ko
PL
Wv
Ko
EL
Ko
tV
ka
ka
ka
Qq
"}
(9,1,1) = {"
WP
aF
bw
gT
lC
sZ
EC
FH
Qu
wF
NN
Wr
Td
ZK
rc
Ck
ut
sZ
RV
um
ue
ka
WP
"}
(10,1,1) = {"
WP
pT
cv
Zp
cD
ug
JP
sX
sX
Dl
WW
zr
zr
zr
bY
Kb
Wj
cg
BP
FS
we
Gm
WP
"}
(11,1,1) = {"
WP
rX
He
Ly
mf
uR
EK
HI
LW
GK
Pc
So
sL
xd
lo
lT
rr
BN
sg
ZJ
nD
ka
WP
"}
(12,1,1) = {"
WP
ka
oq
NI
Ko
xB
EL
Ko
Ko
Jq
PI
Ko
Ko
Ib
Wv
Ko
EL
Ko
tV
ka
ka
ka
kf
"}
(13,1,1) = {"
WP
WP
oe
oe
oe
Da
Zb
RB
Cf
LU
Do
Xn
wN
Vs
ka
zo
KZ
rQ
dG
oq
ka
WP
WP
"}
(14,1,1) = {"
WP
BB
WP
oe
oG
oe
NI
ka
ka
ka
ka
ka
ka
FL
ka
ka
ka
ka
tV
ka
ka
BB
WP
"}
(15,1,1) = {"
WP
WP
WP
TC
WP
WP
oq
WP
oq
WP
WP
oq
WP
WP
WP
WP
WP
NI
Mk
oq
WP
WP
WP
"}
(16,1,1) = {"
WP
WP
WP
oG
TC
WN
ka
WP
ka
wQ
wQ
ka
WP
BB
WP
oG
NI
Zb
ca
NI
oq
oG
BB
"}
(17,1,1) = {"
WP
BB
WP
WP
WP
WP
WP
WP
WP
WP
WP
WP
WP
WP
WP
TC
oe
oq
oq
oq
oe
WP
WP
"}
(18,1,1) = {"
WP
WP
WP
WP
BB
WP
WP
BB
WP
WP
WP
WP
WP
WP
WP
oG
oG
oe
oe
oe
oe
TC
WP
"}
(19,1,1) = {"
WP
WP
WP
WP
WP
WP
WP
WP
WP
WP
WP
WP
WP
WP
WP
BB
WP
WP
WP
WP
WP
WP
WP
"}
