//MAP CONVERTED BY dmm2tgm.py THIS HEADER COMMENT PREVENTS RECONVERSION, DO NOT REMOVE
"aq" = (
/obj/machinery/light/small{
	dir = 8
	},
/turf/simulated/floor/plating,
/area/shuttle/mackerel_hc_skel)
"az" = (
/obj/machinery/shipsensors{
	dir = 1
	},
/turf/simulated/floor/airless,
/area/shuttle/mackerel_hc_skel)
"aF" = (
/obj/effect/wingrille_spawn/reinforced,
/obj/machinery/door/firedoor/glass,
/turf/simulated/floor/plating,
/area/shuttle/mackerel_hc_skel)
"bn" = (
/obj/effect/floor_decal/industrial/warning{
	dir = 9
	},
/turf/simulated/floor/reinforced,
/area/shuttle/mackerel_hc_skel)
"bw" = (
/obj/machinery/computer/ship/helm,
/turf/simulated/floor/tiled/techmaint,
/area/shuttle/mackerel_hc_skel)
"bI" = (
/obj/machinery/atmospherics/pipe/simple/visible/yellow{
	dir = 6
	},
/turf/simulated/floor/airless,
/area/shuttle/mackerel_hc_skel)
"bY" = (
/obj/machinery/atmospherics/pipe/manifold/hidden/scrubbers{
	dir = 4
	},
/obj/structure/cable{
	d1 = 1;
	d2 = 2;
	icon_state = "1-2"
	},
/turf/simulated/floor/tiled/techmaint,
/area/shuttle/mackerel_hc_skel)
"cg" = (
/obj/machinery/door/airlock/hatch,
/obj/machinery/door/firedoor/glass,
/obj/structure/cable{
	d1 = 1;
	d2 = 2;
	icon_state = "1-2"
	},
/turf/simulated/floor/tiled/techmaint,
/area/shuttle/mackerel_hc_skel)
"cv" = (
/obj/machinery/computer/shuttle_control/explore/mackerel_hc,
/turf/simulated/floor/tiled/techmaint,
/area/shuttle/mackerel_hc_skel)
"cD" = (
/obj/effect/floor_decal/industrial/warning,
/turf/simulated/floor/tiled/techmaint,
/area/shuttle/mackerel_hc_skel)
"dG" = (
/obj/machinery/atmospherics/pipe/manifold/visible/yellow,
/turf/simulated/floor/plating,
/area/shuttle/mackerel_hc_skel)
"fD" = (
/obj/structure/handrail{
	dir = 4
	},
/turf/simulated/floor/plating,
/area/shuttle/mackerel_hc_skel)
"fI" = (
/obj/structure/sign/warning/airlock,
/turf/simulated/wall/rshull,
/area/shuttle/mackerel_hc_skel)
"fL" = (
/obj/machinery/atmospherics/portables_connector,
/obj/effect/floor_decal/industrial/outline/yellow,
/obj/machinery/portable_atmospherics/canister/phoron{
	start_pressure = 8000.25
	},
/turf/simulated/floor/plating,
/area/shuttle/mackerel_hc_skel)
"gv" = (
/obj/machinery/computer/ship/sensors,
/turf/simulated/floor/tiled/techmaint,
/area/shuttle/mackerel_hc_skel)
"gT" = (
/obj/structure/bed/chair/bay/shuttle{
	dir = 1
	},
/obj/machinery/atmospherics/unary/vent_scrubber/on,
/turf/simulated/floor/tiled/techmaint,
/area/shuttle/mackerel_hc_skel)
"gU" = (
/obj/machinery/atmospherics/pipe/simple/visible/yellow{
	dir = 10
	},
/turf/simulated/floor/airless,
/area/shuttle/mackerel_hc_skel)
"iP" = (
/obj/structure/bed/chair/bay/shuttle{
	dir = 1
	},
/obj/machinery/atmospherics/unary/vent_pump/on,
/obj/structure/extinguisher_cabinet{
	dir = 8;
	icon_state = "extinguisher_closed";
	pixel_x = 30
	},
/turf/simulated/floor/tiled/techmaint,
/area/shuttle/mackerel_hc_skel)
"jp" = (
/turf/simulated/floor/airless,
/area/shuttle/mackerel_hc_skel)
"ju" = (
/obj/structure/handrail{
	dir = 4
	},
/obj/machinery/light/small{
	dir = 1
	},
/turf/simulated/floor/plating,
/area/shuttle/mackerel_hc_skel)
"ka" = (
/turf/simulated/wall/shull,
/area/shuttle/mackerel_hc_skel)
"kU" = (
/obj/machinery/atmospherics/pipe/simple/visible/yellow,
/obj/machinery/light/small{
	dir = 8
	},
/turf/simulated/floor/plating,
/area/shuttle/mackerel_hc_skel)
"lo" = (
/obj/effect/floor_decal/industrial/warning/cee{
	dir = 4
	},
/turf/simulated/floor/reinforced,
/area/shuttle/mackerel_hc_skel)
"lC" = (
/obj/machinery/atmospherics/pipe/simple/hidden/scrubbers,
/obj/machinery/light,
/obj/structure/closet/walllocker/emerglocker/west,
/obj/effect/floor_decal/industrial/warning/corner,
/turf/simulated/floor/tiled/techmaint,
/area/shuttle/mackerel_hc_skel)
"lT" = (
/obj/machinery/atmospherics/pipe/simple/hidden/supply,
/obj/effect/floor_decal/industrial/warning/cee{
	dir = 8
	},
/turf/simulated/floor/reinforced,
/area/shuttle/mackerel_hc_skel)
"mf" = (
/obj/machinery/atmospherics/pipe/simple/hidden/supply,
/obj/machinery/light,
/obj/machinery/alarm/alarms_hidden{
	dir = 8;
	pixel_x = 26
	},
/obj/effect/floor_decal/industrial/warning/corner{
	dir = 8
	},
/turf/simulated/floor/tiled/techmaint,
/area/shuttle/mackerel_hc_skel)
"mi" = (
/obj/structure/shuttle/engine/heater,
/obj/machinery/atmospherics/pipe/simple/visible/yellow,
/turf/simulated/floor/airless,
/area/shuttle/mackerel_hc_skel)
"mw" = (
/obj/structure/handrail,
/obj/machinery/atmospherics/unary/vent_pump{
	dir = 1
	},
/obj/effect/map_helper/airlock/sensor/chamber_sensor,
/obj/effect/map_helper/airlock/atmos/chamber_pump,
/obj/machinery/airlock_sensor{
	pixel_y = 21
	},
/obj/machinery/light,
/obj/effect/floor_decal/industrial/warning{
	dir = 4
	},
/obj/effect/floor_decal/industrial/warning{
	dir = 8
	},
/turf/simulated/floor/tiled/techmaint,
/area/shuttle/mackerel_hc_skel)
"mO" = (
/obj/effect/floor_decal/industrial/warning{
	dir = 10
	},
/turf/simulated/floor/reinforced,
/area/shuttle/mackerel_hc_skel)
"nD" = (
/obj/structure/closet/crate/engineering/electrical,
/obj/item/weapon/storage/toolbox/electrical,
/turf/simulated/floor/tiled/techfloor,
/area/shuttle/mackerel_hc_skel)
"oe" = (
/obj/structure/handrail{
	dir = 8
	},
/obj/machinery/light/small{
	dir = 1
	},
/turf/simulated/floor/plating,
/area/shuttle/mackerel_hc_skel)
"oq" = (
/turf/simulated/floor/plating,
/area/shuttle/mackerel_hc_skel)
"pZ" = (
/obj/machinery/door/airlock/hatch,
/obj/effect/map_helper/airlock/door/ext_door,
/obj/effect/map_helper/airlock/sensor/ext_sensor,
/obj/machinery/airlock_sensor/airlock_exterior/shuttle{
	dir = 10;
	pixel_x = -8;
	pixel_y = 26
	},
/turf/simulated/floor/tiled/techmaint,
/area/shuttle/mackerel_hc_skel)
"rc" = (
/obj/machinery/atmospherics/pipe/simple/hidden/scrubbers{
	dir = 6
	},
/obj/structure/extinguisher_cabinet{
	dir = 4;
	icon_state = "extinguisher_closed";
	pixel_x = -30
	},
/obj/effect/floor_decal/industrial/warning/corner{
	dir = 1
	},
/turf/simulated/floor/tiled/techfloor,
/area/shuttle/mackerel_hc_skel)
"rf" = (
/obj/effect/floor_decal/industrial/warning/cee{
	dir = 8
	},
/turf/simulated/floor/reinforced,
/area/shuttle/mackerel_hc_skel)
"rr" = (
/obj/machinery/atmospherics/pipe/simple/hidden/supply,
/obj/structure/closet/walllocker/emerglocker/south,
/obj/machinery/embedded_controller/radio/airlock/docking_port{
	id_tag = "mack_hc_docking_skel";
	pixel_y = -28
	},
/obj/machinery/light,
/obj/effect/floor_decal/industrial/warning/corner{
	dir = 8
	},
/turf/simulated/floor/tiled/techfloor,
/area/shuttle/mackerel_hc_skel)
"rQ" = (
/obj/machinery/atmospherics/pipe/simple/visible/yellow,
/obj/machinery/light/small{
	dir = 4
	},
/turf/simulated/floor/plating,
/area/shuttle/mackerel_hc_skel)
"sg" = (
/obj/machinery/atmospherics/pipe/simple/visible/yellow{
	dir = 4
	},
/obj/machinery/atmospherics/pipe/simple/hidden/supply,
/obj/machinery/power/apc{
	dir = 4;
	name = "east bump";
	pixel_x = 24;
	pixel_y = 0
	},
/obj/effect/floor_decal/industrial/warning/corner{
	dir = 1
	},
/obj/structure/cable{
	d2 = 8;
	icon_state = "0-8"
	},
/turf/simulated/floor/tiled/techfloor,
/area/shuttle/mackerel_hc_skel)
"sL" = (
/obj/machinery/atmospherics/pipe/simple/hidden/supply,
/obj/machinery/airlock_sensor{
	pixel_x = 26
	},
/obj/effect/map_helper/airlock/sensor/int_sensor,
/obj/machinery/light{
	dir = 4
	},
/obj/effect/floor_decal/industrial/warning/corner,
/turf/simulated/floor/tiled/techfloor,
/area/shuttle/mackerel_hc_skel)
"sZ" = (
/obj/machinery/atmospherics/pipe/simple/hidden/scrubbers,
/turf/simulated/wall/rshull,
/area/shuttle/mackerel_hc_skel)
"tV" = (
/obj/machinery/atmospherics/pipe/simple/visible/yellow{
	dir = 4
	},
/turf/simulated/wall/shull,
/area/shuttle/mackerel_hc_skel)
"ue" = (
/obj/structure/closet/crate/engineering,
/obj/item/weapon/storage/toolbox/mechanical,
/turf/simulated/floor/tiled/techfloor,
/area/shuttle/mackerel_hc_skel)
"ug" = (
/obj/machinery/door/airlock/hatch,
/turf/simulated/floor/tiled/techmaint,
/area/shuttle/mackerel_hc_skel)
"ul" = (
/obj/machinery/atmospherics/pipe/simple/hidden/supply,
/obj/effect/floor_decal/industrial/warning/corner{
	dir = 4
	},
/turf/simulated/floor/tiled/techfloor,
/area/shuttle/mackerel_hc_skel)
"um" = (
/obj/machinery/atmospherics/unary/vent_scrubber/on{
	dir = 1
	},
/obj/machinery/light{
	dir = 8;
	icon_state = "tube1";
	pixel_x = 0
	},
/turf/simulated/floor/tiled/techfloor,
/area/shuttle/mackerel_hc_skel)
"ut" = (
/obj/machinery/atmospherics/pipe/simple/hidden/scrubbers,
/obj/machinery/light,
/obj/effect/floor_decal/industrial/warning/corner,
/obj/machinery/firealarm/alarms_hidden{
	dir = 1;
	pixel_y = -26
	},
/turf/simulated/floor/tiled/techfloor,
/area/shuttle/mackerel_hc_skel)
"uR" = (
/obj/machinery/atmospherics/pipe/manifold/hidden/supply{
	dir = 8
	},
/turf/simulated/wall/rshull,
/area/shuttle/mackerel_hc_skel)
"we" = (
/obj/structure/shuttle/engine/heater,
/obj/machinery/atmospherics/pipe/simple/visible/yellow,
/turf/simulated/floor/tiled/techfloor,
/area/shuttle/mackerel_hc_skel)
"wF" = (
/obj/machinery/atmospherics/pipe/simple/hidden/scrubbers,
/obj/structure/cable{
	d1 = 4;
	d2 = 8;
	icon_state = "4-8";
	pixel_x = 0
	},
/obj/structure/closet/walllocker/emerglocker/west,
/turf/simulated/floor/tiled/techfloor,
/area/shuttle/mackerel_hc_skel)
"wN" = (
/obj/machinery/atmospherics/pipe/simple/hidden,
/turf/simulated/wall/shull,
/area/shuttle/mackerel_hc_skel)
"xd" = (
/obj/machinery/atmospherics/pipe/simple/hidden/supply,
/obj/effect/floor_decal/industrial/warning{
	dir = 4
	},
/turf/simulated/floor/tiled/techmaint,
/area/shuttle/mackerel_hc_skel)
"xB" = (
/obj/machinery/atmospherics/pipe/simple/hidden/supply{
	dir = 4
	},
/turf/simulated/wall/rshull,
/area/shuttle/mackerel_hc_skel)
"yH" = (
/obj/structure/handrail,
/turf/simulated/floor/airless,
/area/shuttle/mackerel_hc_skel)
"zq" = (
/obj/structure/cable{
	d1 = 4;
	d2 = 8;
	icon_state = "4-8";
	pixel_x = 0
	},
/turf/simulated/wall/rshull,
/area/shuttle/mackerel_hc_skel)
"zt" = (
/obj/structure/symbol/gu,
/turf/simulated/floor/plating,
/area/shuttle/mackerel_hc_skel)
"BN" = (
/obj/machinery/atmospherics/pipe/simple/hidden/supply,
/turf/simulated/wall/rshull,
/area/shuttle/mackerel_hc_skel)
"BP" = (
/obj/machinery/atmospherics/pipe/manifold/visible/yellow{
	dir = 1
	},
/obj/structure/cable{
	d1 = 1;
	d2 = 4;
	icon_state = "1-4"
	},
/obj/effect/floor_decal/industrial/warning{
	dir = 1
	},
/turf/simulated/floor/tiled/techfloor,
/area/shuttle/mackerel_hc_skel)
"Ck" = (
/obj/machinery/atmospherics/pipe/simple/hidden/scrubbers,
/obj/effect/floor_decal/industrial/warning/cee{
	dir = 4
	},
/turf/simulated/floor/reinforced,
/area/shuttle/mackerel_hc_skel)
"Da" = (
/obj/machinery/portable_atmospherics/canister/air,
/obj/machinery/atmospherics/portables_connector{
	dir = 8
	},
/obj/effect/floor_decal/industrial/outline/blue,
/turf/simulated/floor/plating,
/area/shuttle/mackerel_hc_skel)
"Dc" = (
/obj/structure/handrail,
/obj/machinery/light/small{
	dir = 4
	},
/turf/simulated/floor/airless,
/area/shuttle/mackerel_hc_skel)
"Dl" = (
/obj/machinery/atmospherics/unary/vent_pump/on{
	dir = 4
	},
/obj/structure/cable{
	d1 = 2;
	d2 = 8;
	icon_state = "2-8"
	},
/turf/simulated/floor/tiled/techmaint,
/area/shuttle/mackerel_hc_skel)
"Dq" = (
/obj/machinery/atmospherics/pipe/simple/hidden/scrubbers,
/obj/structure/cable{
	d1 = 1;
	d2 = 2;
	icon_state = "1-2"
	},
/obj/effect/shuttle_landmark/shuttle_initializer/mackerel_hc_skel,
/obj/effect/overmap/visitable/ship/landable/mackerel_hc_skel,
/turf/simulated/floor/tiled/techmaint,
/area/shuttle/mackerel_hc_skel)
"Ds" = (
/obj/structure/symbol/gu,
/obj/effect/floor_decal/industrial/warning{
	dir = 9
	},
/turf/simulated/floor/reinforced,
/area/shuttle/mackerel_hc_skel)
"EC" = (
/obj/machinery/atmospherics/pipe/simple/hidden/scrubbers,
/obj/machinery/light{
	dir = 1
	},
/obj/effect/floor_decal/industrial/warning/corner{
	dir = 4
	},
/obj/machinery/firealarm/alarms_hidden{
	pixel_y = 26
	},
/turf/simulated/floor/tiled/techfloor,
/area/shuttle/mackerel_hc_skel)
"EK" = (
/obj/machinery/atmospherics/pipe/simple/hidden/supply,
/obj/machinery/alarm/alarms_hidden{
	pixel_y = 26
	},
/obj/machinery/light{
	dir = 1
	},
/obj/effect/floor_decal/industrial/warning/corner{
	dir = 1
	},
/turf/simulated/floor/tiled/techfloor,
/area/shuttle/mackerel_hc_skel)
"EL" = (
/obj/structure/symbol/gu,
/turf/simulated/wall/rshull,
/area/shuttle/mackerel_hc_skel)
"FH" = (
/obj/machinery/atmospherics/pipe/simple/hidden/scrubbers,
/obj/effect/floor_decal/industrial/warning{
	dir = 5
	},
/turf/simulated/floor/reinforced,
/area/shuttle/mackerel_hc_skel)
"FL" = (
/obj/machinery/door/airlock/hatch,
/obj/effect/map_helper/airlock/door/ext_door,
/obj/effect/map_helper/airlock/sensor/ext_sensor,
/obj/machinery/airlock_sensor/airlock_exterior/shuttle{
	dir = 6;
	pixel_x = 7;
	pixel_y = 26
	},
/turf/simulated/floor/tiled/techmaint,
/area/shuttle/mackerel_hc_skel)
"FN" = (
/obj/structure/handrail{
	dir = 8
	},
/turf/simulated/floor/plating,
/area/shuttle/mackerel_hc_skel)
"FS" = (
/obj/machinery/atmospherics/pipe/simple/visible/yellow,
/obj/machinery/computer/ship/engines{
	dir = 1;
	icon_state = "computer"
	},
/turf/simulated/floor/tiled/techfloor,
/area/shuttle/mackerel_hc_skel)
"Gm" = (
/obj/machinery/atmospherics/unary/engine{
	dir = 1
	},
/obj/structure/window/reinforced{
	dir = 1
	},
/turf/simulated/floor/airless,
/area/shuttle/mackerel_hc_skel)
"GF" = (
/obj/machinery/power/smes/buildable,
/obj/structure/cable{
	d2 = 4;
	icon_state = "0-4"
	},
/turf/simulated/floor/plating,
/area/shuttle/mackerel_hc_skel)
"GK" = (
/obj/machinery/atmospherics/pipe/manifold/hidden/supply{
	dir = 4
	},
/obj/structure/extinguisher_cabinet{
	dir = 8;
	icon_state = "extinguisher_closed";
	pixel_x = 30
	},
/turf/simulated/floor/tiled/techfloor,
/area/shuttle/mackerel_hc_skel)
"Jq" = (
/obj/machinery/atmospherics/pipe/simple/hidden/scrubbers{
	dir = 6
	},
/turf/simulated/wall/rshull,
/area/shuttle/mackerel_hc_skel)
"JG" = (
/obj/machinery/atmospherics/valve/open,
/obj/structure/handrail{
	dir = 4
	},
/turf/simulated/floor/plating,
/area/shuttle/mackerel_hc_skel)
"JP" = (
/obj/effect/floor_decal/industrial/warning{
	dir = 1
	},
/turf/simulated/floor/tiled/techmaint,
/area/shuttle/mackerel_hc_skel)
"JW" = (
/obj/effect/floor_decal/industrial/warning{
	dir = 5
	},
/turf/simulated/floor/reinforced,
/area/shuttle/mackerel_hc_skel)
"Kb" = (
/obj/machinery/atmospherics/unary/vent_scrubber/on{
	dir = 1
	},
/obj/structure/cable{
	d1 = 1;
	d2 = 2;
	icon_state = "1-2"
	},
/turf/simulated/floor/tiled/techmaint,
/area/shuttle/mackerel_hc_skel)
"KZ" = (
/obj/machinery/atmospherics/valve/open,
/obj/structure/handrail{
	dir = 8
	},
/turf/simulated/floor/plating,
/area/shuttle/mackerel_hc_skel)
"LU" = (
/obj/machinery/atmospherics/portables_connector{
	dir = 8
	},
/obj/machinery/portable_atmospherics/canister/empty,
/obj/effect/floor_decal/industrial/outline/red,
/turf/simulated/floor/plating,
/area/shuttle/mackerel_hc_skel)
"LW" = (
/obj/machinery/atmospherics/pipe/simple/hidden/supply,
/obj/effect/floor_decal/industrial/warning{
	dir = 10
	},
/turf/simulated/floor/reinforced,
/area/shuttle/mackerel_hc_skel)
"Nr" = (
/obj/machinery/power/terminal{
	dir = 1
	},
/obj/machinery/light/small{
	dir = 8
	},
/turf/simulated/floor/plating,
/area/shuttle/mackerel_hc_skel)
"NN" = (
/obj/machinery/atmospherics/pipe/simple/hidden/scrubbers{
	dir = 5
	},
/obj/effect/floor_decal/industrial/warning{
	dir = 5
	},
/turf/simulated/floor/reinforced,
/area/shuttle/mackerel_hc_skel)
"Pc" = (
/obj/machinery/atmospherics/pipe/simple/hidden/scrubbers{
	dir = 4
	},
/obj/machinery/atmospherics/pipe/simple/hidden/supply,
/obj/effect/floor_decal/industrial/warning{
	dir = 9
	},
/turf/simulated/floor/reinforced,
/area/shuttle/mackerel_hc_skel)
"PI" = (
/obj/machinery/atmospherics/pipe/simple/hidden/scrubbers{
	dir = 9
	},
/obj/structure/symbol/gu,
/obj/effect/floor_decal/industrial/warning{
	dir = 5
	},
/turf/simulated/floor/reinforced,
/area/shuttle/mackerel_hc_skel)
"PL" = (
/obj/machinery/door/airlock/hatch,
/obj/machinery/door/firedoor/glass,
/obj/effect/map_helper/airlock/door/int_door,
/turf/simulated/floor/tiled/techmaint,
/area/shuttle/mackerel_hc_skel)
"Qu" = (
/obj/machinery/atmospherics/pipe/simple/hidden/scrubbers,
/obj/effect/floor_decal/industrial/warning{
	dir = 6
	},
/turf/simulated/floor/reinforced,
/area/shuttle/mackerel_hc_skel)
"RB" = (
/obj/machinery/light/small{
	dir = 4
	},
/turf/simulated/floor/plating,
/area/shuttle/mackerel_hc_skel)
"RT" = (
/obj/structure/handrail{
	dir = 4
	},
/obj/machinery/portable_atmospherics/canister/air/airlock,
/obj/machinery/atmospherics/portables_connector,
/obj/effect/floor_decal/industrial/outline/blue,
/turf/simulated/floor/plating,
/area/shuttle/mackerel_hc_skel)
"RV" = (
/obj/machinery/atmospherics/pipe/simple/visible/yellow{
	dir = 4
	},
/obj/machinery/atmospherics/pipe/simple/hidden/scrubbers,
/obj/structure/fuel_port{
	pixel_y = 26
	},
/obj/machinery/alarm/alarms_hidden{
	dir = 4;
	pixel_x = -26
	},
/obj/effect/floor_decal/industrial/warning/corner{
	dir = 4
	},
/turf/simulated/floor/tiled/techfloor,
/area/shuttle/mackerel_hc_skel)
"So" = (
/obj/machinery/atmospherics/pipe/simple/hidden/supply,
/obj/effect/floor_decal/industrial/warning{
	dir = 9
	},
/turf/simulated/floor/reinforced,
/area/shuttle/mackerel_hc_skel)
"Td" = (
/obj/machinery/airlock_sensor{
	pixel_x = -25
	},
/obj/effect/map_helper/airlock/sensor/int_sensor,
/obj/machinery/light{
	dir = 8
	},
/obj/effect/floor_decal/industrial/warning/corner{
	dir = 8
	},
/turf/simulated/floor/tiled/techfloor,
/area/shuttle/mackerel_hc_skel)
"UY" = (
/obj/machinery/atmospherics/unary/engine{
	dir = 1
	},
/turf/simulated/floor/airless,
/area/shuttle/mackerel_hc_skel)
"Vs" = (
/obj/machinery/atmospherics/unary/vent_pump{
	dir = 1
	},
/obj/structure/handrail,
/obj/effect/map_helper/airlock/sensor/chamber_sensor,
/obj/effect/map_helper/airlock/atmos/chamber_pump,
/obj/machinery/airlock_sensor{
	pixel_y = 21
	},
/obj/machinery/light,
/obj/effect/floor_decal/industrial/warning{
	dir = 4
	},
/obj/effect/floor_decal/industrial/warning{
	dir = 8
	},
/turf/simulated/floor/tiled/techmaint,
/area/shuttle/mackerel_hc_skel)
"Wj" = (
/obj/effect/floor_decal/industrial/warning,
/obj/structure/cable{
	d1 = 1;
	d2 = 2;
	icon_state = "1-2"
	},
/turf/simulated/floor/tiled/techmaint,
/area/shuttle/mackerel_hc_skel)
"Wr" = (
/obj/effect/floor_decal/industrial/warning{
	dir = 6
	},
/turf/simulated/floor/reinforced,
/area/shuttle/mackerel_hc_skel)
"Wv" = (
/turf/simulated/wall/rshull,
/area/shuttle/mackerel_hc_skel)
"WP" = (
/turf/template_noop,
/area/template_noop)
"WS" = (
/obj/structure/grille,
/turf/simulated/floor/airless,
/area/shuttle/mackerel_hc_skel)
"WW" = (
/obj/machinery/atmospherics/pipe/manifold/hidden/scrubbers{
	dir = 1
	},
/obj/structure/cable{
	d1 = 1;
	d2 = 2;
	icon_state = "1-2"
	},
/turf/simulated/floor/tiled/techmaint,
/area/shuttle/mackerel_hc_skel)
"Xn" = (
/obj/structure/handrail{
	dir = 8
	},
/obj/machinery/portable_atmospherics/canister/air/airlock,
/obj/machinery/atmospherics/portables_connector,
/obj/effect/floor_decal/industrial/outline/blue,
/turf/simulated/floor/plating,
/area/shuttle/mackerel_hc_skel)
"Xs" = (
/obj/machinery/atmospherics/pipe/simple/hidden/scrubbers,
/obj/structure/cable{
	d1 = 1;
	d2 = 2;
	icon_state = "1-2"
	},
/turf/simulated/floor/tiled/techmaint,
/area/shuttle/mackerel_hc_skel)
"Zb" = (
/obj/structure/handrail,
/obj/machinery/light/small{
	dir = 8
	},
/turf/simulated/floor/airless,
/area/shuttle/mackerel_hc_skel)
"Zp" = (
/turf/simulated/floor/tiled/techmaint,
/area/shuttle/mackerel_hc_skel)
"ZJ" = (
/obj/machinery/atmospherics/unary/vent_pump/on{
	dir = 1
	},
/obj/machinery/light{
	dir = 4;
	icon_state = "tube1"
	},
/obj/structure/extinguisher_cabinet{
	dir = 8;
	icon_state = "extinguisher_closed";
	pixel_x = 30
	},
/turf/simulated/floor/tiled/techfloor,
/area/shuttle/mackerel_hc_skel)
"ZK" = (
/obj/effect/floor_decal/industrial/warning{
	dir = 8
	},
/turf/simulated/floor/tiled/techmaint,
/area/shuttle/mackerel_hc_skel)

(1,1,1) = {"
WP
WP
WP
WP
WP
WP
WP
WP
WP
WP
WP
WP
WP
WP
WP
WP
WP
WP
WP
WP
WP
WP
WP
WP
WP
"}
(2,1,1) = {"
WP
WP
WP
WP
WP
WP
WP
WP
WP
WP
WP
WP
WP
WP
WP
WP
WP
WP
ka
ka
ka
ka
ka
WP
WP
"}
(3,1,1) = {"
WP
WP
WP
WP
WP
WP
WP
WP
WP
WP
WP
WP
WP
WP
WP
WP
WP
WP
ka
Zb
bI
mi
UY
WP
WP
"}
(4,1,1) = {"
WP
WP
WP
WP
WP
ka
WS
WS
ka
WP
ka
WS
WS
ka
WP
WP
WP
WP
ka
ka
tV
ka
ka
WP
WP
"}
(5,1,1) = {"
WP
WP
WP
WP
WP
jp
WP
WP
jp
WP
jp
WP
WP
jp
WP
WP
WP
WP
WP
ka
tV
yH
WP
WP
WP
"}
(6,1,1) = {"
WP
ka
jp
jp
jp
ka
ka
ka
ka
ka
ka
ka
ka
ka
ka
pZ
ka
ka
ka
ka
tV
ka
WP
WP
WP
"}
(7,1,1) = {"
WP
jp
WP
az
ka
ka
ju
oq
fD
aq
fD
GF
Nr
RT
wN
mw
ka
fL
JG
kU
dG
ka
WP
WP
WP
"}
(8,1,1) = {"
WP
ka
jp
ka
ka
Wv
Wv
Wv
EL
bn
mO
zq
Ds
mO
Wv
PL
Wv
rf
zt
Wv
tV
ka
ka
ka
WP
"}
(9,1,1) = {"
WP
WP
WP
aF
bw
gT
lC
sZ
EC
FH
Qu
wF
NN
Wr
Td
ZK
rc
Ck
ut
sZ
RV
um
ue
ka
WP
"}
(10,1,1) = {"
WP
WP
WP
aF
cv
Zp
cD
ug
JP
Zp
Zp
Dl
WW
Xs
Xs
Dq
bY
Kb
Wj
cg
BP
FS
we
Gm
WP
"}
(11,1,1) = {"
WP
WP
WP
aF
gv
iP
mf
uR
EK
So
LW
GK
Pc
LW
sL
xd
ul
lT
rr
BN
sg
ZJ
nD
ka
WP
"}
(12,1,1) = {"
WP
ka
jp
ka
ka
Wv
Wv
xB
EL
JW
Wr
Jq
PI
Wr
Wv
PL
fI
lo
zt
Wv
tV
ka
ka
ka
WP
"}
(13,1,1) = {"
WP
jp
WP
WP
ka
ka
oe
Da
FN
RB
FN
LU
RB
Xn
wN
Vs
ka
fL
KZ
rQ
dG
ka
WP
WP
WP
"}
(14,1,1) = {"
WP
ka
jp
jp
jp
ka
ka
ka
ka
ka
ka
ka
ka
ka
ka
FL
ka
ka
ka
ka
tV
ka
WP
WP
WP
"}
(15,1,1) = {"
WP
WP
WP
WP
WP
jp
WP
WP
jp
WP
jp
WP
WP
jp
WP
WP
WP
WP
WP
ka
tV
yH
WP
WP
WP
"}
(16,1,1) = {"
WP
WP
WP
WP
WP
ka
WS
WS
ka
WP
ka
WS
WS
ka
WP
WP
WP
WP
ka
ka
tV
ka
ka
WP
WP
"}
(17,1,1) = {"
WP
WP
WP
WP
WP
WP
WP
WP
WP
WP
WP
WP
WP
WP
WP
WP
WP
WP
ka
Dc
gU
mi
UY
WP
WP
"}
(18,1,1) = {"
WP
WP
WP
WP
WP
WP
WP
WP
WP
WP
WP
WP
WP
WP
WP
WP
WP
WP
ka
ka
ka
ka
ka
WP
WP
"}
(19,1,1) = {"
WP
WP
WP
WP
WP
WP
WP
WP
WP
WP
WP
WP
WP
WP
WP
WP
WP
WP
WP
WP
WP
WP
WP
WP
WP
"}
