//MAP CONVERTED BY dmm2tgm.py THIS HEADER COMMENT PREVENTS RECONVERSION, DO NOT REMOVE
"aq" = (
/obj/machinery/light/small/flicker{
	dir = 8
	},
/turf/simulated/floor/plating,
/area/shuttle/mackerel_hc)
"az" = (
/obj/machinery/shipsensors{
	dir = 1
	},
/turf/simulated/floor/airless,
/area/shuttle/mackerel_hc)
"aF" = (
/obj/effect/wingrille_spawn/reinforced,
/obj/machinery/door/firedoor/glass,
/turf/simulated/floor/plating,
/area/shuttle/mackerel_hc)
"bw" = (
/obj/machinery/computer/ship/helm,
/turf/simulated/floor/tiled/techmaint,
/area/shuttle/mackerel_hc)
"bI" = (
/obj/machinery/atmospherics/pipe/simple/visible/yellow{
	dir = 6
	},
/turf/simulated/floor/airless,
/area/shuttle/mackerel_hc)
"bY" = (
/obj/machinery/atmospherics/pipe/manifold/hidden/scrubbers{
	dir = 4
	},
/obj/structure/cable{
	d1 = 1;
	d2 = 2;
	icon_state = "1-2"
	},
/turf/simulated/floor/tiled/techmaint,
/area/shuttle/mackerel_hc)
"cg" = (
/obj/machinery/door/airlock/hatch,
/obj/machinery/door/firedoor/glass,
/obj/structure/cable{
	d1 = 1;
	d2 = 2;
	icon_state = "1-2"
	},
/turf/simulated/floor/tiled/techmaint,
/area/shuttle/mackerel_hc)
"cv" = (
/obj/machinery/computer/shuttle_control/explore/mackerel_hc,
/turf/simulated/floor/tiled/techmaint,
/area/shuttle/mackerel_hc)
"cD" = (
/obj/effect/floor_decal/industrial/warning,
/turf/simulated/floor/tiled/techmaint,
/area/shuttle/mackerel_hc)
"dG" = (
/obj/machinery/atmospherics/pipe/manifold/visible/yellow,
/turf/simulated/floor/plating,
/area/shuttle/mackerel_hc)
"fD" = (
/obj/structure/handrail{
	dir = 4
	},
/turf/simulated/floor/plating,
/area/shuttle/mackerel_hc)
"fL" = (
/obj/machinery/atmospherics/portables_connector,
/obj/effect/floor_decal/industrial/outline/yellow,
/obj/machinery/portable_atmospherics/canister/phoron{
	start_pressure = 8000.25
	},
/turf/simulated/floor/plating,
/area/shuttle/mackerel_hc)
"gv" = (
/obj/machinery/computer/ship/sensors,
/turf/simulated/floor/tiled/techmaint,
/area/shuttle/mackerel_hc)
"gT" = (
/obj/structure/bed/chair/bay/shuttle{
	dir = 1
	},
/obj/machinery/atmospherics/unary/vent_scrubber/on,
/turf/simulated/floor/tiled/techmaint,
/area/shuttle/mackerel_hc)
"gU" = (
/obj/machinery/atmospherics/pipe/simple/visible/yellow{
	dir = 10
	},
/turf/simulated/floor/airless,
/area/shuttle/mackerel_hc)
"iP" = (
/obj/structure/bed/chair/bay/shuttle{
	dir = 1
	},
/obj/machinery/atmospherics/unary/vent_pump/on,
/obj/structure/extinguisher_cabinet{
	dir = 8;
	icon_state = "extinguisher_closed";
	pixel_x = 30
	},
/turf/simulated/floor/tiled/techmaint,
/area/shuttle/mackerel_hc)
"jp" = (
/turf/simulated/floor/airless,
/area/shuttle/mackerel_hc)
"ju" = (
/obj/structure/handrail{
	dir = 4
	},
/obj/machinery/light/small/flicker{
	dir = 1
	},
/turf/simulated/floor/plating,
/area/shuttle/mackerel_hc)
"ka" = (
/turf/simulated/wall/shull,
/area/shuttle/mackerel_hc)
"kU" = (
/obj/machinery/atmospherics/pipe/simple/visible/yellow,
/obj/machinery/light/small/flicker{
	dir = 8
	},
/turf/simulated/floor/plating,
/area/shuttle/mackerel_hc)
"lC" = (
/obj/machinery/atmospherics/pipe/simple/hidden/scrubbers,
/obj/machinery/light,
/obj/structure/closet/walllocker/emerglocker/west,
/obj/effect/floor_decal/industrial/warning/corner,
/turf/simulated/floor/tiled/techmaint,
/area/shuttle/mackerel_hc)
"lT" = (
/obj/machinery/atmospherics/pipe/simple/hidden/supply,
/obj/effect/floor_decal/industrial/warning/corner,
/obj/structure/extinguisher_cabinet{
	dir = 8;
	icon_state = "extinguisher_closed";
	pixel_x = 30
	},
/obj/structure/closet/crate/large,
/obj/structure/window/reinforced,
/obj/structure/window/reinforced{
	dir = 1
	},
/obj/machinery/door/window/westright,
/turf/simulated/floor/tiled/techfloor,
/area/shuttle/mackerel_hc)
"mf" = (
/obj/machinery/atmospherics/pipe/simple/hidden/supply,
/obj/machinery/light,
/obj/machinery/alarm/alarms_hidden{
	dir = 8;
	pixel_x = 26
	},
/obj/effect/floor_decal/industrial/warning/corner{
	dir = 8
	},
/turf/simulated/floor/tiled/techmaint,
/area/shuttle/mackerel_hc)
"mi" = (
/obj/structure/shuttle/engine/heater,
/obj/machinery/atmospherics/pipe/simple/visible/yellow,
/turf/simulated/floor/airless,
/area/shuttle/mackerel_hc)
"mw" = (
/obj/structure/handrail,
/obj/machinery/atmospherics/unary/vent_pump{
	dir = 1
	},
/obj/effect/map_helper/airlock/sensor/chamber_sensor,
/obj/effect/map_helper/airlock/atmos/chamber_pump,
/obj/machinery/airlock_sensor{
	pixel_y = 21
	},
/obj/machinery/light,
/obj/effect/floor_decal/industrial/warning{
	dir = 4
	},
/obj/effect/floor_decal/industrial/warning{
	dir = 8
	},
/turf/simulated/floor/tiled/techmaint,
/area/shuttle/mackerel_hc)
"nD" = (
/obj/structure/closet/crate/engineering/electrical,
/obj/item/weapon/storage/toolbox/electrical,
/turf/simulated/floor/tiled/techfloor,
/area/shuttle/mackerel_hc)
"oe" = (
/obj/structure/handrail{
	dir = 8
	},
/obj/machinery/light/small/flicker{
	dir = 1
	},
/turf/simulated/floor/plating,
/area/shuttle/mackerel_hc)
"oq" = (
/turf/simulated/floor/plating,
/area/shuttle/mackerel_hc)
"pZ" = (
/obj/machinery/door/airlock/hatch,
/obj/effect/map_helper/airlock/door/ext_door,
/obj/effect/map_helper/airlock/sensor/ext_sensor,
/obj/machinery/airlock_sensor/airlock_exterior/shuttle{
	dir = 10;
	pixel_x = -8;
	pixel_y = 26
	},
/turf/simulated/floor/tiled/techmaint,
/area/shuttle/mackerel_hc)
"rc" = (
/obj/machinery/atmospherics/pipe/simple/hidden/scrubbers{
	dir = 6
	},
/obj/effect/floor_decal/industrial/warning/corner{
	dir = 1
	},
/obj/structure/closet/crate/large,
/obj/structure/window/reinforced{
	dir = 1
	},
/obj/structure/window/reinforced,
/obj/machinery/door/window,
/turf/simulated/floor/tiled/techfloor,
/area/shuttle/mackerel_hc)
"rr" = (
/obj/machinery/atmospherics/pipe/simple/hidden/supply,
/obj/effect/floor_decal/industrial/warning/corner{
	dir = 8
	},
/obj/effect/floor_decal/industrial/warning{
	dir = 4
	},
/obj/structure/closet/walllocker/emerglocker/south,
/obj/machinery/embedded_controller/radio/airlock/docking_port{
	id_tag = "mack_hc_docking";
	pixel_y = -28
	},
/obj/machinery/light,
/turf/simulated/floor/tiled/techfloor,
/area/shuttle/mackerel_hc)
"rQ" = (
/obj/machinery/atmospherics/pipe/simple/visible/yellow,
/obj/machinery/light/small/flicker{
	dir = 4
	},
/turf/simulated/floor/plating,
/area/shuttle/mackerel_hc)
"sg" = (
/obj/machinery/atmospherics/pipe/simple/visible/yellow{
	dir = 4
	},
/obj/machinery/atmospherics/pipe/simple/hidden/supply,
/obj/machinery/power/apc{
	dir = 4;
	name = "east bump";
	pixel_x = 24;
	pixel_y = 0
	},
/obj/effect/floor_decal/industrial/warning/corner{
	dir = 1
	},
/obj/structure/cable{
	d2 = 8;
	icon_state = "0-8"
	},
/turf/simulated/floor/tiled/techfloor,
/area/shuttle/mackerel_hc)
"sL" = (
/obj/machinery/atmospherics/pipe/simple/hidden/supply,
/obj/machinery/airlock_sensor{
	pixel_x = 26
	},
/obj/effect/map_helper/airlock/sensor/int_sensor,
/obj/effect/floor_decal/industrial/warning/corner,
/obj/machinery/light{
	dir = 4
	},
/turf/simulated/floor/tiled/techfloor,
/area/shuttle/mackerel_hc)
"sZ" = (
/obj/machinery/atmospherics/pipe/simple/hidden/scrubbers,
/turf/simulated/wall/rshull,
/area/shuttle/mackerel_hc)
"tV" = (
/obj/machinery/atmospherics/pipe/simple/visible/yellow{
	dir = 4
	},
/turf/simulated/wall/shull,
/area/shuttle/mackerel_hc)
"ue" = (
/obj/structure/closet/crate/engineering,
/obj/item/weapon/storage/toolbox/mechanical,
/turf/simulated/floor/tiled/techfloor,
/area/shuttle/mackerel_hc)
"ug" = (
/obj/machinery/door/airlock/hatch,
/turf/simulated/floor/tiled/techmaint,
/area/shuttle/mackerel_hc)
"um" = (
/obj/machinery/atmospherics/unary/vent_scrubber/on{
	dir = 1
	},
/obj/machinery/light{
	dir = 8;
	icon_state = "tube1";
	pixel_x = 0
	},
/turf/simulated/floor/tiled/techfloor,
/area/shuttle/mackerel_hc)
"ut" = (
/obj/machinery/atmospherics/pipe/simple/hidden/scrubbers,
/obj/effect/floor_decal/industrial/warning/corner,
/obj/effect/floor_decal/industrial/warning{
	dir = 8
	},
/obj/machinery/light,
/turf/simulated/floor/tiled/techfloor,
/area/shuttle/mackerel_hc)
"uR" = (
/obj/machinery/atmospherics/pipe/manifold/hidden/supply{
	dir = 8
	},
/turf/simulated/wall/rshull,
/area/shuttle/mackerel_hc)
"we" = (
/obj/structure/shuttle/engine/heater,
/obj/machinery/atmospherics/pipe/simple/visible/yellow,
/turf/simulated/floor/tiled/techfloor,
/area/shuttle/mackerel_hc)
"wF" = (
/obj/machinery/atmospherics/pipe/simple/hidden/scrubbers,
/obj/structure/cable{
	d1 = 4;
	d2 = 8;
	icon_state = "4-8";
	pixel_x = 0
	},
/obj/effect/floor_decal/industrial/warning/corner{
	dir = 8
	},
/obj/structure/closet/crate/large,
/obj/structure/window/reinforced,
/obj/structure/window/reinforced{
	dir = 1
	},
/obj/machinery/door/window,
/turf/simulated/floor/tiled/techfloor,
/area/shuttle/mackerel_hc)
"wN" = (
/obj/machinery/atmospherics/pipe/simple/hidden,
/turf/simulated/wall/shull,
/area/shuttle/mackerel_hc)
"xd" = (
/obj/machinery/atmospherics/pipe/simple/hidden/supply,
/obj/effect/floor_decal/industrial/warning{
	dir = 4
	},
/turf/simulated/floor/tiled/techmaint,
/area/shuttle/mackerel_hc)
"xB" = (
/obj/machinery/atmospherics/pipe/simple/hidden/supply{
	dir = 4
	},
/turf/simulated/wall/rshull,
/area/shuttle/mackerel_hc)
"yH" = (
/obj/structure/handrail,
/turf/simulated/floor/airless,
/area/shuttle/mackerel_hc)
"zq" = (
/obj/structure/cable{
	d1 = 4;
	d2 = 8;
	icon_state = "4-8";
	pixel_x = 0
	},
/turf/simulated/wall/rshull,
/area/shuttle/mackerel_hc)
"BN" = (
/obj/machinery/atmospherics/pipe/simple/hidden/supply,
/turf/simulated/wall/rshull,
/area/shuttle/mackerel_hc)
"BP" = (
/obj/machinery/atmospherics/pipe/manifold/visible/yellow{
	dir = 1
	},
/obj/structure/cable{
	d1 = 1;
	d2 = 4;
	icon_state = "1-4"
	},
/obj/effect/floor_decal/industrial/warning{
	dir = 1
	},
/turf/simulated/floor/tiled/techfloor,
/area/shuttle/mackerel_hc)
"Ck" = (
/obj/machinery/atmospherics/pipe/simple/hidden/scrubbers,
/obj/effect/floor_decal/industrial/warning/corner{
	dir = 8
	},
/obj/structure/extinguisher_cabinet{
	dir = 4;
	icon_state = "extinguisher_closed";
	pixel_x = -30
	},
/obj/structure/closet/crate/large,
/obj/structure/window/reinforced,
/obj/structure/window/reinforced{
	dir = 1
	},
/obj/machinery/door/window,
/turf/simulated/floor/tiled/techfloor,
/area/shuttle/mackerel_hc)
"Da" = (
/obj/machinery/portable_atmospherics/canister/air,
/obj/machinery/atmospherics/portables_connector{
	dir = 8
	},
/obj/effect/floor_decal/industrial/outline/blue,
/turf/simulated/floor/plating,
/area/shuttle/mackerel_hc)
"Dc" = (
/obj/structure/handrail,
/obj/machinery/light/small/flicker{
	dir = 4
	},
/turf/simulated/floor/airless,
/area/shuttle/mackerel_hc)
"Dl" = (
/obj/machinery/atmospherics/unary/vent_pump/on{
	dir = 4
	},
/obj/structure/cable{
	d1 = 2;
	d2 = 8;
	icon_state = "2-8"
	},
/turf/simulated/floor/tiled/techmaint,
/area/shuttle/mackerel_hc)
"Dq" = (
/obj/machinery/atmospherics/pipe/simple/hidden/scrubbers,
/obj/structure/cable{
	d1 = 1;
	d2 = 2;
	icon_state = "1-2"
	},
/obj/effect/shuttle_landmark/shuttle_initializer/mackerel_hc,
/obj/effect/overmap/visitable/ship/landable/mackerel_hc,
/turf/simulated/floor/tiled/techmaint,
/area/shuttle/mackerel_hc)
"EC" = (
/obj/machinery/atmospherics/pipe/simple/hidden/scrubbers,
/obj/effect/floor_decal/industrial/warning{
	dir = 8
	},
/obj/effect/floor_decal/industrial/warning/corner{
	dir = 4
	},
/obj/machinery/light{
	dir = 1
	},
/turf/simulated/floor/tiled/techfloor,
/area/shuttle/mackerel_hc)
"EK" = (
/obj/machinery/atmospherics/pipe/simple/hidden/supply,
/obj/effect/floor_decal/industrial/warning{
	dir = 4
	},
/obj/machinery/alarm/alarms_hidden{
	pixel_y = 26
	},
/obj/effect/floor_decal/industrial/warning/corner{
	dir = 1
	},
/obj/machinery/light{
	dir = 1
	},
/turf/simulated/floor/tiled/techfloor,
/area/shuttle/mackerel_hc)
"EL" = (
/obj/structure/symbol/gu,
/turf/simulated/wall/rshull{
	can_open = 1
	},
/area/shuttle/mackerel_hc)
"FH" = (
/obj/machinery/atmospherics/pipe/simple/hidden/scrubbers,
/obj/effect/floor_decal/industrial/warning/corner{
	dir = 1
	},
/obj/structure/closet/crate/large,
/obj/structure/window/reinforced{
	dir = 1
	},
/obj/structure/window/reinforced,
/obj/machinery/door/window,
/turf/simulated/floor/tiled/techfloor,
/area/shuttle/mackerel_hc)
"FL" = (
/obj/machinery/door/airlock/hatch,
/obj/effect/map_helper/airlock/door/ext_door,
/obj/effect/map_helper/airlock/sensor/ext_sensor,
/obj/machinery/airlock_sensor/airlock_exterior/shuttle{
	dir = 6;
	pixel_x = 7;
	pixel_y = 26
	},
/turf/simulated/floor/tiled/techmaint,
/area/shuttle/mackerel_hc)
"FN" = (
/obj/structure/handrail{
	dir = 8
	},
/turf/simulated/floor/plating,
/area/shuttle/mackerel_hc)
"FS" = (
/obj/machinery/atmospherics/pipe/simple/visible/yellow,
/obj/machinery/computer/ship/engines{
	dir = 1;
	icon_state = "computer"
	},
/turf/simulated/floor/tiled/techfloor,
/area/shuttle/mackerel_hc)
"Gm" = (
/obj/machinery/atmospherics/unary/engine{
	dir = 1
	},
/obj/structure/window/reinforced{
	dir = 1
	},
/turf/simulated/floor/airless,
/area/shuttle/mackerel_hc)
"GF" = (
/obj/machinery/power/smes/buildable,
/obj/structure/cable{
	d2 = 4;
	icon_state = "0-4"
	},
/turf/simulated/floor/plating,
/area/shuttle/mackerel_hc)
"GK" = (
/obj/machinery/atmospherics/pipe/manifold/hidden/supply{
	dir = 4
	},
/obj/effect/floor_decal/industrial/warning/corner,
/obj/structure/closet/crate/large,
/obj/structure/window/reinforced,
/obj/structure/window/reinforced{
	dir = 1
	},
/obj/machinery/door/window/westright,
/turf/simulated/floor/tiled/techfloor,
/area/shuttle/mackerel_hc)
"Jq" = (
/obj/machinery/atmospherics/pipe/simple/hidden/scrubbers{
	dir = 6
	},
/turf/simulated/wall/rshull,
/area/shuttle/mackerel_hc)
"JG" = (
/obj/machinery/atmospherics/valve/open,
/obj/structure/handrail{
	dir = 4
	},
/turf/simulated/floor/plating,
/area/shuttle/mackerel_hc)
"JP" = (
/obj/effect/floor_decal/industrial/warning{
	dir = 1
	},
/turf/simulated/floor/tiled/techmaint,
/area/shuttle/mackerel_hc)
"Kb" = (
/obj/machinery/atmospherics/unary/vent_scrubber/on{
	dir = 1
	},
/obj/structure/cable{
	d1 = 1;
	d2 = 2;
	icon_state = "1-2"
	},
/turf/simulated/floor/tiled/techmaint,
/area/shuttle/mackerel_hc)
"Ko" = (
/turf/simulated/wall/rshull,
/area/shuttle/mackerel_hc)
"KZ" = (
/obj/machinery/atmospherics/valve/open,
/obj/structure/handrail{
	dir = 8
	},
/turf/simulated/floor/plating,
/area/shuttle/mackerel_hc)
"LU" = (
/obj/machinery/atmospherics/portables_connector{
	dir = 8
	},
/obj/machinery/portable_atmospherics/canister/empty,
/obj/effect/floor_decal/industrial/outline/red,
/turf/simulated/floor/plating,
/area/shuttle/mackerel_hc)
"LW" = (
/obj/machinery/atmospherics/pipe/simple/hidden/supply,
/obj/structure/closet/crate/large,
/obj/structure/window/reinforced{
	dir = 1
	},
/obj/structure/window/reinforced,
/obj/machinery/door/window/westright,
/turf/simulated/floor/tiled/techfloor,
/area/shuttle/mackerel_hc)
"Nr" = (
/obj/machinery/power/terminal{
	dir = 1
	},
/obj/machinery/light/small/flicker{
	dir = 8
	},
/turf/simulated/floor/plating,
/area/shuttle/mackerel_hc)
"NN" = (
/obj/machinery/atmospherics/pipe/simple/hidden/scrubbers{
	dir = 5
	},
/obj/effect/floor_decal/industrial/warning{
	dir = 8
	},
/turf/simulated/floor/tiled/techfloor,
/area/shuttle/mackerel_hc)
"Pc" = (
/obj/machinery/atmospherics/pipe/simple/hidden/scrubbers{
	dir = 4
	},
/obj/machinery/atmospherics/pipe/simple/hidden/supply,
/obj/effect/floor_decal/industrial/warning{
	dir = 4
	},
/turf/simulated/floor/tiled/techfloor,
/area/shuttle/mackerel_hc)
"PI" = (
/obj/machinery/atmospherics/pipe/simple/hidden/scrubbers{
	dir = 9
	},
/obj/structure/symbol/gu,
/turf/simulated/wall/rshull{
	can_open = 1
	},
/area/shuttle/mackerel_hc)
"PL" = (
/obj/machinery/door/airlock/hatch,
/obj/machinery/door/firedoor/glass,
/obj/effect/map_helper/airlock/door/int_door,
/turf/simulated/floor/tiled/techmaint,
/area/shuttle/mackerel_hc)
"Qu" = (
/obj/machinery/atmospherics/pipe/simple/hidden/scrubbers,
/obj/structure/closet/crate/large,
/obj/structure/window/reinforced{
	dir = 1
	},
/obj/structure/window/reinforced,
/obj/machinery/door/window,
/turf/simulated/floor/tiled/techfloor,
/area/shuttle/mackerel_hc)
"RB" = (
/obj/machinery/light/small/flicker{
	dir = 4
	},
/turf/simulated/floor/plating,
/area/shuttle/mackerel_hc)
"RT" = (
/obj/structure/handrail{
	dir = 4
	},
/obj/machinery/portable_atmospherics/canister/air/airlock,
/obj/machinery/atmospherics/portables_connector,
/obj/effect/floor_decal/industrial/outline/blue,
/turf/simulated/floor/plating,
/area/shuttle/mackerel_hc)
"RV" = (
/obj/machinery/atmospherics/pipe/simple/visible/yellow{
	dir = 4
	},
/obj/machinery/atmospherics/pipe/simple/hidden/scrubbers,
/obj/structure/fuel_port{
	pixel_y = 26
	},
/obj/machinery/alarm/alarms_hidden{
	dir = 4;
	pixel_x = -26
	},
/obj/effect/floor_decal/industrial/warning/corner{
	dir = 4
	},
/turf/simulated/floor/tiled/techfloor,
/area/shuttle/mackerel_hc)
"So" = (
/obj/machinery/atmospherics/pipe/simple/hidden/supply,
/obj/effect/floor_decal/industrial/warning/corner{
	dir = 4
	},
/obj/structure/closet/crate/large,
/obj/structure/window/reinforced{
	dir = 1
	},
/obj/structure/window/reinforced,
/obj/machinery/door/window/westright,
/turf/simulated/floor/tiled/techfloor,
/area/shuttle/mackerel_hc)
"Td" = (
/obj/machinery/airlock_sensor{
	pixel_x = -25
	},
/obj/effect/map_helper/airlock/sensor/int_sensor,
/obj/effect/floor_decal/industrial/warning/corner{
	dir = 8
	},
/obj/machinery/light{
	dir = 8
	},
/turf/simulated/floor/tiled/techfloor,
/area/shuttle/mackerel_hc)
"UY" = (
/obj/machinery/atmospherics/unary/engine{
	dir = 1
	},
/turf/simulated/floor/airless,
/area/shuttle/mackerel_hc)
"Vs" = (
/obj/machinery/atmospherics/unary/vent_pump{
	dir = 1
	},
/obj/structure/handrail,
/obj/effect/map_helper/airlock/sensor/chamber_sensor,
/obj/effect/map_helper/airlock/atmos/chamber_pump,
/obj/machinery/airlock_sensor{
	pixel_y = 21
	},
/obj/machinery/light,
/obj/effect/floor_decal/industrial/warning{
	dir = 4
	},
/obj/effect/floor_decal/industrial/warning{
	dir = 8
	},
/turf/simulated/floor/tiled/techmaint,
/area/shuttle/mackerel_hc)
"Wj" = (
/obj/effect/floor_decal/industrial/warning,
/obj/structure/cable{
	d1 = 1;
	d2 = 2;
	icon_state = "1-2"
	},
/turf/simulated/floor/tiled/techmaint,
/area/shuttle/mackerel_hc)
"Wr" = (
/obj/effect/floor_decal/industrial/warning/corner{
	dir = 1
	},
/obj/structure/closet/crate/large,
/obj/structure/window/reinforced{
	dir = 1
	},
/obj/structure/window/reinforced,
/obj/machinery/door/window,
/turf/simulated/floor/tiled/techfloor,
/area/shuttle/mackerel_hc)
"Wv" = (
/obj/structure/sign/warning/airlock,
/turf/simulated/wall/rshull,
/area/shuttle/mackerel_hc)
"WP" = (
/turf/template_noop,
/area/template_noop)
"WS" = (
/obj/structure/grille,
/turf/simulated/floor/airless,
/area/shuttle/mackerel_hc)
"WW" = (
/obj/machinery/atmospherics/pipe/manifold/hidden/scrubbers{
	dir = 1
	},
/obj/structure/cable{
	d1 = 1;
	d2 = 2;
	icon_state = "1-2"
	},
/turf/simulated/floor/tiled/techmaint,
/area/shuttle/mackerel_hc)
"Xn" = (
/obj/structure/handrail{
	dir = 8
	},
/obj/machinery/portable_atmospherics/canister/air/airlock,
/obj/machinery/atmospherics/portables_connector,
/obj/effect/floor_decal/industrial/outline/blue,
/turf/simulated/floor/plating,
/area/shuttle/mackerel_hc)
"Xs" = (
/obj/machinery/atmospherics/pipe/simple/hidden/scrubbers,
/obj/structure/cable{
	d1 = 1;
	d2 = 2;
	icon_state = "1-2"
	},
/turf/simulated/floor/tiled/techmaint,
/area/shuttle/mackerel_hc)
"Zb" = (
/obj/structure/handrail,
/obj/machinery/light/small/flicker{
	dir = 8
	},
/turf/simulated/floor/airless,
/area/shuttle/mackerel_hc)
"Zp" = (
/turf/simulated/floor/tiled/techmaint,
/area/shuttle/mackerel_hc)
"ZJ" = (
/obj/machinery/atmospherics/unary/vent_pump/on{
	dir = 1
	},
/obj/machinery/light{
	dir = 4;
	icon_state = "tube1"
	},
/obj/structure/extinguisher_cabinet{
	dir = 8;
	icon_state = "extinguisher_closed";
	pixel_x = 30
	},
/turf/simulated/floor/tiled/techfloor,
/area/shuttle/mackerel_hc)
"ZK" = (
/obj/effect/floor_decal/industrial/warning{
	dir = 8
	},
/turf/simulated/floor/tiled/techmaint,
/area/shuttle/mackerel_hc)

(1,1,1) = {"
WP
WP
WP
WP
WP
WP
WP
WP
WP
WP
WP
WP
WP
WP
WP
WP
WP
WP
WP
WP
WP
WP
WP
"}
(2,1,1) = {"
WP
WP
WP
WP
WP
WP
WP
WP
WP
WP
WP
WP
WP
WP
WP
WP
ka
ka
ka
ka
ka
WP
WP
"}
(3,1,1) = {"
WP
WP
WP
WP
WP
WP
WP
WP
WP
WP
WP
WP
WP
WP
WP
WP
ka
Zb
bI
mi
UY
WP
WP
"}
(4,1,1) = {"
WP
WP
WP
ka
WS
WS
ka
WP
ka
WS
WS
ka
WP
WP
WP
WP
ka
ka
tV
ka
ka
WP
WP
"}
(5,1,1) = {"
WP
WP
WP
jp
WP
WP
jp
WP
jp
WP
WP
jp
WP
WP
WP
WP
WP
ka
tV
yH
WP
WP
WP
"}
(6,1,1) = {"
WP
WP
WP
ka
ka
ka
ka
ka
ka
ka
ka
ka
ka
pZ
ka
ka
ka
ka
tV
ka
WP
WP
WP
"}
(7,1,1) = {"
WP
az
ka
ka
ju
oq
fD
aq
fD
GF
Nr
RT
wN
mw
ka
fL
JG
kU
dG
ka
WP
WP
WP
"}
(8,1,1) = {"
WP
ka
ka
Ko
Ko
Ko
EL
Ko
Ko
zq
EL
Ko
Ko
PL
Wv
Ko
EL
Ko
tV
ka
ka
ka
WP
"}
(9,1,1) = {"
WP
aF
bw
gT
lC
sZ
EC
FH
Qu
wF
NN
Wr
Td
ZK
rc
Ck
ut
sZ
RV
um
ue
ka
WP
"}
(10,1,1) = {"
WP
aF
cv
Zp
cD
ug
JP
Zp
Zp
Dl
WW
Xs
Xs
Dq
bY
Kb
Wj
cg
BP
FS
we
Gm
WP
"}
(11,1,1) = {"
WP
aF
gv
iP
mf
uR
EK
So
LW
GK
Pc
So
sL
xd
So
lT
rr
BN
sg
ZJ
nD
ka
WP
"}
(12,1,1) = {"
WP
ka
ka
Ko
Ko
xB
EL
Ko
Ko
Jq
PI
Ko
Ko
PL
Wv
Ko
EL
Ko
tV
ka
ka
ka
WP
"}
(13,1,1) = {"
WP
WP
ka
ka
oe
Da
FN
RB
FN
LU
RB
Xn
wN
Vs
ka
fL
KZ
rQ
dG
ka
WP
WP
WP
"}
(14,1,1) = {"
WP
WP
WP
ka
ka
ka
ka
ka
ka
ka
ka
ka
ka
FL
ka
ka
ka
ka
tV
ka
WP
WP
WP
"}
(15,1,1) = {"
WP
WP
WP
jp
WP
WP
jp
WP
jp
WP
WP
jp
WP
WP
WP
WP
WP
ka
tV
yH
WP
WP
WP
"}
(16,1,1) = {"
WP
WP
WP
ka
WS
WS
ka
WP
ka
WS
WS
ka
WP
WP
WP
WP
ka
ka
tV
ka
ka
WP
WP
"}
(17,1,1) = {"
WP
WP
WP
WP
WP
WP
WP
WP
WP
WP
WP
WP
WP
WP
WP
WP
ka
Dc
gU
mi
UY
WP
WP
"}
(18,1,1) = {"
WP
WP
WP
WP
WP
WP
WP
WP
WP
WP
WP
WP
WP
WP
WP
WP
ka
ka
ka
ka
ka
WP
WP
"}
(19,1,1) = {"
WP
WP
WP
WP
WP
WP
WP
WP
WP
WP
WP
WP
WP
WP
WP
WP
WP
WP
WP
WP
WP
WP
WP
"}
