//MAP CONVERTED BY dmm2tgm.py THIS HEADER COMMENT PREVENTS RECONVERSION, DO NOT REMOVE
"bd" = (
/obj/machinery/atmospherics/pipe/simple/hidden/fuel,
/obj/machinery/atmospherics/unary/vent_pump{
	dir = 8
	},
/obj/effect/map_helper/airlock/atmos/pump_out_internal,
/obj/structure/closet/walllocker_double/emergency_engi/north,
/obj/fiftyspawner/steel/hull,
/obj/fiftyspawner/rglass,
/obj/item/storage/toolbox/mechanical,
/turf/simulated/floor/tiled/techfloor,
/area/shuttle/sdf_corvette)
"bn" = (
/obj/structure/cable/green{
	icon_state = "2-4"
	},
/obj/structure/cable/green{
	icon_state = "1-2"
	},
/obj/machinery/atmospherics/pipe/simple/hidden/scrubbers,
/obj/machinery/atmospherics/pipe/simple/hidden/supply{
	dir = 10
	},
/turf/simulated/floor/tiled/techfloor,
/area/shuttle/sdf_corvette)
"cJ" = (
/obj/machinery/atmospherics/pipe/simple/hidden/fuel{
	dir = 10
	},
/turf/simulated/wall/rshull,
/area/shuttle/sdf_corvette)
"cS" = (
/obj/machinery/atmospherics/pipe/simple/hidden/universal{
	dir = 4
	},
/obj/effect/map_helper/airlock/sensor/int_sensor,
/obj/machinery/airlock_sensor/airlock_interior{
	pixel_y = -24
	},
/turf/simulated/floor/tiled/techfloor,
/area/shuttle/sdf_corvette)
"dv" = (
/obj/structure/cable/green{
	icon_state = "4-8"
	},
/turf/simulated/wall/rshull,
/area/shuttle/sdf_corvette)
"dG" = (
/obj/machinery/sleeper{
	dir = 8
	},
/turf/simulated/floor/tiled/techfloor,
/area/shuttle/sdf_corvette)
"dQ" = (
/obj/machinery/atmospherics/unary/vent_pump{
	dir = 4
	},
/obj/effect/map_helper/airlock/atmos/chamber_pump,
/obj/item/storage/toolbox/electrical,
/obj/structure/closet/walllocker_double/emergency_engi/north,
/obj/machinery/button/remote/airlock{
	dir = 4;
	id = "sdf_airlock_w";
	name = "Port Airlock Control";
	pixel_x = -24;
	specialfunctions = 4
	},
/turf/simulated/floor/tiled/techfloor,
/area/shuttle/sdf_corvette)
"en" = (
/obj/structure/cable{
	d1 = 1;
	d2 = 2;
	icon_state = "1-2"
	},
/obj/machinery/atmospherics/pipe/manifold/hidden/supply{
	dir = 8
	},
/turf/simulated/floor/tiled/techfloor,
/area/shuttle/sdf_corvette)
"eD" = (
/obj/machinery/door/firedoor/glass,
/obj/structure/grille,
/obj/structure/window/reinforced/full,
/obj/structure/window/reinforced{
	dir = 1
	},
/obj/machinery/door/blast/regular/open{
	dir = 4;
	id = "sdfc_cockpitshutters";
	name = "Blast Shield"
	},
/turf/simulated/floor/plating,
/area/shuttle/sdf_corvette)
"eT" = (
/obj/machinery/atmospherics/pipe/tank/phoron,
/obj/structure/window/reinforced{
	dir = 8
	},
/obj/effect/floor_decal/industrial/warning/full,
/turf/simulated/floor/tiled/techfloor,
/area/shuttle/sdf_corvette)
"fX" = (
/obj/machinery/door/firedoor/glass,
/obj/effect/floor_decal/industrial/warning{
	dir = 8
	},
/obj/machinery/door/airlock/voidcraft/vertical{
	icon_state = "door_locked";
	id_tag = "sdfc_airlock_w";
	locked = 1
	},
/turf/simulated/floor/tiled/techfloor,
/area/shuttle/sdf_corvette)
"hn" = (
/obj/machinery/atmospherics/unary/vent_pump{
	dir = 4
	},
/obj/effect/map_helper/airlock/atmos/chamber_pump,
/obj/machinery/light,
/turf/simulated/floor/tiled/techfloor,
/area/shuttle/sdf_corvette)
"hy" = (
/obj/machinery/power/smes/buildable,
/obj/structure/cable/green{
	d2 = 4;
	icon_state = "0-4"
	},
/turf/simulated/floor/tiled/techfloor,
/area/shuttle/sdf_corvette)
"jK" = (
/obj/structure/handrail,
/obj/machinery/atmospherics/pipe/manifold4w/hidden,
/obj/machinery/embedded_controller/radio/airlock/docking_port{
	id_tag = "sdfc_dock_con";
	pixel_y = 24
	},
/turf/simulated/floor/tiled/techfloor,
/area/shuttle/sdf_corvette)
"jS" = (
/obj/machinery/computer/ship/helm{
	req_one_access = list()
	},
/turf/simulated/floor/tiled/techfloor,
/area/shuttle/sdf_corvette)
"kI" = (
/obj/structure/bed/chair/shuttle{
	dir = 1
	},
/obj/structure/cable/green{
	icon_state = "2-4"
	},
/obj/machinery/atmospherics/unary/vent_scrubber,
/turf/simulated/floor/tiled/techfloor,
/area/shuttle/sdf_corvette)
"lI" = (
/obj/machinery/atmospherics/unary/vent_pump{
	dir = 8
	},
/obj/effect/map_helper/airlock/atmos/chamber_pump,
/turf/simulated/floor/tiled/techfloor,
/area/shuttle/sdf_corvette)
"lJ" = (
/obj/machinery/atmospherics/pipe/simple/hidden,
/turf/simulated/wall/rshull,
/area/shuttle/sdf_corvette)
"lN" = (
/obj/structure/cable{
	d1 = 2;
	d2 = 8;
	icon_state = "2-8"
	},
/obj/machinery/atmospherics/pipe/simple/hidden/supply,
/obj/machinery/atmospherics/pipe/manifold/hidden/scrubbers{
	dir = 8
	},
/turf/simulated/floor/tiled/techfloor,
/area/shuttle/sdf_corvette)
"lW" = (
/obj/structure/cable{
	d1 = 1;
	d2 = 2;
	icon_state = "1-2"
	},
/obj/machinery/door/firedoor/glass,
/obj/effect/map_helper/airlock/door/int_door,
/obj/machinery/door/airlock/voidcraft,
/turf/simulated/floor/tiled/techfloor,
/area/shuttle/sdf_corvette)
"ms" = (
/obj/machinery/computer/ship/sensors{
	dir = 4
	},
/obj/machinery/button/remote/blast_door{
	id = "sdfc_cockpitshutters";
	name = "Blast Shields Control";
	pixel_y = 24
	},
/turf/simulated/floor/tiled/techfloor,
/area/shuttle/sdf_corvette)
"mT" = (
/obj/structure/cable/green{
	icon_state = "1-4"
	},
/obj/structure/cable/green{
	icon_state = "1-8"
	},
/obj/machinery/sleep_console,
/turf/simulated/floor/tiled/techfloor,
/area/shuttle/sdf_corvette)
"nh" = (
/obj/machinery/atmospherics/pipe/simple/hidden/fuel{
	dir = 6
	},
/turf/simulated/wall/rshull,
/area/shuttle/sdf_corvette)
"nq" = (
/obj/structure/handrail,
/obj/effect/floor_decal/industrial/warning{
	dir = 4
	},
/obj/machinery/button/remote/airlock{
	id = "sdfc_compartment";
	name = "Access Hatch Control";
	pixel_y = 24;
	specialfunctions = 4
	},
/turf/simulated/floor/tiled/techfloor,
/area/shuttle/sdf_corvette)
"nr" = (
/obj/machinery/pointdefense_control{
	id_tag = "sdfc_pd"
	},
/obj/machinery/alarm/alarms_hidden{
	dir = 1;
	pixel_y = -26
	},
/turf/simulated/floor/tiled/techfloor,
/area/shuttle/sdf_corvette)
"pl" = (
/obj/structure/bed/chair/bay/shuttle{
	dir = 8
	},
/obj/structure/cable/green{
	icon_state = "4-8"
	},
/obj/machinery/atmospherics/unary/vent_scrubber{
	dir = 8
	},
/obj/machinery/alarm/alarms_hidden{
	dir = 8;
	pixel_x = 26
	},
/turf/simulated/floor/tiled/techfloor,
/area/shuttle/sdf_corvette)
"pu" = (
/obj/machinery/sleep_console,
/turf/simulated/floor/tiled/techfloor,
/area/shuttle/sdf_corvette)
"pG" = (
/obj/effect/floor_decal/industrial/warning{
	dir = 6
	},
/obj/machinery/atmospherics/unary/vent_pump/high_volume{
	dir = 1
	},
/obj/effect/map_helper/airlock/atmos/pump_out_external,
/turf/simulated/floor/tiled/techfloor{
	nitrogen = 0;
	oxygen = 0
	},
/area/shuttle/sdf_corvette)
"ri" = (
/obj/machinery/door/firedoor/glass,
/obj/structure/grille,
/obj/structure/window/reinforced/full,
/obj/structure/window/reinforced{
	dir = 4
	},
/obj/structure/cable/green{
	icon_state = "1-8"
	},
/obj/machinery/door/blast/regular/open{
	id = "sdfc_cockpitshutters";
	name = "Blast Shield"
	},
/turf/simulated/floor/plating,
/area/shuttle/sdf_corvette)
"rX" = (
/obj/structure/bed/chair/bay/shuttle{
	dir = 4
	},
/obj/machinery/power/terminal{
	dir = 1
	},
/obj/structure/cable{
	d2 = 4;
	icon_state = "0-4"
	},
/obj/structure/extinguisher_cabinet{
	dir = 4;
	pixel_x = -30
	},
/turf/simulated/floor/tiled/techfloor,
/area/shuttle/sdf_corvette)
"sG" = (
/obj/structure/cable{
	d1 = 1;
	d2 = 2;
	icon_state = "1-2"
	},
/obj/machinery/atmospherics/unary/vent_pump{
	dir = 4
	},
/obj/effect/map_helper/airlock/atmos/pump_out_internal,
/turf/simulated/floor/tiled/techfloor,
/area/shuttle/sdf_corvette)
"tg" = (
/obj/structure/cable/green{
	icon_state = "4-8"
	},
/obj/machinery/sleeper{
	dir = 8
	},
/turf/simulated/floor/tiled/techfloor,
/area/shuttle/sdf_corvette)
"tt" = (
/obj/machinery/atmospherics/pipe/manifold/hidden/fuel{
	dir = 8
	},
/obj/structure/cable{
	d1 = 4;
	d2 = 8;
	icon_state = "4-8"
	},
/obj/machinery/atmospherics/unary/vent_pump{
	dir = 8
	},
/obj/effect/map_helper/airlock/atmos/pump_out_internal,
/obj/effect/shuttle_landmark/shuttle_initializer/sdf_corvette,
/obj/effect/overmap/visitable/ship/landable/sdf_corvette,
/obj/machinery/light,
/turf/simulated/floor/tiled/techfloor,
/area/shuttle/sdf_corvette)
"uw" = (
/obj/structure/bed/chair/bay/shuttle{
	dir = 8
	},
/obj/structure/closet/walllocker/emerglocker/east,
/obj/machinery/atmospherics/unary/vent_pump/on{
	dir = 8
	},
/turf/simulated/floor/tiled/techfloor,
/area/shuttle/sdf_corvette)
"uD" = (
/obj/structure/cable{
	d1 = 4;
	d2 = 8;
	icon_state = "4-8"
	},
/obj/structure/cable/green{
	icon_state = "1-2"
	},
/turf/simulated/floor/tiled/techfloor,
/area/shuttle/sdf_corvette)
"wl" = (
/obj/machinery/atmospherics/unary/vent_pump{
	dir = 8
	},
/obj/effect/map_helper/airlock/atmos/chamber_pump,
/obj/machinery/light{
	dir = 1
	},
/turf/simulated/floor/tiled/techfloor,
/area/shuttle/sdf_corvette)
"wn" = (
/obj/machinery/atmospherics/pipe/manifold/hidden/fuel{
	dir = 1
	},
/obj/machinery/atmospherics/pipe/simple/hidden{
	dir = 9
	},
/turf/simulated/wall/rshull,
/area/shuttle/sdf_corvette)
"wQ" = (
/obj/structure/cable/green{
	icon_state = "1-2"
	},
/obj/machinery/door/firedoor/glass,
/obj/machinery/door/airlock/hatch{
	req_one_access = list()
	},
/obj/machinery/atmospherics/pipe/simple/hidden/scrubbers,
/obj/machinery/atmospherics/pipe/simple/hidden/supply,
/turf/simulated/floor/tiled/techfloor,
/area/shuttle/sdf_corvette)
"xk" = (
/obj/structure/cable{
	d1 = 1;
	d2 = 2;
	icon_state = "1-2"
	},
/obj/structure/cable/green{
	icon_state = "4-8"
	},
/obj/machinery/atmospherics/pipe/simple/hidden/scrubbers{
	dir = 5
	},
/obj/machinery/atmospherics/pipe/simple/hidden/supply,
/turf/simulated/floor/tiled/techfloor,
/area/shuttle/sdf_corvette)
"ye" = (
/obj/machinery/atmospherics/pipe/manifold4w/hidden/fuel,
/turf/simulated/wall/rshull,
/area/shuttle/sdf_corvette)
"yA" = (
/obj/structure/cable{
	d1 = 1;
	d2 = 2;
	icon_state = "1-2"
	},
/obj/machinery/atmospherics/pipe/simple/hidden/supply{
	dir = 9
	},
/turf/simulated/floor/tiled/techfloor,
/area/shuttle/sdf_corvette)
"yN" = (
/obj/machinery/atmospherics/unary/vent_pump{
	dir = 8
	},
/obj/structure/handrail{
	dir = 4
	},
/obj/effect/floor_decal/industrial/warning{
	dir = 4
	},
/turf/simulated/floor/airless,
/area/shuttle/sdf_corvette)
"zb" = (
/obj/structure/cable/green{
	icon_state = "1-8"
	},
/obj/machinery/atmospherics/pipe/simple/hidden/supply,
/obj/machinery/atmospherics/pipe/simple/hidden/scrubbers,
/turf/simulated/floor/tiled/techfloor,
/area/shuttle/sdf_corvette)
"zn" = (
/obj/effect/floor_decal/industrial/hatch/yellow,
/obj/structure/sign/warning/airlock{
	pixel_y = -32
	},
/obj/machinery/light,
/turf/simulated/floor/tiled/techfloor,
/area/shuttle/sdf_corvette)
"zX" = (
/obj/machinery/atmospherics/pipe/simple/hidden/supply{
	dir = 5
	},
/obj/structure/extinguisher_cabinet{
	dir = 1;
	pixel_y = -28
	},
/obj/machinery/light,
/turf/simulated/floor/tiled/techfloor,
/area/shuttle/sdf_corvette)
"Cg" = (
/obj/structure/cable{
	d1 = 1;
	d2 = 4;
	icon_state = "1-4"
	},
/obj/machinery/atmospherics/unary/vent_pump{
	dir = 4
	},
/obj/effect/map_helper/airlock/atmos/pump_out_internal,
/turf/simulated/floor/tiled/techfloor,
/area/shuttle/sdf_corvette)
"Cq" = (
/obj/structure/cable/green{
	icon_state = "4-8"
	},
/obj/machinery/computer/ship/engines{
	dir = 8
	},
/obj/machinery/button/remote/blast_door{
	id = "sdfc_cockpitshutters";
	name = "Blast Shields Control";
	pixel_y = 24
	},
/turf/simulated/floor/tiled/techfloor,
/area/shuttle/sdf_corvette)
"Eg" = (
/obj/structure/cable/green{
	d2 = 2;
	icon_state = "0-2"
	},
/obj/effect/floor_decal/industrial/warning{
	dir = 5
	},
/obj/machinery/power/pointdefense{
	id_tag = "sdfc_pd";
	name = "\improper twin-linked laser turret"
	},
/turf/simulated/floor/airless,
/area/shuttle/sdf_corvette)
"Eo" = (
/obj/effect/floor_decal/industrial/warning{
	dir = 4
	},
/turf/simulated/floor/airless,
/area/shuttle/sdf_corvette)
"EN" = (
/obj/structure/handrail,
/obj/machinery/atmospherics/pipe/manifold/hidden{
	dir = 1
	},
/obj/machinery/airlock_sensor{
	pixel_y = 22
	},
/obj/effect/map_helper/airlock/sensor/chamber_sensor,
/turf/simulated/floor/tiled/techfloor,
/area/shuttle/sdf_corvette)
"Fb" = (
/obj/structure/cable/green{
	icon_state = "1-2"
	},
/turf/simulated/wall/rshull,
/area/shuttle/sdf_corvette)
"Fp" = (
/obj/machinery/atmospherics/pipe/simple/hidden/scrubbers{
	dir = 4
	},
/turf/simulated/wall/rshull,
/area/shuttle/sdf_corvette)
"Hb" = (
/obj/machinery/shipsensors{
	dir = 1
	},
/obj/effect/floor_decal/industrial/warning{
	dir = 9
	},
/turf/simulated/floor/airless,
/area/shuttle/sdf_corvette)
"Hu" = (
/obj/machinery/atmospherics/pipe/manifold/hidden/fuel{
	dir = 1
	},
/turf/simulated/wall/rshull,
/area/shuttle/sdf_corvette)
"Ib" = (
/obj/machinery/atmospherics/pipe/simple/hidden/fuel{
	dir = 4
	},
/obj/structure/cable{
	d1 = 4;
	d2 = 8;
	icon_state = "4-8"
	},
/obj/machinery/door/firedoor/glass,
/obj/effect/floor_decal/industrial/warning{
	dir = 4
	},
/obj/effect/map_helper/airlock/door/ext_door,
/obj/machinery/door/airlock/voidcraft/vertical,
/obj/machinery/airlock_sensor/airlock_exterior{
	dir = 4;
	pixel_x = 10;
	pixel_y = 25
	},
/obj/effect/map_helper/airlock/sensor/ext_sensor,
/turf/simulated/floor/tiled/techfloor,
/area/shuttle/sdf_corvette)
"IY" = (
/obj/machinery/door/firedoor/glass,
/obj/structure/grille,
/obj/structure/window/reinforced/full,
/obj/structure/window/reinforced{
	dir = 8
	},
/obj/machinery/door/blast/regular/open{
	id = "sdfc_cockpitshutters";
	name = "Blast Shield"
	},
/turf/simulated/floor/plating,
/area/shuttle/sdf_corvette)
"JX" = (
/obj/structure/handrail{
	dir = 1
	},
/obj/machinery/atmospherics/pipe/manifold/hidden,
/obj/structure/extinguisher_cabinet{
	dir = 1;
	pixel_y = -28
	},
/turf/simulated/floor/tiled/techfloor,
/area/shuttle/sdf_corvette)
"Kj" = (
/obj/machinery/atmospherics/pipe/simple/hidden/fuel,
/turf/simulated/wall/rshull,
/area/shuttle/sdf_corvette)
"KJ" = (
/obj/structure/handrail{
	dir = 1
	},
/obj/structure/cable{
	d1 = 4;
	d2 = 8;
	icon_state = "4-8"
	},
/obj/machinery/atmospherics/pipe/manifold4w/hidden,
/obj/machinery/button/remote/airlock{
	dir = 1;
	id = "sdfc_airlock_s";
	name = "Aft Airlock Control";
	pixel_y = -24;
	specialfunctions = 4
	},
/turf/simulated/floor/tiled/techfloor,
/area/shuttle/sdf_corvette)
"KM" = (
/turf/template_noop,
/area/space)
"Ly" = (
/obj/machinery/door/firedoor/glass,
/obj/structure/grille,
/obj/structure/window/reinforced/full,
/obj/structure/window/reinforced{
	dir = 4
	},
/obj/machinery/door/blast/regular/open{
	id = "sdfc_cockpitshutters";
	name = "Blast Shield"
	},
/turf/simulated/floor/plating,
/area/shuttle/sdf_corvette)
"LM" = (
/obj/structure/bed/chair/bay/shuttle{
	dir = 8
	},
/obj/machinery/atmospherics/pipe/simple/hidden/scrubbers{
	dir = 4
	},
/obj/structure/closet/walllocker_double/medical/east,
/obj/effect/floor_decal/industrial/warning/corner{
	dir = 4
	},
/obj/item/storage/firstaid{
	pixel_x = 2;
	pixel_y = 2
	},
/obj/item/storage/firstaid/o2{
	pixel_x = -2;
	pixel_y = -2
	},
/turf/simulated/floor/tiled/techfloor,
/area/shuttle/sdf_corvette)
"Ms" = (
/obj/machinery/atmospherics/pipe/simple/hidden/fuel{
	dir = 4
	},
/obj/machinery/door/firedoor/glass,
/obj/machinery/atmospherics/pipe/simple/hidden{
	dir = 6
	},
/obj/machinery/door/airlock/multi_tile/glass{
	icon_state = "door_locked";
	id_tag = "sdfc_airlock_s";
	locked = 1
	},
/turf/simulated/floor/tiled/techfloor,
/area/shuttle/sdf_corvette)
"Oc" = (
/obj/structure/cable/green{
	icon_state = "4-8"
	},
/obj/structure/cable/green{
	icon_state = "2-8"
	},
/obj/structure/closet/walllocker/emerglocker/north,
/obj/machinery/light{
	dir = 1
	},
/turf/simulated/floor/tiled/techfloor,
/area/shuttle/sdf_corvette)
"PO" = (
/obj/effect/floor_decal/industrial/warning{
	dir = 4
	},
/obj/machinery/door/firedoor/glass,
/obj/machinery/door/airlock/voidcraft/vertical{
	id_tag = "sdfc_compartment"
	},
/obj/machinery/atmospherics/pipe/simple/hidden/scrubbers{
	dir = 4
	},
/turf/simulated/floor/tiled/techfloor,
/area/shuttle/sdf_corvette)
"Qn" = (
/obj/structure/bed/chair/shuttle{
	dir = 1
	},
/obj/machinery/atmospherics/unary/vent_pump/on,
/turf/simulated/floor/tiled/techfloor,
/area/shuttle/sdf_corvette)
"QG" = (
/obj/machinery/power/pointdefense{
	id_tag = "sdfc_pd";
	name = "\improper twin-linked laser turret"
	},
/obj/structure/cable/green{
	d2 = 4;
	icon_state = "0-4"
	},
/obj/effect/floor_decal/industrial/warning{
	dir = 9
	},
/turf/simulated/floor/airless,
/area/shuttle/sdf_corvette)
"Rb" = (
/obj/machinery/computer/shuttle_control/explore/sdf_corvette,
/turf/simulated/floor/tiled/techfloor,
/area/shuttle/sdf_corvette)
"RW" = (
/obj/effect/floor_decal/industrial/warning{
	dir = 10
	},
/obj/machinery/atmospherics/unary/vent_pump/high_volume{
	dir = 1
	},
/obj/effect/map_helper/airlock/atmos/pump_out_external,
/turf/simulated/floor/tiled/techfloor{
	nitrogen = 0;
	oxygen = 0
	},
/area/shuttle/sdf_corvette)
"Tf" = (
/obj/structure/cable/green{
	d2 = 8;
	icon_state = "0-8"
	},
/obj/machinery/power/apc/alarms_hidden{
	pixel_y = -24
	},
/turf/simulated/floor/tiled/techfloor,
/area/shuttle/sdf_corvette)
"TK" = (
/obj/machinery/atmospherics/pipe/manifold/hidden{
	dir = 1
	},
/obj/effect/floor_decal/industrial/hatch/yellow,
/obj/structure/closet/walllocker/emerglocker/south,
/turf/simulated/floor/tiled/techfloor,
/area/shuttle/sdf_corvette)
"UB" = (
/turf/simulated/wall/rshull,
/area/shuttle/sdf_corvette)
"VN" = (
/obj/structure/window/reinforced{
	dir = 4
	},
/obj/effect/floor_decal/industrial/warning/full,
/obj/machinery/atmospherics/pipe/tank/air{
	dir = 4
	},
/turf/simulated/floor/tiled/techfloor,
/area/shuttle/sdf_corvette)
"Wf" = (
/obj/machinery/atmospherics/unary/engine{
	dir = 1
	},
/turf/simulated/shuttle/plating/airless/carry,
/area/shuttle/sdf_corvette)
"Wy" = (
/obj/structure/cable/green{
	d2 = 8;
	icon_state = "0-8"
	},
/obj/effect/floor_decal/industrial/warning{
	dir = 4
	},
/obj/machinery/power/pointdefense{
	id_tag = "sdfc_pd";
	name = "\improper twin-linked laser turret"
	},
/turf/simulated/floor/airless,
/area/shuttle/sdf_corvette)
"WA" = (
/obj/machinery/atmospherics/pipe/simple/hidden/fuel{
	dir = 4
	},
/obj/machinery/door/firedoor/glass,
/obj/machinery/atmospherics/pipe/manifold/hidden{
	dir = 1
	},
/turf/simulated/floor/tiled/techfloor,
/area/shuttle/sdf_corvette)
"WR" = (
/obj/effect/floor_decal/industrial/warning{
	dir = 5
	},
/obj/structure/handrail{
	dir = 4
	},
/obj/structure/fuel_port/heavy{
	dir = 8;
	pixel_x = -30
	},
/turf/simulated/floor/airless,
/area/shuttle/sdf_corvette)

(1,1,1) = {"
KM
KM
KM
KM
KM
KM
KM
KM
KM
KM
KM
KM
KM
KM
KM
KM
KM
"}
(2,1,1) = {"
KM
KM
KM
KM
KM
KM
KM
KM
QG
UB
UB
UB
UB
fX
nh
Wf
KM
"}
(3,1,1) = {"
KM
Hb
UB
IY
IY
UB
UB
UB
dv
UB
VN
UB
dQ
hn
Hu
Wf
KM
"}
(4,1,1) = {"
KM
UB
UB
ms
nr
UB
hy
rX
tg
dG
TK
lJ
jK
JX
Hu
Wf
KM
"}
(5,1,1) = {"
KM
eD
jS
Qn
zX
UB
Oc
uD
mT
pu
cS
UB
wl
lI
Ms
RW
KM
"}
(6,1,1) = {"
KM
eD
Rb
kI
bn
wQ
zb
lN
xk
en
yA
lW
sG
Cg
WA
pG
KM
"}
(7,1,1) = {"
KM
UB
UB
Cq
Tf
UB
nq
LM
pl
uw
zn
UB
EN
KJ
wn
Wf
KM
"}
(8,1,1) = {"
KM
Eg
Fb
ri
Ly
UB
PO
Fp
dv
UB
eT
Kj
bd
tt
ye
Wf
KM
"}
(9,1,1) = {"
KM
KM
KM
KM
KM
WR
Eo
yN
Wy
UB
UB
UB
UB
Ib
cJ
Wf
KM
"}
(10,1,1) = {"
KM
KM
KM
KM
KM
KM
KM
KM
KM
KM
KM
KM
KM
KM
KM
KM
KM
"}
