//MAP CONVERTED BY dmm2tgm.py THIS HEADER COMMENT PREVENTS RECONVERSION, DO NOT REMOVE
"a" = (
/turf/template_noop,
/area/template_noop)
"c" = (
/turf/simulated/mineral/floor/vacuum{
	ignore_cavegen = 1
	},
/area/submap/space_rocks/spacecrystals)
"j" = (
/obj/random/underdark/uncertain,
/turf/simulated/mineral/floor/vacuum{
	ignore_cavegen = 1
	},
/area/submap/space_rocks/spacecrystals)
"W" = (
/turf/simulated/mineral/vacuum/sdmine,
/area/submap/space_rocks/spacecrystals)
"X" = (
/obj/tether_away_spawner/asteroidbaddies,
/turf/simulated/mineral/floor/vacuum{
	ignore_cavegen = 1
	},
/area/submap/space_rocks/spacecrystals)
"Z" = (
/obj/machinery/crystal,
/turf/simulated/mineral/floor/vacuum{
	ignore_cavegen = 1
	},
/area/submap/space_rocks/spacecrystals)

(1,1,1) = {"
a
a
a
a
a
a
a
a
a
a
a
a
a
a
a
a
a
a
a
a
"}
(2,1,1) = {"
a
a
a
a
a
a
a
a
a
a
a
a
a
a
a
a
a
a
a
a
"}
(3,1,1) = {"
a
a
a
a
a
a
a
a
a
a
a
a
a
a
a
a
a
a
a
a
"}
(4,1,1) = {"
a
a
a
a
W
W
W
W
W
W
a
a
a
a
a
a
a
a
a
a
"}
(5,1,1) = {"
a
a
a
W
W
c
c
c
c
W
W
a
a
a
a
a
a
a
a
a
"}
(6,1,1) = {"
a
a
a
W
c
c
c
c
c
c
W
a
a
a
a
a
a
a
a
a
"}
(7,1,1) = {"
a
a
W
W
X
j
c
c
c
c
W
W
W
W
W
W
a
a
a
a
"}
(8,1,1) = {"
a
a
W
c
c
c
c
c
c
Z
c
c
c
c
W
W
a
a
a
a
"}
(9,1,1) = {"
a
a
W
c
c
c
c
Z
c
c
c
Z
c
c
c
W
W
a
a
a
"}
(10,1,1) = {"
a
a
W
W
c
c
c
c
c
c
c
c
c
j
c
c
W
a
a
a
"}
(11,1,1) = {"
a
a
a
W
W
W
c
c
c
Z
c
c
c
c
c
c
W
a
a
a
"}
(12,1,1) = {"
a
a
a
a
a
W
c
c
c
c
c
c
c
c
c
c
W
a
a
a
"}
(13,1,1) = {"
a
a
a
a
W
W
c
Z
c
c
c
Z
c
c
X
W
W
a
a
a
"}
(14,1,1) = {"
a
a
a
W
W
c
c
c
c
Z
c
c
W
W
W
W
a
a
a
a
"}
(15,1,1) = {"
a
a
a
W
c
c
j
X
c
c
c
W
W
a
a
a
a
a
a
a
"}
(16,1,1) = {"
a
a
a
W
c
c
c
c
c
c
W
W
a
a
a
a
a
a
a
a
"}
(17,1,1) = {"
a
a
a
W
c
c
c
c
c
W
W
a
a
a
a
a
a
a
a
a
"}
(18,1,1) = {"
a
a
a
W
W
c
W
c
W
W
a
a
a
a
a
a
a
a
a
a
"}
(19,1,1) = {"
a
a
a
a
W
W
W
W
W
a
a
a
a
a
a
a
a
a
a
a
"}
(20,1,1) = {"
a
a
a
a
a
a
a
a
a
a
a
a
a
a
a
a
a
a
a
a
"}
