//MAP CONVERTED BY dmm2tgm.py THIS HEADER COMMENT PREVENTS RECONVERSION, DO NOT REMOVE
"a" = (
/turf/space,
/area/space)
"b" = (
/obj/effect/landmark/map_data{
	height = 2
	},
/turf/space,
/area/space)
"c" = (
/turf/simulated/wall,
/area/aisat_interior)
"d" = (
/obj/structure/lattice,
/obj/machinery/atmospherics/pipe/zpipe/down{
	dir = 4;
	icon_state = "down"
	},
/obj/structure/disposalpipe/down,
/turf/simulated/open,
/area/aisat_interior)
"e" = (
/obj/machinery/atmospherics/pipe/simple/visible{
	dir = 4
	},
/obj/effect/floor_decal/corner/lime/diagonal,
/turf/simulated/floor/tiled/dark,
/area/aisat_interior)
"f" = (
/obj/machinery/atmospherics/pipe/manifold/visible{
	dir = 1
	},
/obj/effect/floor_decal/corner/lime/diagonal,
/turf/simulated/floor/tiled/dark,
/area/aisat_interior)
"g" = (
/obj/machinery/atmospherics/binary/pump/high_power{
	dir = 8
	},
/obj/effect/floor_decal/corner/lime/diagonal,
/turf/simulated/floor/tiled/dark,
/area/aisat_interior)
"h" = (
/obj/machinery/atmospherics/pipe/simple/visible{
	dir = 10;
	icon_state = "intact"
	},
/obj/effect/floor_decal/corner/lime/diagonal,
/turf/simulated/floor/tiled/dark,
/area/aisat_interior)
"i" = (
/obj/effect/floor_decal/corner/lime/diagonal,
/turf/simulated/floor/tiled/dark,
/area/aisat_interior)
"j" = (
/obj/machinery/light{
	dir = 1
	},
/turf/simulated/floor/tiled/dark,
/area/aisat_interior)
"k" = (
/obj/structure/disposalpipe/segment,
/turf/simulated/floor/plating,
/area/aisat_interior)
"l" = (
/obj/machinery/atmospherics/pipe/simple/visible,
/obj/effect/floor_decal/corner/lime/diagonal,
/obj/machinery/meter,
/turf/simulated/floor/tiled/dark,
/area/aisat_interior)
"m" = (
/obj/machinery/atmospherics/portables_connector{
	dir = 4
	},
/obj/effect/floor_decal/corner/lime/diagonal,
/turf/simulated/floor/tiled/dark,
/area/aisat_interior)
"n" = (
/obj/machinery/atmospherics/pipe/manifold/visible{
	dir = 4;
	icon_state = "map"
	},
/obj/effect/floor_decal/corner/lime/diagonal,
/obj/machinery/meter,
/turf/simulated/floor/tiled/dark,
/area/aisat_interior)
"o" = (
/turf/simulated/floor/tiled/dark,
/area/aisat_interior)
"p" = (
/turf/simulated/open,
/area/aisat_interior)
"q" = (
/obj/machinery/portable_atmospherics/canister/empty,
/obj/effect/floor_decal/corner/lime/diagonal,
/obj/structure/disposalpipe/segment,
/turf/simulated/floor/tiled/dark,
/area/aisat_interior)
"r" = (
/obj/machinery/atmospherics/pipe/simple/visible{
	dir = 5;
	icon_state = "intact"
	},
/obj/effect/floor_decal/corner/lime/diagonal,
/turf/simulated/floor/tiled/dark,
/area/aisat_interior)
"s" = (
/obj/machinery/atmospherics/binary/pump/high_power{
	dir = 4;
	icon_state = "map_off"
	},
/obj/effect/floor_decal/corner/lime/diagonal,
/turf/simulated/floor/tiled/dark,
/area/aisat_interior)
"t" = (
/obj/machinery/atmospherics/pipe/simple/visible{
	dir = 9;
	icon_state = "intact"
	},
/obj/effect/floor_decal/corner/lime/diagonal,
/turf/simulated/floor/tiled/dark,
/area/aisat_interior)
"u" = (
/obj/structure/ladder,
/turf/simulated/floor/tiled/dark,
/area/aisat_interior)
"v" = (
/obj/machinery/portable_atmospherics/canister/air,
/obj/effect/floor_decal/corner/lime/diagonal,
/obj/structure/disposalpipe/segment,
/turf/simulated/floor/tiled/dark,
/area/aisat_interior)
"w" = (
/obj/machinery/light,
/turf/simulated/floor/tiled/dark,
/area/aisat_interior)
"x" = (
/obj/machinery/alarm{
	dir = 4;
	pixel_x = -22
	},
/obj/machinery/light{
	dir = 8;
	icon_state = "tube1"
	},
/obj/machinery/disposal,
/obj/structure/disposalpipe/trunk{
	dir = 1;
	icon_state = "pipe-t"
	},
/turf/simulated/floor/tiled/dark,
/area/aisat_interior)
"y" = (
/obj/machinery/light{
	dir = 4;
	icon_state = "tube1"
	},
/turf/simulated/floor/tiled/dark,
/area/aisat_interior)
"z" = (
/obj/machinery/light_switch,
/turf/simulated/wall,
/area/aisat_interior)
"A" = (
/obj/machinery/power/debug_items/infinite_generator,
/obj/structure/cable/yellow{
	icon_state = "0-4"
	},
/obj/machinery/light{
	dir = 8;
	icon_state = "tube1"
	},
/turf/simulated/floor/tiled/dark,
/area/aisat_interior)
"B" = (
/obj/structure/cable/yellow{
	icon_state = "4-8"
	},
/turf/simulated/floor/tiled/dark,
/area/aisat_interior)
"C" = (
/obj/machinery/power/apc{
	dir = 4;
	name = "east bump";
	pixel_x = 24
	},
/obj/structure/cable/yellow{
	icon_state = "0-8"
	},
/obj/structure/cable/yellow{
	icon_state = "2-8"
	},
/obj/machinery/light{
	dir = 4;
	icon_state = "tube1"
	},
/turf/simulated/floor/tiled/dark,
/area/aisat_interior)
"D" = (
/obj/structure/cable/yellow{
	icon_state = "1-2"
	},
/obj/effect/floor_decal/corner/lime/diagonal,
/turf/simulated/floor/tiled/dark,
/area/aisat_interior)
"E" = (
/turf/simulated/floor/tiled/red,
/area/aisat_interior)
"F" = (
/obj/effect/floor_decal/sign/two,
/turf/simulated/floor/tiled/dark,
/area/aisat_interior)
"G" = (
/obj/machinery/light,
/obj/effect/floor_decal/corner/lime/diagonal,
/turf/simulated/floor/tiled/dark,
/area/aisat_interior)
"H" = (
/obj/structure/lattice,
/obj/structure/cable/yellow{
	icon_state = "32-1"
	},
/turf/simulated/open,
/area/aisat_interior)

(1,1,1) = {"
a
a
a
a
a
a
a
a
a
a
a
a
a
a
a
a
a
a
a
a
a
a
a
a
a
a
a
a
a
a
a
a
"}
(2,1,1) = {"
a
a
a
a
a
a
a
a
a
a
a
a
a
a
a
a
a
a
a
a
a
a
a
a
a
a
a
a
a
a
a
a
"}
(3,1,1) = {"
a
a
a
a
a
a
a
a
a
a
a
a
a
a
a
a
a
a
a
a
a
a
a
a
a
a
a
a
a
a
a
a
"}
(4,1,1) = {"
a
a
a
a
a
a
a
a
b
a
a
a
a
a
a
a
a
a
a
a
a
a
a
a
a
a
a
a
a
a
a
a
"}
(5,1,1) = {"
a
a
a
a
a
a
a
a
a
a
a
a
a
a
a
a
a
a
a
a
a
a
a
a
a
a
a
a
a
a
a
a
"}
(6,1,1) = {"
a
a
a
a
a
a
a
a
a
a
a
a
a
a
a
a
a
a
a
a
a
a
a
a
a
a
a
a
a
a
a
a
"}
(7,1,1) = {"
a
a
a
a
a
a
a
a
a
a
a
a
a
a
a
a
a
a
a
a
a
a
a
a
a
a
a
a
a
a
a
a
"}
(8,1,1) = {"
a
a
a
a
a
a
a
a
a
a
a
a
a
a
a
a
a
a
a
a
a
a
a
a
a
a
a
a
a
a
a
a
"}
(9,1,1) = {"
a
a
a
a
a
a
a
a
a
c
c
c
c
c
c
c
c
c
c
c
c
c
c
c
a
a
a
a
a
a
a
a
"}
(10,1,1) = {"
a
a
a
a
a
a
a
a
a
c
d
k
q
q
v
v
x
i
i
c
E
i
i
c
a
a
a
a
a
a
a
a
"}
(11,1,1) = {"
a
a
a
a
a
a
a
a
a
c
e
i
i
i
i
i
o
i
i
c
c
c
i
c
a
a
a
a
a
a
a
a
"}
(12,1,1) = {"
a
a
a
a
a
a
a
a
a
c
f
l
r
i
i
i
o
i
i
i
i
i
i
c
a
a
a
a
a
a
a
a
"}
(13,1,1) = {"
a
a
a
a
a
a
a
a
a
c
g
m
s
i
i
i
o
i
i
i
i
i
G
c
c
c
c
c
c
c
a
a
"}
(14,1,1) = {"
a
a
a
a
a
a
a
a
a
c
h
n
t
i
i
i
o
i
i
i
i
i
i
c
E
E
E
E
E
c
a
a
"}
(15,1,1) = {"
a
a
a
a
a
a
a
a
a
c
i
i
i
i
i
i
y
i
i
i
i
i
i
o
E
E
E
E
E
c
a
a
"}
(16,1,1) = {"
a
a
a
a
a
a
a
a
a
c
j
o
u
o
o
w
z
j
o
o
o
F
o
o
E
E
E
E
E
c
a
a
"}
(17,1,1) = {"
a
a
a
a
a
a
a
a
a
c
i
i
i
i
i
i
A
i
i
i
i
i
i
o
E
E
E
E
E
c
a
a
"}
(18,1,1) = {"
a
a
a
a
a
a
a
a
a
c
i
i
i
i
i
i
B
i
i
i
i
i
i
c
E
E
E
E
E
c
a
a
"}
(19,1,1) = {"
a
a
a
a
a
a
a
a
a
c
i
p
p
p
i
i
B
i
i
i
i
i
G
c
c
c
c
c
c
c
a
a
"}
(20,1,1) = {"
a
a
a
a
a
a
a
a
a
c
i
p
p
p
i
i
B
i
i
i
i
i
i
c
a
a
a
a
a
a
a
a
"}
(21,1,1) = {"
a
a
a
a
a
a
a
a
a
c
i
p
p
p
i
i
B
i
i
i
i
i
i
c
a
a
a
a
a
a
a
a
"}
(22,1,1) = {"
a
a
a
a
a
a
a
a
a
c
i
i
i
i
i
i
C
D
D
D
D
D
H
c
a
a
a
a
a
a
a
a
"}
(23,1,1) = {"
a
a
a
a
a
a
a
a
a
c
c
c
c
c
c
c
c
c
c
c
c
c
c
c
a
a
a
a
a
a
a
a
"}
(24,1,1) = {"
a
a
a
a
a
a
a
a
a
a
a
a
a
a
a
a
a
a
a
a
a
a
a
a
a
a
a
a
a
a
a
a
"}
(25,1,1) = {"
a
a
a
a
a
a
a
a
a
a
a
a
a
a
a
a
a
a
a
a
a
a
a
a
a
a
a
a
a
a
a
a
"}
(26,1,1) = {"
a
a
a
a
a
a
a
a
a
a
a
a
a
a
a
a
a
a
a
a
a
a
a
a
a
a
a
a
a
a
a
a
"}
(27,1,1) = {"
a
a
a
a
a
a
a
a
a
a
a
a
a
a
a
a
a
a
a
a
a
a
a
a
a
a
a
a
a
a
a
a
"}
(28,1,1) = {"
a
a
a
a
a
a
a
a
a
a
a
a
a
a
a
a
a
a
a
a
a
a
a
a
a
a
a
a
a
a
a
a
"}
(29,1,1) = {"
a
a
a
a
a
a
a
a
a
a
a
a
a
a
a
a
a
a
a
a
a
a
a
a
a
a
a
a
a
a
a
a
"}
(30,1,1) = {"
a
a
a
a
a
a
a
a
a
a
a
a
a
a
a
a
a
a
a
a
a
a
a
a
a
a
a
a
a
a
a
a
"}
(31,1,1) = {"
a
a
a
a
a
a
a
a
a
a
a
a
a
a
a
a
a
a
a
a
a
a
a
a
a
a
a
a
a
a
a
a
"}
(32,1,1) = {"
a
a
a
a
a
a
a
a
a
a
a
a
a
a
a
a
a
a
a
a
a
a
a
a
a
a
a
a
a
a
a
a
"}
