"a" = (/turf/template_noop,/area/template_noop)
"d" = (/obj/item/device/flashlight/flare,/turf/simulated/mineral/floor/ignore_mapgen/virgo2,/area/submap/virgo2/DeadSettlers1)
"e" = (/turf/simulated/mineral/floor/ignore_mapgen/virgo2,/area/submap/virgo2/DeadSettlers1)
"g" = (/obj/item/trash/meatration,/turf/simulated/mineral/floor/ignore_mapgen/virgo2,/area/submap/virgo2/DeadSettlers1)
"n" = (/obj/tether_away_spawner/aerostat_surface,/turf/simulated/mineral/floor/ignore_mapgen/virgo2,/area/submap/virgo2/DeadSettlers1)
"o" = (/obj/item/weapon/gun/projectile/shotgun/pump/rifle/lever/trailgun,/turf/simulated/mineral/floor/ignore_mapgen/virgo2,/area/submap/virgo2/DeadSettlers1)
"p" = (/turf/template_noop,/area/submap/virgo2/DeadSettlers1)
"q" = (/obj/item/ammo_casing,/turf/simulated/mineral/floor/ignore_mapgen/virgo2,/area/submap/virgo2/DeadSettlers1)
"t" = (/obj/random/multiple/voidsuit,/obj/effect/decal/remains,/turf/simulated/mineral/floor/ignore_mapgen/virgo2,/area/submap/virgo2/DeadSettlers1)
"B" = (/obj/item/device/radio/off,/turf/simulated/mineral/floor/ignore_mapgen/virgo2,/area/submap/virgo2/DeadSettlers1)
"K" = (/obj/effect/decal/remains,/obj/effect/decal/cleanable/blood,/turf/simulated/mineral/floor/ignore_mapgen/virgo2,/area/submap/virgo2/DeadSettlers1)
"Q" = (/obj/item/ammo_magazine/ammo_box/b44,/turf/simulated/mineral/floor/ignore_mapgen/virgo2,/area/submap/virgo2/DeadSettlers1)
"W" = (/obj/effect/decal/cleanable/blood,/turf/simulated/mineral/floor/ignore_mapgen/virgo2,/area/submap/virgo2/DeadSettlers1)

(1,1,1) = {"
aaaaaaaaaaaaaaa
apppppppppppppa
apppeeeeppppppa
appeeeeeeeppppa
apeeeneeeeepppa
apeeeeeQeegpppa
apeeeeeeqKeeppa
appeeeedeBeeppa
apppeqtWeeneppa
apppeoqeeeeeppa
appppeWeeeepppa
appppppeeeppppa
apppppppepppppa
apppppppppppppa
aaaaaaaaaaaaaaa
"}
