//MAP CONVERTED BY dmm2tgm.py THIS HEADER COMMENT PREVENTS RECONVERSION, DO NOT REMOVE
"a" = (
/turf/template_noop,
/area/template_noop)
"b" = (
/turf/template_noop,
/area/submap/virgo2/Drugd)
"c" = (
/turf/simulated/mineral/ignore_mapgen/virgo2,
/area/submap/virgo2/Drugd)
"e" = (
/obj/machinery/door/airlock,
/turf/simulated/floor,
/area/submap/virgo2/Drugd)
"f" = (
/turf/simulated/floor/tiled,
/area/submap/virgo2/Drugd)
"g" = (
/obj/effect/floor_decal/rust,
/turf/simulated/floor/tiled,
/area/submap/virgo2/Drugd)
"h" = (
/obj/random/trash,
/turf/simulated/floor,
/area/submap/virgo2/Drugd)
"i" = (
/obj/structure/closet/cabinet,
/obj/item/lipstick/random,
/turf/simulated/floor/carpet,
/area/submap/virgo2/Drugd)
"j" = (
/obj/structure/bed,
/obj/item/bedsheet,
/obj/structure/curtain/open/bed,
/turf/simulated/floor/carpet,
/area/submap/virgo2/Drugd)
"k" = (
/obj/structure/table/woodentable,
/obj/item/reagent_containers/pill/happy{
	name = "pill"
	},
/turf/simulated/floor/carpet,
/area/submap/virgo2/Drugd)
"l" = (
/obj/tether_away_spawner/aerostat_inside,
/turf/simulated/floor,
/area/submap/virgo2/Drugd)
"m" = (
/obj/structure/curtain/black,
/turf/simulated/floor,
/area/submap/virgo2/Drugd)
"n" = (
/obj/random/trash,
/turf/simulated/floor/carpet,
/area/submap/virgo2/Drugd)
"o" = (
/turf/simulated/floor/carpet,
/area/submap/virgo2/Drugd)
"p" = (
/obj/effect/decal/remains/mouse,
/turf/simulated/floor,
/area/submap/virgo2/Drugd)
"q" = (
/obj/structure/closet/cabinet,
/turf/simulated/floor/carpet,
/area/submap/virgo2/Drugd)
"r" = (
/obj/structure/table/woodentable,
/obj/item/reagent_containers/pill/methylphenidate{
	name = "pill"
	},
/turf/simulated/floor/carpet,
/area/submap/virgo2/Drugd)
"s" = (
/obj/structure/bed/chair/comfy/beige{
	icon_state = "armchair_preview";
	dir = 1
	},
/turf/simulated/floor/carpet,
/area/submap/virgo2/Drugd)
"t" = (
/obj/item/reagent_containers/pill/citalopram{
	name = "pill"
	},
/turf/simulated/floor/carpet,
/area/submap/virgo2/Drugd)
"u" = (
/obj/random/junk,
/turf/simulated/floor,
/area/submap/virgo2/Drugd)
"v" = (
/obj/structure/closet/cabinet,
/obj/item/poster,
/turf/simulated/floor/carpet,
/area/submap/virgo2/Drugd)
"w" = (
/obj/structure/bed/chair/comfy/beige,
/turf/simulated/floor/carpet,
/area/submap/virgo2/Drugd)
"x" = (
/obj/structure/table/woodentable,
/obj/item/flashlight/lamp,
/obj/item/reagent_containers/syringe/drugs,
/turf/simulated/floor/carpet,
/area/submap/virgo2/Drugd)
"y" = (
/obj/structure/bed/chair/comfy/beige,
/obj/item/reagent_containers/pill/citalopram{
	name = "pill"
	},
/turf/simulated/floor/carpet,
/area/submap/virgo2/Drugd)
"z" = (
/obj/structure/loot_pile/maint/junk,
/turf/simulated/floor,
/area/submap/virgo2/Drugd)
"A" = (
/obj/item/reagent_containers/pill/citalopram{
	name = "pill"
	},
/obj/item/reagent_containers/pill/citalopram{
	name = "pill"
	},
/turf/simulated/floor/carpet,
/area/submap/virgo2/Drugd)
"B" = (
/obj/structure/table/standard,
/obj/item/storage/pill_bottle/happy,
/turf/simulated/floor/tiled,
/area/submap/virgo2/Drugd)
"C" = (
/obj/structure/table/standard,
/obj/item/stack/medical/splint,
/turf/simulated/floor/tiled,
/area/submap/virgo2/Drugd)
"D" = (
/obj/structure/table/standard,
/obj/item/reagent_containers/pill/citalopram,
/obj/item/reagent_containers/pill/citalopram,
/turf/simulated/floor/tiled,
/area/submap/virgo2/Drugd)
"E" = (
/obj/structure/table/standard,
/obj/item/reagent_containers/pill/tramadol,
/obj/item/reagent_containers/pill/tramadol,
/turf/simulated/floor/tiled,
/area/submap/virgo2/Drugd)
"F" = (
/obj/structure/closet/cabinet,
/obj/item/clothing/accessory/jacket,
/obj/item/material/butterfly/switchblade,
/turf/simulated/floor/carpet,
/area/submap/virgo2/Drugd)
"G" = (
/obj/item/reagent_containers/pill/zoom{
	name = "pill"
	},
/obj/random/trash,
/turf/simulated/floor/carpet,
/area/submap/virgo2/Drugd)
"H" = (
/obj/item/reagent_containers/pill/zoom{
	name = "pill"
	},
/turf/simulated/floor/carpet,
/area/submap/virgo2/Drugd)
"I" = (
/obj/structure/loot_pile/maint/boxfort,
/turf/simulated/floor/carpet,
/area/submap/virgo2/Drugd)
"J" = (
/obj/structure/table/standard,
/obj/item/surgical/scalpel,
/turf/simulated/floor/tiled,
/area/submap/virgo2/Drugd)
"K" = (
/obj/item/wheelchair,
/turf/simulated/floor/tiled,
/area/submap/virgo2/Drugd)
"L" = (
/obj/structure/table/standard,
/obj/random/firstaid,
/turf/simulated/floor,
/area/submap/virgo2/Drugd)
"M" = (
/obj/structure/loot_pile/maint/junk,
/turf/simulated/floor/tiled,
/area/submap/virgo2/Drugd)
"N" = (
/obj/effect/floor_decal/rust,
/obj/structure/table/standard,
/obj/item/survivalcapsule,
/turf/simulated/floor/tiled,
/area/submap/virgo2/Drugd)
"O" = (
/obj/structure/table/standard,
/obj/item/reagent_containers/pill/zoom,
/obj/item/reagent_containers/pill/zoom,
/turf/simulated/floor,
/area/submap/virgo2/Drugd)
"P" = (
/obj/structure/table/woodentable,
/obj/item/reagent_containers/pill/tramadol{
	name = "pill"
	},
/turf/simulated/floor/carpet,
/area/submap/virgo2/Drugd)
"R" = (
/obj/structure/girder,
/turf/simulated/floor,
/area/submap/virgo2/Drugd)
"S" = (
/obj/item/material/shard,
/turf/simulated/floor,
/area/submap/virgo2/Drugd)
"T" = (
/obj/structure/table/woodentable,
/obj/item/flashlight/lamp,
/turf/simulated/floor/carpet,
/area/submap/virgo2/Drugd)
"U" = (
/obj/structure/table/woodentable,
/obj/item/reagent_containers/syringe/drugs,
/turf/simulated/floor/carpet,
/area/submap/virgo2/Drugd)
"V" = (
/turf/simulated/floor,
/area/submap/virgo2/Drugd)
"W" = (
/turf/simulated/wall/virgo2,
/area/submap/virgo2/Drugd)
"X" = (
/obj/machinery/door/airlock/external,
/turf/simulated/floor,
/area/submap/virgo2/Drugd)

(1,1,1) = {"
a
a
a
a
a
a
a
a
a
a
a
a
a
a
a
a
a
a
a
a
a
a
a
a
a
"}
(2,1,1) = {"
a
b
b
b
b
b
b
b
b
b
b
b
b
b
c
c
c
b
b
b
b
b
b
b
a
"}
(3,1,1) = {"
a
b
b
b
b
b
c
c
c
c
c
c
c
c
c
c
c
c
b
b
b
b
b
b
a
"}
(4,1,1) = {"
a
b
b
b
c
c
c
c
c
c
c
c
c
c
c
c
c
c
c
c
c
c
b
b
a
"}
(5,1,1) = {"
a
b
b
b
c
c
c
c
c
c
c
c
c
c
c
c
c
c
c
c
c
c
c
b
a
"}
(6,1,1) = {"
a
b
b
b
c
c
c
c
c
c
c
c
c
c
c
c
c
c
c
c
c
c
c
c
a
"}
(7,1,1) = {"
a
b
b
b
c
c
c
c
c
c
c
c
c
c
W
W
W
W
W
W
W
c
c
c
a
"}
(8,1,1) = {"
a
b
b
b
c
c
c
c
c
c
c
c
c
c
W
B
J
N
V
R
W
c
c
c
a
"}
(9,1,1) = {"
a
b
b
b
b
c
c
c
c
c
c
c
c
c
W
C
K
V
V
V
W
c
c
c
a
"}
(10,1,1) = {"
a
b
b
b
b
b
c
c
c
c
c
c
c
c
W
D
g
l
V
S
W
c
c
c
a
"}
(11,1,1) = {"
a
b
b
b
b
b
c
c
c
c
c
c
c
c
W
E
L
O
V
V
W
c
c
b
a
"}
(12,1,1) = {"
a
b
b
b
b
b
b
W
W
W
W
W
W
W
W
W
W
W
e
W
W
c
c
b
a
"}
(13,1,1) = {"
a
b
b
b
b
W
W
W
f
g
g
p
u
V
z
V
V
h
V
V
V
c
c
b
a
"}
(14,1,1) = {"
a
b
b
b
b
X
V
X
f
g
V
V
V
l
V
V
f
V
V
V
u
c
c
b
a
"}
(15,1,1) = {"
a
b
b
b
b
W
W
W
f
h
V
V
h
V
g
f
M
g
V
h
W
c
c
b
a
"}
(16,1,1) = {"
a
b
b
b
b
b
b
W
W
W
m
W
W
W
m
W
W
W
m
W
W
c
c
c
a
"}
(17,1,1) = {"
a
b
b
b
b
b
c
c
W
i
n
q
W
v
o
F
W
q
o
q
W
c
c
c
a
"}
(18,1,1) = {"
a
b
b
b
b
c
c
c
W
j
o
r
W
w
o
G
W
P
o
T
W
c
c
c
a
"}
(19,1,1) = {"
a
b
b
b
b
c
c
c
W
k
o
s
W
x
o
H
W
w
o
U
W
c
c
c
a
"}
(20,1,1) = {"
a
b
b
b
b
c
c
c
W
j
o
t
W
y
A
I
W
w
o
n
W
c
c
b
a
"}
(21,1,1) = {"
a
b
b
b
b
c
c
c
W
W
W
W
W
W
W
W
W
W
W
W
W
c
c
c
a
"}
(22,1,1) = {"
a
b
b
b
b
b
c
c
c
c
c
c
c
c
c
c
c
c
c
c
c
c
c
c
a
"}
(23,1,1) = {"
a
b
b
b
b
b
b
c
c
c
c
c
c
c
c
c
c
c
c
c
c
c
c
b
a
"}
(24,1,1) = {"
a
b
b
b
b
b
b
b
b
c
c
c
c
b
b
b
b
c
c
c
c
b
b
b
a
"}
(25,1,1) = {"
a
a
a
a
a
a
a
a
a
a
a
a
a
a
a
a
a
a
a
a
a
a
a
a
a
"}
