//MAP CONVERTED BY dmm2tgm.py THIS HEADER COMMENT PREVENTS RECONVERSION, DO NOT REMOVE
"a" = (
/turf/template_noop,
/area/template_noop)
"b" = (
/turf/template_noop,
/area/submap/virgo2/Lake1)
"d" = (
/obj/machinery/crystal/lava,
/turf/simulated/floor/outdoors/rocks,
/area/submap/virgo2/Lake1)
"f" = (
/turf/simulated/floor/outdoors/rocks,
/area/submap/virgo2/Lake1)
"h" = (
/turf/simulated/floor/lava,
/area/submap/virgo2/Lake1)
"i" = (
/turf/simulated/mineral/floor/ignore_mapgen/virgo2,
/area/submap/virgo2/Lake1)
"j" = (
/turf/simulated/mineral/ignore_mapgen/virgo2,
/area/submap/virgo2/Lake1)
"R" = (
/obj/machinery/crystal/lava,
/turf/simulated/mineral/floor/ignore_mapgen/virgo2,
/area/submap/virgo2/Lake1)

(1,1,1) = {"
a
a
a
a
a
a
a
a
a
a
a
a
a
a
a
a
a
a
a
a
"}
(2,1,1) = {"
a
a
a
b
b
b
b
b
b
b
b
b
b
b
b
b
a
a
a
a
"}
(3,1,1) = {"
a
a
a
a
b
b
d
f
f
f
f
f
f
f
b
b
b
a
a
a
"}
(4,1,1) = {"
a
a
a
a
b
f
f
h
h
h
h
h
h
f
f
f
b
b
a
a
"}
(5,1,1) = {"
a
a
a
b
b
f
h
h
h
h
h
h
h
h
h
f
b
b
b
a
"}
(6,1,1) = {"
a
a
a
b
b
f
h
h
h
h
h
h
h
h
h
f
b
b
b
a
"}
(7,1,1) = {"
a
a
a
b
b
f
h
h
h
h
h
h
h
h
h
d
f
b
b
a
"}
(8,1,1) = {"
a
a
b
b
f
f
h
h
h
h
h
h
h
h
h
h
f
b
b
a
"}
(9,1,1) = {"
a
b
b
b
f
h
h
h
h
h
h
h
h
h
h
h
f
b
b
a
"}
(10,1,1) = {"
a
b
b
b
f
h
h
h
h
h
h
h
h
h
h
h
f
b
b
a
"}
(11,1,1) = {"
a
b
b
b
f
h
h
h
h
h
h
h
h
h
h
h
f
b
a
a
"}
(12,1,1) = {"
a
b
b
b
f
h
h
h
h
h
h
h
h
h
h
h
f
a
a
a
"}
(13,1,1) = {"
a
b
b
b
d
h
h
h
h
h
h
h
h
h
h
h
f
a
a
a
"}
(14,1,1) = {"
a
b
b
b
f
h
h
h
h
h
h
h
h
h
h
h
f
a
a
a
"}
(15,1,1) = {"
a
b
b
f
f
h
h
h
h
h
h
h
h
h
h
h
f
b
a
a
"}
(16,1,1) = {"
a
b
b
f
h
h
h
h
h
h
h
h
h
h
h
h
f
b
b
a
"}
(17,1,1) = {"
a
b
b
f
h
h
h
h
h
h
h
h
h
h
h
f
f
b
b
a
"}
(18,1,1) = {"
a
b
b
f
h
h
h
h
h
h
h
h
h
h
h
f
b
b
b
a
"}
(19,1,1) = {"
a
b
b
f
h
h
h
h
h
h
h
h
h
h
h
f
b
b
b
a
"}
(20,1,1) = {"
a
b
b
f
f
h
h
h
h
h
h
h
h
h
h
f
b
b
b
a
"}
(21,1,1) = {"
a
b
b
b
f
f
f
h
h
h
h
h
h
f
f
f
b
b
b
a
"}
(22,1,1) = {"
a
b
b
b
b
b
f
f
f
f
f
f
f
f
i
i
b
b
a
a
"}
(23,1,1) = {"
a
b
b
b
b
b
b
b
b
i
R
i
i
i
i
R
b
b
a
a
"}
(24,1,1) = {"
a
a
b
b
b
b
b
b
b
i
i
i
i
j
i
i
b
a
a
a
"}
(25,1,1) = {"
a
a
a
b
b
b
b
b
b
i
i
j
j
j
i
b
b
a
a
a
"}
(26,1,1) = {"
a
a
a
b
b
b
b
b
b
R
j
j
j
j
i
b
b
a
a
a
"}
(27,1,1) = {"
a
a
b
b
b
a
a
b
b
b
i
j
j
i
i
b
b
a
a
a
"}
(28,1,1) = {"
a
a
b
a
a
a
a
a
b
b
b
i
i
R
b
b
b
a
a
a
"}
(29,1,1) = {"
a
a
a
a
a
a
a
a
b
b
b
b
b
b
b
b
a
a
a
a
"}
(30,1,1) = {"
a
a
a
a
a
a
a
a
a
a
a
a
a
a
a
a
a
a
a
a
"}
