//MAP CONVERTED BY dmm2tgm.py THIS HEADER COMMENT PREVENTS RECONVERSION, DO NOT REMOVE
"aa" = (
/turf/template_noop,
/area/submap/virgo2/Manor1)
"ab" = (
/turf/simulated/wall/virgo2,
/area/submap/virgo2/Manor1)
"ac" = (
/obj/structure/window/reinforced/full,
/turf/simulated/floor/holofloor/wood,
/area/submap/virgo2/Manor1)
"ad" = (
/obj/structure/bed/chair/wood{
	icon_state = "wooden_chair";
	dir = 4
	},
/turf/simulated/floor/holofloor/wood,
/area/submap/virgo2/Manor1)
"ae" = (
/obj/structure/table/woodentable,
/obj/item/reagent_containers/food/drinks/cans/waterbottle,
/turf/simulated/floor/holofloor/wood,
/area/submap/virgo2/Manor1)
"af" = (
/obj/structure/bed/chair/wood{
	icon_state = "wooden_chair";
	dir = 8
	},
/turf/simulated/floor/holofloor/wood,
/area/submap/virgo2/Manor1)
"ag" = (
/turf/simulated/floor/holofloor/wood,
/area/submap/virgo2/Manor1)
"ah" = (
/obj/structure/flora/pottedplant/dead,
/turf/simulated/floor/holofloor/wood,
/area/submap/virgo2/Manor1)
"ai" = (
/obj/structure/flora/pottedplant/drooping,
/turf/simulated/floor/holofloor/wood,
/area/submap/virgo2/Manor1)
"aj" = (
/obj/structure/table/woodentable,
/obj/item/clothing/mask/smokable/cigarette/cigar,
/obj/item/material/ashtray/glass,
/turf/simulated/floor/holofloor/wood,
/area/submap/virgo2/Manor1)
"ak" = (
/obj/structure/flora/pottedplant/dead,
/obj/effect/decal/cleanable/cobweb,
/turf/simulated/floor/holofloor/wood,
/area/submap/virgo2/Manor1)
"al" = (
/obj/structure/table/woodentable,
/turf/simulated/floor/holofloor/wood,
/area/submap/virgo2/Manor1)
"am" = (
/obj/structure/table/woodentable,
/obj/item/flashlight,
/turf/simulated/floor/holofloor/wood,
/area/submap/virgo2/Manor1)
"an" = (
/obj/effect/decal/cleanable/dirt,
/turf/simulated/floor/holofloor/wood,
/area/submap/virgo2/Manor1)
"ao" = (
/obj/structure/mopbucket,
/obj/effect/decal/cleanable/cobweb,
/turf/simulated/floor/holofloor/wood,
/area/submap/virgo2/Manor1)
"ap" = (
/obj/structure/sink,
/turf/simulated/wall/virgo2,
/area/submap/virgo2/Manor1)
"aq" = (
/turf/simulated/floor/carpet/bcarpet,
/area/submap/virgo2/Manor1)
"ar" = (
/obj/effect/decal/cleanable/dirt,
/turf/simulated/floor/carpet/bcarpet,
/area/submap/virgo2/Manor1)
"as" = (
/obj/structure/simple_door/wood,
/turf/simulated/floor/holofloor/wood,
/area/submap/virgo2/Manor1)
"at" = (
/obj/structure/table/woodentable,
/obj/item/flashlight/lamp,
/obj/effect/decal/cleanable/blood/gibs/robot,
/turf/simulated/floor/holofloor/wood,
/area/submap/virgo2/Manor1)
"au" = (
/obj/structure/bed,
/obj/item/bedsheet,
/obj/effect/decal/cleanable/blood/oil,
/turf/simulated/floor/holofloor/wood,
/area/submap/virgo2/Manor1)
"av" = (
/obj/structure/janitorialcart,
/turf/simulated/floor/holofloor/wood,
/area/submap/virgo2/Manor1)
"aw" = (
/obj/structure/table/woodentable,
/obj/item/mop,
/obj/item/reagent_containers/glass/bucket,
/turf/simulated/floor/holofloor/wood,
/area/submap/virgo2/Manor1)
"ax" = (
/obj/structure/closet/cabinet,
/turf/simulated/floor/holofloor/wood,
/area/submap/virgo2/Manor1)
"ay" = (
/obj/effect/decal/cleanable/blood/gibs/robot/limb,
/turf/simulated/floor/holofloor/wood,
/area/submap/virgo2/Manor1)
"az" = (
/obj/structure/table/woodentable,
/obj/item/trash/candle,
/turf/simulated/floor/holofloor/wood,
/area/submap/virgo2/Manor1)
"aA" = (
/obj/effect/decal/cleanable/dirt,
/obj/effect/spider/stickyweb,
/turf/simulated/floor/holofloor/wood,
/area/submap/virgo2/Manor1)
"aC" = (
/obj/structure/table/woodentable,
/obj/item/flashlight/maglight,
/turf/simulated/floor/holofloor/wood,
/area/submap/virgo2/Manor1)
"aD" = (
/obj/structure/table/woodentable,
/obj/item/flashlight/lamp,
/turf/simulated/floor/holofloor/wood,
/area/submap/virgo2/Manor1)
"aE" = (
/obj/structure/closet/cabinet,
/obj/effect/decal/cleanable/cobweb2,
/obj/item/clothing/head/hood/winter,
/obj/item/clothing/shoes/boots/winter,
/obj/item/clothing/suit/storage/hooded/wintercoat,
/turf/simulated/floor/holofloor/wood,
/area/submap/virgo2/Manor1)
"aF" = (
/obj/structure/table/woodentable,
/obj/effect/decal/cleanable/cobweb,
/turf/simulated/floor/holofloor/wood,
/area/submap/virgo2/Manor1)
"aG" = (
/obj/structure/table/woodentable,
/obj/item/paper,
/turf/simulated/floor/holofloor/wood,
/area/submap/virgo2/Manor1)
"aH" = (
/obj/structure/table/woodentable,
/obj/item/pen,
/turf/simulated/floor/holofloor/wood,
/area/submap/virgo2/Manor1)
"aI" = (
/obj/structure/flora/pottedplant/dead,
/obj/effect/spider/stickyweb,
/turf/simulated/floor/holofloor/wood,
/area/submap/virgo2/Manor1)
"aJ" = (
/obj/effect/spider/stickyweb,
/turf/simulated/floor/holofloor/wood,
/area/submap/virgo2/Manor1)
"aL" = (
/obj/structure/fireplace,
/turf/simulated/floor/holofloor/wood,
/area/submap/virgo2/Manor1)
"aN" = (
/obj/effect/decal/cleanable/cobweb2,
/turf/simulated/floor/holofloor/wood,
/area/submap/virgo2/Manor1)
"aO" = (
/obj/structure/bed,
/obj/item/bedsheet,
/turf/simulated/floor/holofloor/wood,
/area/submap/virgo2/Manor1)
"aP" = (
/obj/structure/bed/chair/wood,
/turf/simulated/floor/holofloor/wood,
/area/submap/virgo2/Manor1)
"aQ" = (
/turf/simulated/floor/carpet/purcarpet,
/area/submap/virgo2/Manor1)
"aR" = (
/obj/structure/table/standard,
/turf/simulated/floor/holofloor/wood,
/area/submap/virgo2/Manor1)
"aS" = (
/obj/structure/table/standard,
/obj/machinery/microwave,
/turf/simulated/floor/holofloor/wood,
/area/submap/virgo2/Manor1)
"aT" = (
/obj/structure/closet/cabinet,
/obj/random/projectile/shotgun,
/turf/simulated/floor/holofloor/wood,
/area/submap/virgo2/Manor1)
"aU" = (
/obj/structure/bookcase,
/turf/simulated/floor/holofloor/wood,
/area/submap/virgo2/Manor1)
"aV" = (
/obj/structure/table/woodentable,
/obj/item/material/kitchen/utensil/fork,
/turf/simulated/floor/holofloor/wood,
/area/submap/virgo2/Manor1)
"aW" = (
/obj/structure/table/standard,
/obj/item/reagent_containers/food/condiment/small/peppermill,
/turf/simulated/floor/holofloor/wood,
/area/submap/virgo2/Manor1)
"aX" = (
/obj/structure/table/standard,
/obj/item/material/knife,
/turf/simulated/floor/holofloor/wood,
/area/submap/virgo2/Manor1)
"aY" = (
/obj/machinery/appliance/cooker/oven,
/turf/simulated/floor/holofloor/wood,
/area/submap/virgo2/Manor1)
"aZ" = (
/obj/structure/table/standard,
/obj/item/reagent_containers/food/condiment/small/saltshaker,
/turf/simulated/floor/holofloor/wood,
/area/submap/virgo2/Manor1)
"ba" = (
/obj/machinery/appliance/cooker/grill,
/turf/simulated/floor/holofloor/wood,
/area/submap/virgo2/Manor1)
"bb" = (
/obj/structure/table/standard,
/obj/item/tray,
/obj/item/tray,
/turf/simulated/floor/holofloor/wood,
/area/submap/virgo2/Manor1)
"bc" = (
/obj/structure/table/standard,
/obj/item/material/knife/butch,
/turf/simulated/floor/holofloor/wood,
/area/submap/virgo2/Manor1)
"bd" = (
/obj/structure/table/standard,
/obj/item/reagent_containers/food/drinks/cans/waterbottle,
/obj/item/reagent_containers/food/drinks/cans/waterbottle,
/turf/simulated/floor/holofloor/wood,
/area/submap/virgo2/Manor1)
"be" = (
/obj/random/trash,
/turf/simulated/floor/holofloor/wood,
/area/submap/virgo2/Manor1)
"bf" = (
/obj/structure/closet/cabinet,
/obj/item/clothing/head/hood/winter,
/obj/item/clothing/shoes/boots/winter,
/obj/item/clothing/suit/storage/hooded/wintercoat,
/obj/random/contraband,
/turf/simulated/floor/holofloor/wood,
/area/submap/virgo2/Manor1)
"bg" = (
/obj/structure/table/woodentable,
/obj/item/paper_bin,
/turf/simulated/floor/holofloor/wood,
/area/submap/virgo2/Manor1)
"bh" = (
/obj/structure/bed/chair/wood{
	icon_state = "wooden_chair";
	dir = 1
	},
/turf/simulated/floor/holofloor/wood,
/area/submap/virgo2/Manor1)
"bi" = (
/obj/effect/decal/cleanable/cobweb,
/turf/simulated/floor/holofloor/wood{
	icon_state = "wood_broken0"
	},
/area/submap/virgo2/Manor1)
"bj" = (
/obj/effect/decal/cleanable/cobweb,
/obj/structure/salvageable/personal,
/turf/simulated/floor/holofloor/wood,
/area/submap/virgo2/Manor1)
"bk" = (
/obj/random/plushielarge,
/turf/simulated/floor/holofloor/wood,
/area/submap/virgo2/Manor1)
"bl" = (
/turf/simulated/floor/carpet/blucarpet,
/area/submap/virgo2/Manor1)
"bm" = (
/obj/structure/loot_pile/surface/bones,
/obj/item/clothing/accessory/sweater/blue,
/turf/simulated/floor/carpet/blucarpet,
/area/submap/virgo2/Manor1)
"bn" = (
/obj/structure/window/reinforced/full,
/turf/template_noop,
/area/submap/virgo2/Manor1)
"bo" = (
/obj/item/material/twohanded/baseballbat/metal,
/turf/simulated/floor/carpet/blucarpet,
/area/submap/virgo2/Manor1)
"bp" = (
/obj/effect/decal/cleanable/blood,
/turf/simulated/floor/carpet/blucarpet,
/area/submap/virgo2/Manor1)
"bq" = (
/obj/effect/decal/cleanable/blood/drip,
/turf/simulated/floor/holofloor/wood,
/area/submap/virgo2/Manor1)
"br" = (
/obj/structure/bed/chair/comfy/purp{
	icon_state = "comfychair_preview";
	dir = 4
	},
/turf/simulated/floor/holofloor/wood{
	icon_state = "wood_broken5"
	},
/area/submap/virgo2/Manor1)
"bs" = (
/obj/structure/table,
/turf/simulated/floor/holofloor/wood,
/area/submap/virgo2/Manor1)
"bt" = (
/obj/structure/bed/chair/wood{
	icon_state = "wooden_chair";
	dir = 4
	},
/obj/effect/decal/cleanable/dirt,
/turf/simulated/floor/holofloor/wood,
/area/submap/virgo2/Manor1)
"bu" = (
/obj/structure/bed/chair/wood{
	icon_state = "wooden_chair";
	dir = 8
	},
/obj/effect/decal/cleanable/dirt,
/turf/simulated/floor/holofloor/wood,
/area/submap/virgo2/Manor1)
"bv" = (
/obj/structure/table/standard,
/obj/item/reagent_containers/food/condiment/small/sugar,
/turf/simulated/floor/holofloor/wood,
/area/submap/virgo2/Manor1)
"bw" = (
/obj/effect/decal/cleanable/blood/drip,
/turf/simulated/floor/carpet/blucarpet,
/area/submap/virgo2/Manor1)
"bx" = (
/obj/structure/bed/chair/comfy/purp{
	icon_state = "comfychair_preview";
	dir = 4
	},
/turf/simulated/floor/holofloor/wood,
/area/submap/virgo2/Manor1)
"by" = (
/obj/structure/closet/cabinet,
/obj/item/clothing/suit/storage/hooded/wintercoat,
/obj/item/clothing/head/hood/winter,
/obj/item/clothing/shoes/boots/winter,
/turf/simulated/floor/holofloor/wood,
/area/submap/virgo2/Manor1)
"bz" = (
/obj/structure/table/woodentable,
/obj/effect/decal/cleanable/dirt,
/turf/simulated/floor/holofloor/wood,
/area/submap/virgo2/Manor1)
"bA" = (
/obj/structure/table/standard,
/obj/item/material/kitchen/utensil/fork,
/obj/item/material/kitchen/utensil/fork,
/turf/simulated/floor/holofloor/wood,
/area/submap/virgo2/Manor1)
"bB" = (
/obj/structure/closet/secure_closet/freezer/fridge,
/obj/item/reagent_containers/food/snacks/stew,
/obj/item/reagent_containers/food/snacks/stew,
/turf/simulated/floor/holofloor/wood,
/area/submap/virgo2/Manor1)
"bC" = (
/obj/item/shovel,
/turf/simulated/floor/holofloor/wood,
/area/submap/virgo2/Manor1)
"bD" = (
/obj/structure/bed/chair/wood{
	icon_state = "wooden_chair";
	dir = 1
	},
/obj/effect/decal/cleanable/dirt,
/turf/simulated/floor/holofloor/wood,
/area/submap/virgo2/Manor1)
"bE" = (
/obj/structure/table/standard,
/obj/item/material/kitchen/utensil/spoon,
/obj/item/material/kitchen/utensil/spoon,
/obj/item/material/kitchen/utensil/spoon,
/obj/effect/spider/stickyweb,
/turf/simulated/floor/holofloor/wood,
/area/submap/virgo2/Manor1)
"bF" = (
/obj/structure/table/standard,
/obj/effect/spider/stickyweb,
/turf/simulated/floor/holofloor/wood,
/area/submap/virgo2/Manor1)
"bG" = (
/obj/structure/closet/secure_closet/freezer/fridge,
/obj/item/reagent_containers/food/snacks/sausage,
/obj/item/reagent_containers/food/snacks/sausage,
/turf/simulated/floor/holofloor/wood,
/area/submap/virgo2/Manor1)
"bH" = (
/obj/effect/decal/cleanable/dirt,
/obj/structure/flora/pottedplant/drooping,
/turf/simulated/floor/holofloor/wood,
/area/submap/virgo2/Manor1)
"bI" = (
/obj/effect/decal/cleanable/dirt,
/obj/structure/flora/pottedplant/dead,
/turf/simulated/floor/holofloor/wood,
/area/submap/virgo2/Manor1)
"bJ" = (
/obj/structure/table/standard,
/obj/item/material/kitchen/rollingpin,
/obj/effect/spider/stickyweb,
/turf/simulated/floor/holofloor/wood,
/area/submap/virgo2/Manor1)
"bK" = (
/obj/structure/table/standard,
/obj/item/reagent_containers/glass/bottle/stoxin,
/turf/simulated/floor/holofloor/wood,
/area/submap/virgo2/Manor1)
"bL" = (
/obj/structure/table/woodentable,
/obj/item/storage/fancy/candle_box,
/turf/simulated/floor/holofloor/wood,
/area/submap/virgo2/Manor1)
"bM" = (
/obj/machinery/papershredder,
/turf/simulated/floor/holofloor/wood,
/area/submap/virgo2/Manor1)
"bN" = (
/obj/structure/simple_door/wood,
/turf/simulated/floor/carpet/purcarpet,
/area/submap/virgo2/Manor1)
"bO" = (
/obj/machinery/icecream_vat,
/turf/simulated/floor/holofloor/wood,
/area/submap/virgo2/Manor1)
"bP" = (
/obj/effect/decal/cleanable/dirt,
/turf/simulated/floor/carpet/blucarpet,
/area/submap/virgo2/Manor1)
"bQ" = (
/obj/effect/decal/cleanable/blood,
/turf/simulated/floor/holofloor/wood,
/area/submap/virgo2/Manor1)
"bR" = (
/obj/effect/decal/cleanable/cobweb,
/obj/structure/table/woodentable,
/turf/simulated/floor/holofloor/wood,
/area/submap/virgo2/Manor1)
"bS" = (
/obj/structure/flora/pottedplant/subterranean,
/turf/simulated/floor/holofloor/wood,
/area/submap/virgo2/Manor1)
"bT" = (
/obj/item/material/minihoe,
/turf/simulated/floor/carpet/blucarpet,
/area/submap/virgo2/Manor1)
"bU" = (
/obj/effect/decal/cleanable/dirt,
/turf/simulated/floor/carpet/purcarpet,
/area/submap/virgo2/Manor1)
"bV" = (
/turf/simulated/floor/holofloor/wood{
	icon_state = "wood_broken6"
	},
/area/submap/virgo2/Manor1)
"bW" = (
/obj/machinery/washing_machine,
/turf/simulated/floor/holofloor/wood,
/area/submap/virgo2/Manor1)
"bX" = (
/obj/structure/table/woodentable,
/obj/structure/bedsheetbin,
/obj/effect/decal/cleanable/cobweb2,
/turf/simulated/floor/holofloor/wood,
/area/submap/virgo2/Manor1)
"bY" = (
/obj/structure/table/rack,
/turf/simulated/floor/holofloor/wood,
/area/submap/virgo2/Manor1)
"bZ" = (
/obj/structure/closet/crate,
/obj/item/stack/cable_coil/random_belt,
/obj/random/cash,
/turf/simulated/floor/holofloor/wood,
/area/submap/virgo2/Manor1)
"ca" = (
/obj/structure/table/woodentable,
/obj/item/melee/umbrella/random,
/turf/simulated/floor/holofloor/wood,
/area/submap/virgo2/Manor1)
"cb" = (
/obj/structure/closet/cabinet,
/obj/random/gun/random,
/turf/simulated/floor/holofloor/wood,
/area/submap/virgo2/Manor1)
"cc" = (
/obj/structure/closet/cabinet,
/obj/item/cell/device/weapon,
/obj/item/cell/device/weapon,
/obj/random/medical,
/turf/simulated/floor/holofloor/wood,
/area/submap/virgo2/Manor1)
"cd" = (
/obj/structure/table/woodentable,
/obj/item/flashlight/lamp/green,
/turf/simulated/floor/holofloor/wood,
/area/submap/virgo2/Manor1)
"ce" = (
/obj/structure/bed/double,
/obj/item/bedsheet/rddouble,
/obj/structure/curtain/open/bed,
/turf/simulated/floor/holofloor/wood,
/area/submap/virgo2/Manor1)
"cf" = (
/obj/structure/table/woodentable,
/obj/item/storage/wallet/random,
/turf/simulated/floor/holofloor/wood,
/area/submap/virgo2/Manor1)
"cg" = (
/obj/structure/flora/pottedplant/dead,
/obj/effect/decal/cleanable/cobweb2,
/turf/simulated/floor/holofloor/wood,
/area/submap/virgo2/Manor1)
"ch" = (
/obj/structure/loot_pile/surface/bones,
/obj/item/clothing/accessory/sweater,
/turf/simulated/floor/carpet/blucarpet,
/area/submap/virgo2/Manor1)
"ci" = (
/obj/structure/closet/crate,
/obj/item/flame/lighter/random,
/obj/random/powercell,
/turf/simulated/floor/holofloor/wood,
/area/submap/virgo2/Manor1)
"cj" = (
/obj/structure/closet/cabinet,
/obj/item/clothing/shoes/boots/winter,
/obj/item/clothing/suit/storage/hooded/wintercoat,
/obj/item/clothing/head/hood/winter,
/turf/simulated/floor/holofloor/wood,
/area/submap/virgo2/Manor1)
"ck" = (
/obj/effect/decal/cleanable/spiderling_remains,
/turf/simulated/floor/holofloor/wood,
/area/submap/virgo2/Manor1)
"cl" = (
/turf/simulated/floor/carpet/turcarpet,
/area/submap/virgo2/Manor1)
"cm" = (
/obj/effect/decal/cleanable/blood,
/obj/structure/bed/chair/comfy/purp{
	icon_state = "comfychair_preview";
	dir = 4
	},
/turf/simulated/floor/holofloor/wood,
/area/submap/virgo2/Manor1)
"cn" = (
/obj/structure/closet/crate,
/obj/item/storage/wallet/random,
/turf/simulated/floor/holofloor/wood,
/area/submap/virgo2/Manor1)
"co" = (
/obj/structure/coatrack,
/turf/simulated/floor/holofloor/wood,
/area/submap/virgo2/Manor1)
"cp" = (
/obj/structure/loot_pile/surface/bones,
/obj/item/clothing/suit/storage/hooded/wintercoat,
/turf/simulated/floor/holofloor/wood,
/area/submap/virgo2/Manor1)
"cq" = (
/obj/structure/loot_pile/surface/bones,
/obj/item/clothing/under/suit_jacket,
/obj/item/clothing/shoes/black,
/obj/random/projectile/random,
/turf/simulated/floor/holofloor/wood,
/area/submap/virgo2/Manor1)
"cr" = (
/obj/effect/decal/cleanable/dirt,
/obj/machinery/door/airlock/external,
/turf/simulated/floor/carpet/purcarpet,
/area/submap/virgo2/Manor1)
"cs" = (
/obj/item/material/twohanded/spear,
/turf/simulated/floor/holofloor/wood,
/area/submap/virgo2/Manor1)
"ct" = (
/obj/structure/closet/cabinet{
	opened = 1
	},
/turf/simulated/floor/holofloor/wood,
/area/submap/virgo2/Manor1)
"cu" = (
/obj/effect/decal/remains,
/obj/item/material/knife/tacknife/combatknife,
/turf/simulated/floor/holofloor/wood,
/area/submap/virgo2/Manor1)
"cv" = (
/obj/structure/sink{
	pixel_y = 30
	},
/turf/simulated/floor/tiled/hydro,
/area/submap/virgo2/Manor1)
"cw" = (
/turf/simulated/floor/tiled/hydro,
/area/submap/virgo2/Manor1)
"cx" = (
/obj/structure/table/standard,
/obj/effect/decal/cleanable/cobweb2,
/turf/simulated/floor/tiled/hydro,
/area/submap/virgo2/Manor1)
"cy" = (
/obj/structure/table/standard,
/obj/item/towel/random,
/obj/item/towel/random,
/turf/simulated/floor/tiled/hydro,
/area/submap/virgo2/Manor1)
"cz" = (
/obj/effect/decal/cleanable/cobweb2,
/obj/effect/spider/stickyweb,
/turf/simulated/floor/holofloor/wood,
/area/submap/virgo2/Manor1)
"cA" = (
/obj/item/paper/crumpled,
/turf/simulated/floor/holofloor/wood,
/area/submap/virgo2/Manor1)
"cB" = (
/turf/simulated/floor/holofloor/wood{
	icon_state = "wood_broken3"
	},
/area/submap/virgo2/Manor1)
"cC" = (
/obj/effect/decal/cleanable/spiderling_remains,
/obj/effect/spider/stickyweb,
/turf/simulated/floor/holofloor/wood,
/area/submap/virgo2/Manor1)
"cD" = (
/obj/structure/closet/crate,
/obj/item/clothing/suit/armor/vest,
/turf/simulated/floor/holofloor/wood,
/area/submap/virgo2/Manor1)
"cE" = (
/obj/structure/closet/crate,
/turf/simulated/floor/holofloor/wood,
/area/submap/virgo2/Manor1)
"cF" = (
/obj/structure/simple_door/wood,
/turf/simulated/floor/tiled/hydro,
/area/submap/virgo2/Manor1)
"cG" = (
/obj/structure/toilet{
	icon_state = "toilet00";
	dir = 8
	},
/turf/simulated/floor/tiled/hydro,
/area/submap/virgo2/Manor1)
"cH" = (
/obj/machinery/shower{
	icon_state = "shower";
	dir = 8
	},
/obj/structure/curtain/open/shower,
/turf/simulated/floor/tiled/hydro,
/area/submap/virgo2/Manor1)
"cI" = (
/obj/item/stack/material/wood,
/turf/simulated/floor/holofloor/wood,
/area/submap/virgo2/Manor1)
"cJ" = (
/obj/machinery/shower{
	icon_state = "shower";
	dir = 8
	},
/obj/structure/curtain/open/shower,
/obj/random/soap,
/turf/simulated/floor/tiled/hydro,
/area/submap/virgo2/Manor1)
"cK" = (
/obj/structure/table/standard,
/turf/simulated/floor/tiled/hydro,
/area/submap/virgo2/Manor1)
"cL" = (
/obj/structure/toilet{
	icon_state = "toilet00";
	dir = 1
	},
/turf/simulated/floor/tiled/hydro,
/area/submap/virgo2/Manor1)
"cM" = (
/obj/structure/table/woodentable,
/obj/item/modular_computer/laptop/preset/custom_loadout/standard,
/turf/simulated/floor/holofloor/wood,
/area/submap/virgo2/Manor1)
"cN" = (
/turf/template_noop,
/area/template_noop)
"cO" = (
/obj/machinery/door/airlock/external,
/turf/simulated/floor/carpet/purcarpet,
/area/submap/virgo2/Manor1)
"kI" = (
/obj/tether_away_spawner/aerostat_surface,
/turf/simulated/floor/holofloor/wood,
/area/submap/virgo2/Manor1)
"KY" = (
/obj/tether_away_spawner/aerostat_surface,
/turf/simulated/floor/carpet/turcarpet,
/area/submap/virgo2/Manor1)
"VR" = (
/obj/tether_away_spawner/aerostat_surface,
/turf/simulated/floor/carpet/purcarpet,
/area/submap/virgo2/Manor1)
"Yk" = (
/obj/structure/salvageable/personal,
/turf/simulated/floor/holofloor/wood,
/area/submap/virgo2/Manor1)

(1,1,1) = {"
cN
cN
cN
cN
cN
cN
cN
cN
cN
cN
cN
cN
cN
cN
cN
cN
cN
cN
cN
cN
cN
cN
cN
cN
cN
cN
cN
cN
cN
cN
cN
cN
cN
cN
cN
cN
cN
cN
cN
cN
"}
(2,1,1) = {"
cN
aa
aa
aa
aa
aa
aa
aa
aa
aa
aa
aa
aa
aa
aa
aa
aa
aa
aa
aa
aa
aa
aa
aa
aa
aa
aa
aa
aa
aa
aa
aa
aa
aa
aa
aa
aa
aa
aa
cN
"}
(3,1,1) = {"
cN
aa
aa
aa
aa
aa
aa
aa
aa
aa
aa
aa
aa
aa
aa
aa
aa
aa
aa
aa
aa
aa
aa
aa
aa
aa
aa
aa
aa
aa
aa
aa
aa
aa
aa
aa
aa
aa
aa
cN
"}
(4,1,1) = {"
cN
aa
aa
aa
aa
aa
aa
aa
aa
aa
aa
aa
aa
aa
aa
aa
aa
aa
aa
aa
aa
aa
aa
aa
aa
aa
aa
aa
aa
aa
aa
aa
aa
aa
aa
aa
aa
aa
aa
cN
"}
(5,1,1) = {"
cN
aa
aa
aa
aa
aa
aa
aa
aa
aa
aa
aa
aa
aa
aa
aa
aa
ab
bn
bn
ab
aa
aa
aa
aa
aa
aa
ab
ac
ac
ab
aa
aa
aa
aa
aa
aa
aa
aa
cN
"}
(6,1,1) = {"
cN
aa
aa
aa
aa
aa
aa
aa
aa
aa
aa
aa
aa
aa
aa
aa
ab
ab
ag
ag
ab
ab
aa
aa
aa
aa
ab
ab
ag
ag
ab
ab
aa
aa
aa
aa
aa
aa
aa
cN
"}
(7,1,1) = {"
cN
aa
aa
aa
aa
aa
ab
ab
ab
ab
ab
ab
ab
ab
ab
ab
ab
bj
ag
ag
ag
ab
ab
ab
ab
ab
ab
ag
ag
ag
ag
ab
ab
ab
aa
aa
aa
aa
aa
cN
"}
(8,1,1) = {"
cN
aa
aa
aa
aa
ab
ab
ax
ab
ag
as
ag
ag
aD
ab
aD
ag
ag
ag
ag
ag
ag
ag
ag
az
ab
bR
ag
ag
ag
bQ
cq
ct
ab
ab
aa
aa
aa
aa
cN
"}
(9,1,1) = {"
cN
aa
aa
aa
ab
ab
at
ag
as
ag
ab
ag
ag
al
ab
al
bh
ag
ag
ag
ag
ag
ag
ag
al
ab
az
ag
ag
bq
bQ
ag
ag
al
ab
ab
aa
aa
aa
cN
"}
(10,1,1) = {"
cN
aa
aa
ab
ab
al
au
ay
ab
ag
ab
aT
ag
aO
ab
bg
ag
bk
aO
al
by
ag
ag
ag
ag
ab
bS
ag
bq
ag
ag
ag
cu
ag
al
ab
ab
aa
aa
cN
"}
(11,1,1) = {"
cN
aa
aa
ab
ab
ab
ab
ab
ab
as
ab
ab
ab
ab
ab
ab
ab
ab
ab
ab
ab
ab
ab
as
ab
ab
ab
ab
as
ab
ab
ab
ab
ab
ab
ab
ab
ab
aa
cN
"}
(12,1,1) = {"
cN
aa
aa
ab
ak
ag
ag
ag
ag
ag
ag
ag
ag
ag
ag
al
az
al
ag
ag
an
an
ag
ag
ag
bQ
bq
ag
bq
ag
ah
ab
cv
cw
cw
cw
cw
ab
aa
cN
"}
(13,1,1) = {"
cN
aa
aa
ab
ag
aq
aq
aq
aq
aq
aq
aq
aq
aq
aq
aq
aq
aq
aq
ar
ar
ar
ar
aq
aq
aq
aq
aq
aq
aq
aq
as
cw
ab
cF
ab
cF
ab
aa
cN
"}
(14,1,1) = {"
cN
aa
aa
ab
ag
aq
aq
ag
ag
ag
ag
ag
ag
ag
ag
ag
ag
ag
an
an
an
ag
ag
ag
ag
ag
kI
ag
ag
ag
ag
ab
cx
ab
cG
ab
cG
ab
aa
cN
"}
(15,1,1) = {"
cN
aa
aa
ab
ag
aq
aq
ag
ab
ab
ab
ab
ab
ab
ab
ab
as
ab
ab
ab
ab
ab
ab
ab
ab
ag
ag
ab
ab
ab
ab
ab
ab
ab
ab
ab
ab
ab
aa
cN
"}
(16,1,1) = {"
cN
aa
aa
ab
al
aq
aq
az
ab
aF
ag
ag
ag
ag
ag
ag
ag
ag
an
ag
ag
ag
ag
aG
ab
an
ag
ab
bW
ag
bW
ab
cy
cw
cw
cw
cw
ab
aa
cN
"}
(17,1,1) = {"
cN
aa
aa
ab
am
ar
aq
al
ab
aG
ag
aU
aU
aU
ag
aU
aU
aU
an
aU
aU
aU
ag
bL
ab
an
ag
ab
bX
ag
az
ab
cw
cw
cH
cH
cJ
ab
aa
cN
"}
(18,1,1) = {"
cN
aa
aa
ab
al
ar
aq
al
ab
ag
ag
ag
ag
ag
kI
ag
ag
an
an
an
an
an
an
bM
ab
an
an
ab
ab
as
ab
ab
as
ab
ab
ab
ab
ab
aa
cN
"}
(19,1,1) = {"
cN
aa
aa
ab
ag
ar
aq
ag
ab
al
ag
aU
aU
aU
ag
aU
aU
aU
an
aU
aU
aU
ag
ag
as
an
an
as
ag
ag
ag
ag
ag
ag
as
cw
cK
ab
aa
cN
"}
(20,1,1) = {"
cN
aa
aa
ab
an
ar
ar
an
ab
aH
ag
ag
ag
ag
an
an
an
an
an
ag
ag
ag
ag
ai
ab
an
an
ab
ab
ab
as
ab
ab
ab
ab
cv
cL
ab
aa
cN
"}
(21,1,1) = {"
cN
aa
ab
ab
an
ar
ar
an
ab
ab
ab
ab
ab
ab
ab
ab
ab
ab
ab
ab
ab
ab
ab
ab
ab
an
an
ab
bY
ag
ag
ag
bY
bY
ab
ab
ab
ab
aa
cN
"}
(22,1,1) = {"
cN
ab
ab
ag
ag
ar
ar
an
ab
aI
aJ
ag
ag
ag
ag
ag
ag
ag
an
an
an
an
bH
ab
ab
an
an
ab
ag
ag
kI
ag
ag
cC
ab
ab
aa
aa
aa
cN
"}
(23,1,1) = {"
cN
ac
ad
ag
ag
ar
ar
aA
ab
aJ
aJ
ad
ad
ad
ad
ad
ad
ad
ad
bt
bt
an
an
ab
ab
an
an
ab
bZ
ci
cn
ag
aJ
aJ
ab
aa
aa
aa
aa
cN
"}
(24,1,1) = {"
cN
ac
ae
ag
ag
aq
ar
aA
ab
aJ
aP
al
al
al
al
al
aG
al
al
al
al
bh
an
ab
ab
as
as
ab
ab
ab
ab
aJ
aJ
cD
ab
aa
aa
aa
aa
cN
"}
(25,1,1) = {"
cN
ac
af
ag
ag
ar
ar
aA
ab
ag
aP
aV
al
al
al
al
al
al
al
al
al
bh
ag
ab
al
ag
ag
al
al
cj
ab
ab
cz
cE
ab
aa
aa
aa
aa
cN
"}
(26,1,1) = {"
cN
ac
ag
ag
an
ar
ar
ag
ab
ag
ag
af
af
af
af
af
af
af
af
af
af
ag
ag
ab
al
ag
ag
ag
ag
ck
co
ab
ab
ab
ab
aa
aa
aa
aa
cN
"}
(27,1,1) = {"
cN
ab
ah
ag
an
ar
ar
an
ab
aL
aQ
aQ
aQ
aQ
aQ
aQ
aQ
aQ
aQ
aQ
aQ
aQ
aQ
bN
aQ
aQ
VR
bU
bU
bU
bU
cr
bU
bU
cO
aa
aa
aa
aa
cN
"}
(28,1,1) = {"
cN
ab
ai
ag
an
ar
ar
an
ab
aL
aQ
aQ
aQ
aQ
aQ
aQ
VR
aQ
aQ
aQ
aQ
aQ
aQ
bN
aQ
aQ
aQ
aQ
bU
bU
bU
cr
bU
bU
cO
aa
aa
aa
aa
cN
"}
(29,1,1) = {"
cN
ac
ag
ag
an
ar
ar
ag
ab
ag
ag
ad
ad
ad
ad
ad
ad
ad
ad
ad
ad
ag
ag
ab
al
ag
ag
ag
ag
ag
co
ab
ab
ab
ab
aa
aa
aa
aa
cN
"}
(30,1,1) = {"
cN
ac
ad
ag
ag
ar
ar
ag
ab
ag
aP
aV
al
al
al
al
al
al
al
al
al
bh
an
ab
al
ag
ag
al
ca
cj
ab
ab
az
al
ab
aa
aa
aa
aa
cN
"}
(31,1,1) = {"
cN
ac
aj
ag
ag
ar
ar
ag
ab
ag
aP
al
al
al
al
al
al
al
al
al
bz
bD
an
ab
ab
as
as
ab
ab
ab
ab
ag
af
ag
ab
aa
aa
aa
aa
cN
"}
(32,1,1) = {"
cN
ac
af
ag
ag
aq
ar
ag
ab
ag
ag
af
af
af
af
af
af
af
af
bu
bu
an
an
ab
ab
ag
ag
ab
cb
ag
ag
ag
ag
ag
ab
aa
aa
aa
aa
cN
"}
(33,1,1) = {"
cN
ab
ab
ag
ag
aq
aq
ag
ab
ah
ag
ag
ag
ag
ag
ag
ag
ag
ag
an
an
an
bI
ab
ab
ag
ag
ab
cc
cl
cl
cl
cl
ag
ab
ab
aa
aa
aa
cN
"}
(34,1,1) = {"
cN
aa
ab
ab
ag
aq
aq
ag
ab
ab
ab
ab
ab
ab
ab
ab
ab
ab
as
ab
ab
ab
ab
ab
ab
ag
ag
ab
ag
cl
cl
cl
cl
ag
ah
ab
ab
ab
aa
cN
"}
(35,1,1) = {"
cN
aa
aa
ab
ag
aq
aq
ag
ab
ag
aR
aR
aR
bb
ag
ag
ag
ag
ag
ag
ag
ag
ag
bO
ab
ag
ag
ab
cd
cl
cl
cl
cl
ag
ag
al
cM
ab
aa
cN
"}
(36,1,1) = {"
cN
aa
aa
ab
ag
aq
aq
ag
ab
ag
ag
ag
ag
ag
ag
ag
ag
ag
ag
ag
ag
ag
ag
aJ
ab
ag
ag
ab
ce
cl
cl
cl
cl
cl
cl
cl
al
ab
aa
cN
"}
(37,1,1) = {"
cN
aa
aa
ab
ag
aq
aq
ag
ab
ag
aR
aW
aZ
aR
ag
ag
ag
ag
ag
aR
bA
bE
bF
aJ
ab
ag
ag
ab
cf
cl
cl
cl
cl
cl
cl
cl
al
ab
aa
cN
"}
(38,1,1) = {"
cN
aa
aa
ab
al
aq
aq
al
ab
ag
aR
aX
aR
bc
ag
ag
kI
ag
ag
bv
aR
bF
bJ
aJ
ab
ag
ag
ab
ag
cl
cl
KY
cl
cl
cl
cl
ag
ab
aa
cN
"}
(39,1,1) = {"
cN
aa
aa
ab
al
aq
aq
al
ab
ag
ag
ag
ag
ag
ag
ag
ag
ag
ag
ag
ag
ag
ag
ag
ab
ag
ag
ab
ag
cl
cl
cl
cl
cl
cl
cl
ag
ab
aa
cN
"}
(40,1,1) = {"
cN
aa
aa
ab
al
aq
aq
aC
ab
aN
aS
aY
ba
bd
ag
ag
ag
ag
ag
ag
bB
bG
bK
ag
ab
ag
ag
ab
cg
aD
al
al
ag
cl
cl
cl
ag
ab
aa
cN
"}
(41,1,1) = {"
cN
aa
aa
ab
ag
aq
aq
ag
ab
ab
ab
ab
ab
ab
ab
ab
ab
ab
as
ab
ab
ab
ab
ab
ab
ag
ag
ab
ab
ab
ab
ab
ag
cl
cl
cl
ag
ab
aa
cN
"}
(42,1,1) = {"
cN
aa
aa
ab
ag
aq
aq
ag
ag
ag
ag
al
ag
ag
ag
ag
ag
ag
ag
ag
ag
ag
ag
ag
ag
ag
ag
ag
ag
ag
ah
ab
ag
cl
cl
cl
ag
ab
aa
cN
"}
(43,1,1) = {"
cN
aa
aa
ab
ag
aq
aq
aq
aq
aq
aq
aq
aq
aq
aq
aq
aq
aq
aq
aq
aq
aq
aq
aq
aq
aq
aq
aq
aq
aq
aq
as
ag
cl
cl
cl
ag
ab
aa
cN
"}
(44,1,1) = {"
cN
aa
aa
ab
ai
ag
ag
ag
ag
ag
ag
ag
ag
ag
ag
ag
ag
ag
ag
ag
ag
ag
ag
ag
ag
ag
ag
ag
ag
ag
ah
ab
ah
ag
ag
ag
ah
ab
aa
cN
"}
(45,1,1) = {"
cN
aa
aa
ab
ab
as
ab
ab
ab
ab
ab
as
ab
ab
ab
ab
ab
ab
as
ab
ab
ab
ab
ab
ab
ab
ab
ab
as
ab
ab
ab
ab
ab
ab
ab
ab
ab
aa
cN
"}
(46,1,1) = {"
cN
aa
aa
ab
ao
ag
av
ab
aD
aO
ab
ag
ab
aO
aD
ab
bi
ag
ag
ag
ag
al
aD
al
al
az
al
ag
ag
bq
ag
cs
ag
cA
ag
cI
ab
ab
aa
cN
"}
(47,1,1) = {"
cN
aa
aa
ab
ap
ag
ag
ab
kI
ag
ab
ag
ab
ag
be
ab
ag
bl
bo
bl
bl
bl
bl
bl
bw
bl
bl
bl
bp
bw
bw
bl
cA
bq
cI
ab
ab
aa
aa
cN
"}
(48,1,1) = {"
cN
aa
aa
aa
ab
ab
aw
ab
ag
ag
as
ag
as
ag
kI
ab
ag
bm
bp
bw
bl
bl
bl
bl
bP
bP
bT
bl
ch
bl
bl
bw
cB
ag
ab
ab
aa
aa
aa
cN
"}
(49,1,1) = {"
cN
aa
aa
aa
aa
ab
ab
ab
aE
al
ab
ag
ab
al
bf
ab
ag
ag
bq
ag
ag
ag
al
al
al
al
ag
bV
ag
ag
ag
ag
ag
ab
ab
aa
aa
aa
aa
cN
"}
(50,1,1) = {"
cN
aa
aa
aa
aa
aa
ab
ab
ab
ab
ab
ab
ab
ab
ab
ab
ab
Yk
br
bx
bC
ab
ab
ab
ab
ab
ab
Yk
bx
cm
cp
ab
ab
ab
aa
aa
aa
aa
aa
cN
"}
(51,1,1) = {"
cN
aa
aa
aa
aa
aa
aa
aa
aa
aa
aa
aa
aa
aa
aa
aa
ab
ab
bs
bs
ab
ab
aa
aa
aa
aa
ab
ab
bs
ag
ab
ab
aa
aa
aa
aa
aa
aa
aa
cN
"}
(52,1,1) = {"
cN
aa
aa
aa
aa
aa
aa
aa
aa
aa
aa
aa
aa
aa
aa
aa
aa
ab
ac
ac
ab
aa
aa
aa
aa
aa
aa
ab
ac
ac
ab
aa
aa
aa
aa
aa
aa
aa
aa
cN
"}
(53,1,1) = {"
cN
aa
aa
aa
aa
aa
aa
aa
aa
aa
aa
aa
aa
aa
aa
aa
aa
aa
aa
aa
aa
aa
aa
aa
aa
aa
aa
aa
aa
aa
aa
aa
aa
aa
aa
aa
aa
aa
aa
cN
"}
(54,1,1) = {"
cN
cN
cN
cN
cN
cN
cN
cN
cN
cN
cN
cN
cN
cN
cN
cN
cN
cN
cN
cN
cN
cN
cN
cN
cN
cN
cN
cN
cN
cN
cN
cN
cN
cN
cN
cN
cN
cN
cN
cN
"}
