//MAP CONVERTED BY dmm2tgm.py THIS HEADER COMMENT PREVENTS RECONVERSION, DO NOT REMOVE
"a" = (
/turf/template_noop,
/area/template_noop)
"b" = (
/turf/template_noop,
/area/submap/virgo2/MilitaryCamp1)
"c" = (
/turf/simulated/mineral/floor/ignore_mapgen/virgo2,
/area/submap/virgo2/MilitaryCamp1)
"e" = (
/obj/effect/decal/cleanable/blood,
/turf/simulated/mineral/floor/ignore_mapgen/virgo2,
/area/submap/virgo2/MilitaryCamp1)
"f" = (
/obj/item/stack/rods,
/turf/simulated/mineral/floor/ignore_mapgen/virgo2,
/area/submap/virgo2/MilitaryCamp1)
"g" = (
/obj/item/material/shard,
/turf/simulated/mineral/floor/ignore_mapgen/virgo2,
/area/submap/virgo2/MilitaryCamp1)
"h" = (
/obj/effect/decal/remains,
/turf/simulated/mineral/floor/ignore_mapgen/virgo2,
/area/submap/virgo2/MilitaryCamp1)
"i" = (
/obj/tether_away_spawner/aerostat_surface,
/turf/simulated/floor/tiled/techfloor/virgo2,
/area/submap/virgo2/MilitaryCamp1)
"j" = (
/turf/simulated/wall/virgo2,
/area/submap/virgo2/MilitaryCamp1)
"k" = (
/obj/effect/mine,
/turf/simulated/mineral/floor/ignore_mapgen/virgo2,
/area/submap/virgo2/MilitaryCamp1)
"l" = (
/turf/simulated/floor/plating/virgo2,
/area/submap/virgo2/MilitaryCamp1)
"m" = (
/obj/structure/table/standard,
/turf/simulated/floor/tiled/techfloor/virgo2,
/area/submap/virgo2/MilitaryCamp1)
"n" = (
/obj/structure/table/standard,
/obj/item/gun/energy/gun,
/turf/simulated/floor/tiled/techfloor/virgo2,
/area/submap/virgo2/MilitaryCamp1)
"o" = (
/obj/effect/mine,
/turf/simulated/floor/plating/virgo2,
/area/submap/virgo2/MilitaryCamp1)
"q" = (
/obj/structure/table/standard,
/obj/item/gun/projectile/automatic/c20r,
/turf/simulated/floor/tiled/techfloor/virgo2,
/area/submap/virgo2/MilitaryCamp1)
"r" = (
/obj/structure/table/standard,
/obj/item/storage/box/syndie_kit/space,
/turf/simulated/floor/tiled/techfloor/virgo2,
/area/submap/virgo2/MilitaryCamp1)
"s" = (
/turf/simulated/floor/tiled/techfloor/virgo2,
/area/submap/virgo2/MilitaryCamp1)
"t" = (
/obj/machinery/door/airlock,
/turf/simulated/floor/tiled/techfloor/virgo2,
/area/submap/virgo2/MilitaryCamp1)
"w" = (
/obj/effect/decal/cleanable/blood,
/turf/simulated/floor/tiled/techfloor/virgo2,
/area/submap/virgo2/MilitaryCamp1)
"x" = (
/obj/structure/girder,
/turf/simulated/floor/plating/virgo2,
/area/submap/virgo2/MilitaryCamp1)
"y" = (
/obj/machinery/computer/security,
/turf/simulated/floor/tiled/techfloor/virgo2,
/area/submap/virgo2/MilitaryCamp1)
"z" = (
/obj/machinery/computer/message_monitor,
/turf/simulated/floor/tiled/techfloor/virgo2,
/area/submap/virgo2/MilitaryCamp1)
"A" = (
/obj/machinery/light,
/turf/simulated/floor/tiled/techfloor/virgo2,
/area/submap/virgo2/MilitaryCamp1)
"B" = (
/obj/structure/door_assembly,
/turf/simulated/floor/tiled/techfloor/virgo2,
/area/submap/virgo2/MilitaryCamp1)
"C" = (
/obj/structure/table/standard,
/obj/random/toolbox,
/turf/simulated/floor/tiled/techfloor/virgo2,
/area/submap/virgo2/MilitaryCamp1)
"D" = (
/obj/machinery/light,
/obj/structure/table/standard,
/turf/simulated/floor/tiled/techfloor/virgo2,
/area/submap/virgo2/MilitaryCamp1)
"E" = (
/obj/machinery/door/airlock,
/turf/simulated/floor/plating/virgo2,
/area/submap/virgo2/MilitaryCamp1)
"J" = (
/obj/effect/mine,
/turf/template_noop,
/area/submap/virgo2/MilitaryCamp1)

(1,1,1) = {"
a
a
a
a
a
a
a
a
a
a
a
a
a
a
a
a
a
a
a
a
"}
(2,1,1) = {"
a
b
c
c
c
b
b
b
b
c
e
c
c
c
c
b
b
c
b
a
"}
(3,1,1) = {"
a
b
h
c
c
c
b
b
c
c
k
c
c
c
c
k
c
h
c
a
"}
(4,1,1) = {"
a
c
c
c
c
c
k
c
g
c
c
c
c
c
c
c
c
c
c
a
"}
(5,1,1) = {"
a
c
c
c
c
c
j
j
j
l
l
x
j
j
c
c
c
k
c
a
"}
(6,1,1) = {"
a
k
c
c
f
j
j
j
j
j
j
j
j
j
j
c
c
c
b
a
"}
(7,1,1) = {"
a
c
c
k
j
j
m
r
j
i
s
s
w
C
j
j
c
c
J
a
"}
(8,1,1) = {"
a
c
c
c
j
j
s
l
j
j
t
j
s
m
j
j
j
c
c
a
"}
(9,1,1) = {"
a
e
c
c
l
l
o
l
j
y
A
j
s
s
j
j
j
c
c
a
"}
(10,1,1) = {"
a
k
c
c
j
l
l
l
w
s
s
j
s
i
E
l
c
k
e
a
"}
(11,1,1) = {"
a
c
c
f
j
j
i
s
s
s
i
j
B
s
l
l
g
c
c
a
"}
(12,1,1) = {"
a
c
e
c
j
j
j
t
j
z
A
j
s
s
j
j
j
f
c
a
"}
(13,1,1) = {"
a
c
k
c
l
j
n
s
j
j
t
j
s
D
j
j
j
c
k
a
"}
(14,1,1) = {"
a
b
c
c
j
j
q
s
j
i
s
s
s
m
j
j
c
c
c
a
"}
(15,1,1) = {"
a
b
c
c
g
j
j
j
j
j
j
j
j
j
j
c
k
c
c
a
"}
(16,1,1) = {"
a
b
h
c
c
c
j
j
x
j
j
x
j
j
c
c
c
h
c
a
"}
(17,1,1) = {"
a
b
b
k
c
k
c
c
c
c
c
c
c
g
k
c
c
c
b
a
"}
(18,1,1) = {"
a
b
b
c
c
c
c
c
k
c
c
c
c
c
c
k
c
b
b
a
"}
(19,1,1) = {"
a
b
b
b
c
k
c
c
c
c
c
c
c
e
c
c
b
b
b
a
"}
(20,1,1) = {"
a
a
a
a
a
a
a
a
a
a
a
a
a
a
a
a
a
a
a
a
"}
