//MAP CONVERTED BY dmm2tgm.py THIS HEADER COMMENT PREVENTS RECONVERSION, DO NOT REMOVE
"a" = (
/turf/template_noop,
/area/template_noop)
"b" = (
/turf/template_noop,
/area/submap/virgo2/SnowR1)
"c" = (
/turf/simulated/mineral/ignore_mapgen/virgo2,
/area/submap/virgo2/SnowR1)
"d" = (
/obj/structure/loot_pile/maint/trash,
/turf/simulated/mineral/floor/ignore_mapgen/virgo2,
/area/submap/virgo2/SnowR1)
"e" = (
/obj/structure/closet/crate/trashcart,
/turf/simulated/mineral/floor/ignore_mapgen/virgo2,
/area/submap/virgo2/SnowR1)
"f" = (
/turf/simulated/mineral/floor/ignore_mapgen/virgo2,
/area/submap/virgo2/SnowR1)
"g" = (
/obj/random/trash,
/turf/simulated/mineral/floor/ignore_mapgen/virgo2,
/area/submap/virgo2/SnowR1)
"h" = (
/obj/tether_away_spawner/aerostat_surface,
/turf/simulated/mineral/floor/ignore_mapgen/virgo2,
/area/submap/virgo2/SnowR1)

(1,1,1) = {"
a
a
a
a
a
a
a
a
a
a
a
a
a
a
a
a
a
a
a
a
"}
(2,1,1) = {"
a
b
b
b
b
b
b
b
b
b
b
b
b
b
b
b
b
b
b
a
"}
(3,1,1) = {"
a
b
b
b
b
b
b
b
b
b
b
f
f
f
f
f
f
b
b
a
"}
(4,1,1) = {"
a
b
b
b
b
b
c
c
c
c
f
f
f
f
f
f
b
b
b
a
"}
(5,1,1) = {"
a
b
b
b
b
b
c
c
c
f
f
f
f
f
f
c
b
b
b
a
"}
(6,1,1) = {"
a
b
b
b
b
c
c
c
f
f
f
f
h
f
f
c
b
b
b
a
"}
(7,1,1) = {"
a
b
b
c
c
c
c
c
f
f
f
f
f
f
f
c
c
b
b
a
"}
(8,1,1) = {"
a
b
c
c
c
c
c
c
f
f
f
f
f
f
f
c
c
b
b
a
"}
(9,1,1) = {"
a
b
c
c
c
d
g
f
f
f
f
f
f
f
c
c
c
b
b
a
"}
(10,1,1) = {"
a
b
c
c
c
e
f
f
f
f
h
f
f
f
c
c
c
b
b
a
"}
(11,1,1) = {"
a
b
c
c
c
f
f
f
f
f
f
f
f
f
c
c
c
b
b
a
"}
(12,1,1) = {"
a
b
c
c
c
g
f
f
f
f
f
f
f
c
c
c
c
b
b
a
"}
(13,1,1) = {"
a
b
c
c
c
g
f
f
f
f
f
f
f
c
c
c
c
b
b
a
"}
(14,1,1) = {"
a
b
b
c
c
c
c
f
f
f
f
f
f
c
c
c
b
b
b
a
"}
(15,1,1) = {"
a
b
b
b
c
c
c
f
f
f
f
f
f
c
c
c
c
b
b
a
"}
(16,1,1) = {"
a
b
b
b
b
c
c
f
f
f
f
f
f
c
c
c
b
b
b
a
"}
(17,1,1) = {"
a
b
b
b
b
b
b
f
f
h
f
f
f
b
b
b
b
b
b
a
"}
(18,1,1) = {"
a
b
b
b
b
b
b
f
f
f
f
f
f
b
b
b
b
b
b
a
"}
(19,1,1) = {"
a
b
b
b
b
b
b
f
f
f
f
f
f
b
b
b
b
b
b
a
"}
(20,1,1) = {"
a
a
a
a
a
a
a
a
a
a
a
a
a
a
a
a
a
a
a
a
"}
