"a" = (/turf/simulated/shuttle/wall/voidcraft/survival,/area/survivalpod)
"b" = (/obj/structure/bed/padded,/obj/item/weapon/bedsheet/medical,/obj/structure/curtain/open/privacy,/turf/simulated/shuttle/floor/voidcraft/light,/area/survivalpod)
"c" = (/obj/structure/window/reinforced/survival_pod{dir = 1},/obj/machinery/disposal,/obj/effect/floor_decal/industrial/warning/full,/obj/structure/disposalpipe/trunk{dir = 4},/turf/simulated/shuttle/floor/voidcraft/dark,/area/survivalpod)
"d" = (/turf/simulated/shuttle/floor/voidcraft/dark,/area/survivalpod)
"e" = (/obj/machinery/light/small,/obj/structure/sink{dir = 8; pixel_x = -12; pixel_y = 2},/turf/simulated/shuttle/floor/voidcraft/light,/area/survivalpod)
"f" = (/obj/structure/window/reinforced/survival_pod{dir = 1},/obj/structure/bed/chair/comfy/black{dir = 8},/turf/simulated/shuttle/floor/voidcraft/dark,/area/survivalpod)
"g" = (/obj/structure/table/glass,/obj/structure/closet/secure_closet/guncabinet/phase{pixel_y = -32},/obj/item/weapon/gun/energy/locked/frontier/holdout,/obj/item/weapon/gun/energy/locked/frontier/holdout,/obj/item/clothing/accessory/permit/gun/planetside,/obj/item/clothing/accessory/permit/gun/planetside,/obj/item/clothing/accessory/holster/waist,/obj/item/clothing/accessory/holster/waist,/turf/simulated/shuttle/floor/voidcraft/dark,/area/survivalpod)
"h" = (/obj/structure/sign/mining/survival{dir = 8},/turf/simulated/shuttle/wall/voidcraft/survival/hard_corner,/area/survivalpod)
"i" = (/obj/effect/floor_decal/industrial/danger/full,/obj/structure/fans/tiny,/obj/machinery/door/airlock/voidcraft/survival_pod,/turf/simulated/shuttle/floor/voidcraft/dark,/area/survivalpod)
"j" = (/obj/structure/sign/mining/survival,/turf/simulated/shuttle/wall/voidcraft/survival,/area/survivalpod)
"k" = (/turf/simulated/shuttle/floor/voidcraft/light,/area/survivalpod)
"l" = (/obj/machinery/sleeper/survival_pod,/turf/simulated/shuttle/floor/voidcraft/light,/area/survivalpod)
"m" = (/obj/structure/disposalpipe/segment,/turf/simulated/shuttle/wall/voidcraft/survival/hard_corner,/area/survivalpod)
"n" = (/obj/machinery/smartfridge/survival_pod,/obj/item/weapon/storage/mre/menu10,/obj/item/weapon/storage/mre/menu10,/obj/item/weapon/storage/mre/menu10,/obj/item/weapon/storage/mre/menu10,/obj/item/weapon/storage/mre/menu11,/obj/item/weapon/storage/mre/menu11,/obj/item/weapon/storage/mre/menu11,/obj/item/weapon/storage/mre/menu11,/obj/item/device/fbp_backup_cell,/obj/item/device/fbp_backup_cell,/obj/item/device/fbp_backup_cell,/obj/item/device/fbp_backup_cell,/obj/item/weapon/reagent_containers/glass/beaker/large,/obj/item/weapon/reagent_containers/glass/beaker/large,/obj/item/weapon/reagent_containers/food/drinks/drinkingglass/fitnessflask/glucose,/obj/item/weapon/reagent_containers/food/drinks/drinkingglass/fitnessflask/glucose,/obj/item/weapon/storage/box/freezer,/obj/item/weapon/storage/box/freezer,/obj/item/weapon/reagent_containers/dropper,/obj/item/weapon/reagent_containers/dropper,/obj/item/weapon/reagent_containers/glass/beaker,/obj/item/weapon/reagent_containers/glass/beaker,/obj/machinery/light{dir = 1},/obj/item/device/defib_kit/loaded,/obj/item/device/defib_kit/loaded,/obj/item/weapon/reagent_containers/blood/OMinus,/obj/item/weapon/reagent_containers/blood/OMinus,/obj/item/weapon/reagent_containers/blood/OMinus,/obj/item/weapon/reagent_containers/blood/OMinus,/turf/simulated/shuttle/floor/voidcraft/light,/area/survivalpod)
"o" = (/obj/item/device/gps/computer,/turf/simulated/shuttle/floor/voidcraft/light,/area/survivalpod)
"p" = (/obj/structure/window/reinforced/survival_pod{dir = 1},/obj/structure/toilet{dir = 8},/turf/simulated/shuttle/floor/voidcraft/light,/area/survivalpod)
"s" = (/obj/structure/sign/mining/survival{dir = 1},/turf/simulated/shuttle/wall/voidcraft/survival,/area/survivalpod)
"t" = (/obj/structure/window/reinforced/survival_pod{dir = 8},/obj/structure/window/reinforced/survival_pod{dir = 4},/obj/structure/window/reinforced/survival_pod{dir = 1},/obj/structure/window/reinforced/survival_pod,/obj/structure/grille,/obj/structure/curtain/black,/turf/simulated/shuttle/floor/voidcraft/dark,/area/survivalpod)
"u" = (/obj/machinery/light{dir = 1},/turf/simulated/shuttle/floor/voidcraft/light,/area/survivalpod)
"v" = (/obj/structure/window/reinforced/survival_pod{dir = 1},/obj/structure/bed/chair/comfy/black{dir = 4},/turf/simulated/shuttle/floor/voidcraft/dark,/area/survivalpod)
"w" = (/obj/structure/table/steel_reinforced,/obj/machinery/chemical_dispenser/full,/turf/simulated/shuttle/floor/voidcraft/light,/area/survivalpod)
"x" = (/obj/structure/sign/redcross,/turf/simulated/shuttle/wall/voidcraft/survival/hard_corner,/area/survivalpod)
"z" = (/obj/structure/disposalpipe/segment{dir = 8; icon_state = "pipe-c"},/obj/structure/sign/mining/survival{dir = 4},/turf/simulated/shuttle/wall/voidcraft/survival/hard_corner,/area/survivalpod)
"A" = (/obj/machinery/shower{dir = 8},/obj/item/weapon/soap/deluxe,/obj/structure/curtain,/turf/simulated/shuttle/floor/voidcraft/light,/area/survivalpod)
"B" = (/obj/structure/table/survival_pod,/obj/item/weapon/storage/firstaid/adv,/obj/item/weapon/storage/firstaid/o2{pixel_x = 5; pixel_y = 5},/turf/simulated/shuttle/floor/voidcraft/light,/area/survivalpod)
"C" = (/obj/effect/floor_decal/industrial/outline,/turf/simulated/shuttle/floor/voidcraft/dark,/area/survivalpod)
"D" = (/obj/structure/window/reinforced/survival_pod{dir = 1},/obj/structure/table/gamblingtable,/obj/item/device/starcaster_news,/obj/item/weapon/deck/cards,/obj/structure/fireaxecabinet{pixel_y = 27},/turf/simulated/shuttle/floor/voidcraft/dark,/area/survivalpod)
"E" = (/obj/machinery/optable,/obj/machinery/oxygen_pump/anesthetic{pixel_x = 32},/turf/simulated/shuttle/floor/voidcraft/light,/area/survivalpod)
"F" = (/obj/machinery/door/window/survival_pod{dir = 1},/turf/simulated/shuttle/floor/voidcraft/dark,/area/survivalpod)
"G" = (/turf/simulated/shuttle/wall/voidcraft/survival/hard_corner,/area/survivalpod)
"H" = (/obj/machinery/smartfridge/survival_pod,/obj/item/weapon/storage/box/bodybags,/obj/item/clothing/suit/straight_jacket,/obj/item/clothing/mask/muzzle,/obj/item/clothing/suit/straight_jacket,/obj/item/clothing/mask/muzzle,/obj/item/device/sleevemate,/obj/item/roller{pixel_y = 8},/obj/item/roller{pixel_y = 8},/obj/item/roller{pixel_y = 8},/obj/item/weapon/reagent_containers/spray/cleaner{desc = "Someone has crossed out the Space from Space Cleaner and written in Surgery. 'Do not remove under punishment of death!!!' is scrawled on the back."; name = "Surgery Cleaner"; pixel_x = 2; pixel_y = 2},/obj/item/weapon/reagent_containers/spray/cleaner{desc = "Someone has crossed out the Space from Space Cleaner and written in Surgery. 'Do not remove under punishment of death!!!' is scrawled on the back."; name = "Surgery Cleaner"; pixel_x = 2; pixel_y = 2},/obj/item/weapon/storage/firstaid/surgery,/obj/item/device/defib_kit/compact/loaded,/obj/item/bodybag/cryobag,/obj/item/bodybag/cryobag,/obj/item/weapon/extinguisher/mini,/obj/item/weapon/extinguisher/mini,/obj/item/weapon/towel/random,/obj/item/weapon/towel/random,/obj/item/weapon/towel/random,/obj/item/weapon/towel/random,/obj/item/device/binoculars,/obj/item/device/bluespaceradio,/obj/item/device/radio/emergency,/obj/item/device/radio/emergency,/obj/item/weapon/storage/box/survival/space,/obj/item/weapon/storage/box/survival/space,/obj/item/weapon/storage/box/survival/space,/obj/item/weapon/storage/box/survival/space,/obj/item/weapon/storage/box/survival/comp,/obj/item/weapon/storage/box/survival/comp,/obj/item/weapon/storage/toolbox/mechanical,/obj/item/toy/crossbow,/turf/simulated/shuttle/floor/voidcraft/light,/area/survivalpod)
"I" = (/obj/machinery/light,/obj/machinery/sleeper{dir = 4},/turf/simulated/shuttle/floor/voidcraft/dark,/area/survivalpod)
"J" = (/obj/machinery/sleep_console{dir = 4},/turf/simulated/shuttle/floor/voidcraft/dark,/area/survivalpod)
"K" = (/obj/structure/fans,/turf/simulated/shuttle/floor/voidcraft/light,/area/survivalpod)
"M" = (/obj/structure/sign/nosmoking_2,/turf/simulated/shuttle/wall/voidcraft/survival/hard_corner,/area/survivalpod)
"N" = (/obj/structure/sign/mining,/turf/simulated/shuttle/wall/voidcraft/survival/hard_corner,/area/survivalpod)
"O" = (/obj/structure/disposalpipe/segment,/turf/simulated/shuttle/wall/voidcraft/survival,/area/survivalpod)
"P" = (/obj/structure/sign/mining/survival{dir = 4},/turf/simulated/shuttle/wall/voidcraft/survival,/area/survivalpod)
"R" = (/obj/structure/window/reinforced/survival_pod{dir = 1},/obj/machinery/vending/medical{req_access = null; req_log_access = null},/turf/simulated/shuttle/floor/voidcraft/dark,/area/survivalpod)
"S" = (/obj/machinery/iv_drip,/obj/machinery/iv_drip,/obj/machinery/vending/wallmed1{dir = 8; pixel_x = 22; pixel_y = 3},/turf/simulated/shuttle/floor/voidcraft/light,/area/survivalpod)
"T" = (/obj/machinery/iv_drip,/obj/effect/floor_decal/industrial/loading{dir = 1},/turf/simulated/shuttle/floor/voidcraft/light,/area/survivalpod)
"U" = (/obj/structure/table/survival_pod,/obj/item/weapon/storage/firstaid/toxin,/obj/item/weapon/storage/firstaid/fire{pixel_x = 5; pixel_y = 5},/turf/simulated/shuttle/floor/voidcraft/light,/area/survivalpod)
"V" = (/obj/structure/disposalpipe/segment,/obj/structure/sign/mining/survival{dir = 4},/turf/simulated/shuttle/wall/voidcraft/survival,/area/survivalpod)
"W" = (/obj/structure/table/glass,/obj/item/weapon/storage/box/masks,/obj/item/weapon/storage/box/gloves{pixel_x = 4; pixel_y = 4},/obj/machinery/newscaster{pixel_y = -30},/turf/simulated/shuttle/floor/voidcraft/dark,/area/survivalpod)
"X" = (/obj/structure/sign/mining/survival{dir = 8},/turf/simulated/shuttle/wall/voidcraft/survival,/area/survivalpod)
"Y" = (/obj/structure/table/survival_pod,/obj/item/weapon/storage/firstaid/surgery,/obj/structure/sink/kitchen{dir = 4; pixel_x = -13},/obj/machinery/recharger,/turf/simulated/shuttle/floor/voidcraft/light,/area/survivalpod)
"Z" = (/obj/machinery/door/window/survival_pod{dir = 1},/turf/simulated/shuttle/floor/voidcraft/light,/area/survivalpod)

(1,1,1) = {"
asGGNGtsO
XKnoGHubV
GlTEGBkSm
GYkwGUkbm
hRFvDfFcz
idddddddi
xCCCCMZpx
XJIgWGeAP
ajGGNGGja
"}
