"a" = (/turf/simulated/wall,/area/template_noop)
"c" = (/turf/simulated/wall{can_open = 1},/area/template_noop)
"h" = (/obj/effect/decal/remains/lizard,/turf/simulated/mineral/floor/ignore_mapgen,/area/template_noop)
"k" = (/obj/structure/window/basic{dir = 1},/obj/structure/table/standard,/obj/random/maintenance/engineering,/obj/random/maintenance/engineering,/obj/random/maintenance/clean,/obj/random/maintenance/clean,/obj/random/powercell,/turf/simulated/floor/wood,/area/template_noop)
"m" = (/turf/template_noop,/area/template_noop)
"n" = (/obj/structure/dogbed,/obj/structure/sign/poster{dir = 1; pixel_y = 32; poster_decl = /decl/poster/vore_45},/turf/simulated/mineral/floor/ignore_mapgen,/area/template_noop)
"o" = (/obj/structure/window/basic{dir = 1},/obj/structure/table/standard,/obj/random/maintenance,/obj/random/drinksoft,/obj/random/snack,/turf/simulated/floor/wood,/area/template_noop)
"p" = (/obj/structure/dogbed,/mob/living/simple_mob/animal/passive/lizard/large,/turf/simulated/mineral/floor/ignore_mapgen,/area/template_noop)
"u" = (/obj/structure/flora/pottedplant/overgrown,/turf/simulated/floor/wood,/area/template_noop)
"v" = (/obj/machinery/door/window/westright,/obj/effect/decal/cleanable/dirt,/turf/simulated/floor/wood,/area/template_noop)
"w" = (/obj/structure/sign/poster{dir = 8; pixel_x = -32; poster_decl = /decl/poster/bay_19},/turf/simulated/floor/wood/broken,/area/template_noop)
"x" = (/obj/machinery/light/small{dir = 4},/turf/simulated/mineral/floor/ignore_mapgen,/area/template_noop)
"z" = (/obj/structure/loot_pile/maint/trash,/turf/simulated/floor/wood,/area/template_noop)
"B" = (/obj/structure/dogbed,/mob/living/simple_mob/animal/passive/lizard,/obj/item/trash/unajerky,/turf/simulated/mineral/floor/ignore_mapgen,/area/template_noop)
"E" = (/obj/structure/window/basic{dir = 1},/obj/structure/table/standard,/obj/structure/bedsheetbin,/obj/random/plushie,/turf/simulated/floor/wood,/area/template_noop)
"G" = (/obj/machinery/light/small{dir = 8},/turf/simulated/mineral/floor/ignore_mapgen,/area/template_noop)
"I" = (/obj/item/reagent_containers/food/snacks/wishsoup{pixel_y = -6},/obj/structure/sink/generic{dir = 4; pixel_x = -12; pixel_y = -4},/turf/simulated/mineral/floor/ignore_mapgen,/area/template_noop)
"L" = (/obj/item/trash/sosjerky,/turf/simulated/mineral/floor/ignore_mapgen,/area/template_noop)
"M" = (/obj/structure/window/basic{dir = 1},/obj/machinery/disposal,/obj/structure/disposalpipe/trunk{dir = 1},/turf/simulated/floor/wood,/area/template_noop)
"N" = (/obj/structure/bed/chair/office/dark{dir = 1},/turf/simulated/floor/wood,/area/template_noop)
"O" = (/obj/machinery/light/small,/obj/item/stack/emptysandbag,/obj/effect/decal/cleanable/dirt,/turf/simulated/floor/wood/broken,/area/template_noop)
"P" = (/obj/machinery/door/window/northleft,/obj/structure/window/basic{dir = 8},/obj/effect/decal/cleanable/dirt,/turf/simulated/floor/wood,/area/template_noop)
"R" = (/obj/structure/disposalpipe/trunk,/obj/structure/disposaloutlet{dir = 4},/turf/simulated/mineral/floor/ignore_mapgen,/area/template_noop)
"T" = (/obj/structure/window/basic{dir = 1},/obj/structure/table/standard,/obj/item/flashlight/lamp/green,/obj/item/paper_bin{pixel_x = 1; pixel_y = 9},/turf/simulated/floor/wood,/area/template_noop)
"U" = (/obj/item/toy/plushie/lizard,/turf/simulated/mineral/floor/ignore_mapgen,/area/template_noop)
"V" = (/obj/machinery/space_heater,/turf/simulated/mineral/floor/ignore_mapgen,/area/template_noop)
"W" = (/obj/item/stack/sandbags,/obj/machinery/power/apc{coverlocked = 0; locked = 0; name = "south bump"; operating = 0; pixel_y = -24},/turf/simulated/floor/wood,/area/template_noop)
"X" = (/turf/simulated/mineral/floor/ignore_mapgen,/area/template_noop)
"Y" = (/obj/structure/dogbed,/mob/living/simple_mob/animal/passive/lizard,/obj/machinery/light/small{dir = 1},/turf/simulated/mineral/floor/ignore_mapgen,/area/template_noop)
"Z" = (/turf/simulated/floor/wood,/area/template_noop)

(1,1,1) = {"
aaaaaaaa
aVBnYpVa
aGXXXLXa
aIXUXXxa
aRXXXhXa
aMTkoEPa
awNZNZva
azWZOuaa
aaacaaam
"}
