"a" = (/turf/unsimulated/wall/planetary/virgo3b{desc = "You can't go there!"; icon = 'icons/turf/flooring/plating_vr.dmi'; icon_state = ""; name = "impassible landscape"},/area/tether/surfacebase/outside/wilderness)
"b" = (/obj/effect/step_trigger/teleporter/wild/to_wild_1,/turf/simulated/floor/outdoors/grass/sif/virgo3b{icon_state = "grass_sif_dark"; name = "passage"; tree_chance = 0},/area/tether/surfacebase/outside/wilderness)
"c" = (/turf/simulated/floor/outdoors/grass/sif/virgo3b{icon_state = "grass_sif_dark"; name = "light growth"; tree_chance = 0},/area/tether/surfacebase/outside/wilderness)
"d" = (/turf/simulated/floor/outdoors/grass/sif/virgo3b{icon_state = "grass_sif_dark"; name = "dense growth"; tree_chance = 4},/area/tether/surfacebase/outside/wilderness)
"e" = (/obj/structure/mob_spawner/scanner/wild_animals,/turf/simulated/floor/outdoors/grass/sif/virgo3b{icon_state = "grass_sif_dark"; name = "dense growth"; tree_chance = 0},/area/tether/surfacebase/outside/wilderness)
"f" = (/turf/simulated/wall/sandstonediamond,/area/tether/surfacebase/temple)
"g" = (/turf/simulated/floor/outdoors/dirt{desc = "Quite dirty!"; icon = 'icons/turf/outdoors.dmi'; icon_state = "dirt-dark"; name = "dirt"},/area/tether/surfacebase/temple)
"h" = (/obj/structure/mob_spawner/scanner/xenos,/turf/simulated/floor/outdoors/dirt{desc = "Quite dirty!"; icon = 'icons/turf/outdoors.dmi'; icon_state = "dirt-dark"; name = "dirt"},/area/tether/surfacebase/temple)
"i" = (/obj/structure/mob_spawner/scanner/xenos/royal,/turf/simulated/floor/outdoors/dirt{desc = "Quite dirty!"; icon = 'icons/turf/outdoors.dmi'; icon_state = "dirt-dark"; name = "dirt"},/area/tether/surfacebase/temple)
"j" = (/obj/effect/step_trigger/teleporter/wild/to_wild_6,/turf/simulated/floor/outdoors/grass/sif/virgo3b{icon_state = "grass_sif_dark"; name = "passage"; tree_chance = 0},/area/tether/surfacebase/outside/wilderness)
"k" = (/obj/item/weapon/material/star,/turf/simulated/floor/outdoors/dirt{desc = "Quite dirty!"; icon = 'icons/turf/outdoors.dmi'; icon_state = "dirt-dark"; name = "dirt"},/area/tether/surfacebase/temple)
"l" = (/obj/effect/decal/mecha_wreckage/phazon{anchored = 1; name = "rusted Phazon wreckage"},/turf/simulated/floor/outdoors/dirt{desc = "Quite dirty!"; icon = 'icons/turf/outdoors.dmi'; icon_state = "dirt-dark"; name = "dirt"},/area/tether/surfacebase/temple)
"m" = (/obj/item/weapon/cell/infinite,/obj/effect/gibspawner/human,/turf/simulated/floor/outdoors/dirt{desc = "Quite dirty!"; icon = 'icons/turf/outdoors.dmi'; icon_state = "dirt-dark"; name = "dirt"},/area/tether/surfacebase/temple)
"n" = (/obj/item/weapon/material/sword/katana,/turf/simulated/floor/outdoors/dirt{desc = "Quite dirty!"; icon = 'icons/turf/outdoors.dmi'; icon_state = "dirt-dark"; name = "dirt"},/area/tether/surfacebase/temple)
"o" = (/obj/effect/step_trigger/teleporter/wild/to_wild_4,/turf/simulated/floor/outdoors/grass/sif/virgo3b{icon_state = "grass_sif_dark"; name = "passage"; tree_chance = 0},/area/tether/surfacebase/outside/wilderness)

(1,1,1) = {"
aaaaaaaaaaaaaaaaaaaaaaaaaaaaaaaaaaaaaaaaaaaaaaaaaaaaaaabbbbbbbbbaaaaaaaaaaaaaaaaaaaaaaaaaaaaaaaaaaaaaaaaaaaaaaaaaaaaaaaa
acccccccccccccccccccccccccccccccccccccccccccccccccccccccccccccccccccccccccccccccccccccccccccccccccccccccccccccccccccccca
acccccccccccccccccccccccccccccccccccccccccccccccccccccccccccccccccccccccccccccccccccccccccccccccccccccccccccccccccccccca
accddddddddddddddddddddddddddddddddddddddddddddddddddddddddddddddddddddddddddddddddddddddddddddddddddddddddddddddddddcca
accddddddddddddddddddddddddddddddddddddddddcddddddddddddddddddddddddddddddcddddddddddcdddddddddddddcddddddddddddddcddcca
accddddddddddddddddddddddddddddddddddddddddddddddddddddddddddddddddddddddddddddddddddddddddddddddddddddddddddddddddddcca
accdddddcdddddddddddddddcddddddddddddddddddddddddddddddddddddddddddddddddddddddddddddddddddddddddddddddddddddddddddddcca
accddddddddddddddddddddddddddddddddddddddddddddddddddddddddddddddddddddddddddddddddddddddddddddddddddddddddddddddddddcca
accddddddddddedddddddddddddddddddddddddddddddddddddddddddddddddddddddddddddddddddddddddddddddddddddddddddddddddddddddcca
accddddddddddddddddddddddddddddddddddddddddddddddddddddddddddddddddddddddddddddddddddddddddddddddddddddddddddddddddddcca
accdddddddddddddddddddddddddddddddddddddddddddddddcdddddddddddddddddcddddddddddddddddddddddddddddddddddddddddddddddddcca
accddddddddddddddddddddddddddddddddddddeddddddddddddddedddddddddddddddddddddddddddddddddeddcdddddddddddddddcdddddddddcca
accddddddddddddddddddddddddddddddddcddddddddddddddddddddddddddddddddddddddddddddddddddddddddddddddddddddddddeddddddddcca
accdddddddddddddcddddddddddddddddddddddddddddddddddddddddddcdddddddddddddddddddddddddddddddddddddddddddddddddddddddddcca
accddddddddddddddddddddddddddddddddddddddddddddddddddddddddddddddddddddddddddddddddddddddddddddddddddddddddddddddddddcca
accdddddddddddddddddddddddddddddddddddddddddddddddddddddddddddeddddddddddddddddddddddddddddddddddddddddddddddddddddddcca
accddddddddddddddddddddddddddddddddddddddddddddddddddddddddddddddddddddddddddddddddddddddddddddddddddddddddddddddddddcca
accddddddddddddddddddddddddddddddddddddddddddddddddddddddddddddddddddddddddddddddddddddddddddddddddddddddddddddddddddcca
accddddddddddddddddddddddddddddddddddddddddddddddddddddddddddddddddddddddddddddddddddddddddddddddddddddddddddddddddddcca
accddddddddddddddddddddddddddddddddddddddddddddcdddddddddddddddddddddddcddddddddddddcdddddddddddddddcdddddddddddddcddcca
accdddddcddddddddddddddddcdddddddddddddddddddddddddddddddddddddddddddddddddddddddddddddddddddddddddddddddddddddddddddcca
accddddddddddddddddddddddddddddddddddddddddddddddddddddddddddddddddddddddddddddddddddddddddddddddddddddddddddddddddddcca
accdddddddddddddddddddddddddddddddddddddddddddddddddddddddddddddddddddddddddddddddddddddddddddddddddddddddddeddddddddcca
accdddddddddddddddddddddfffffffffffffffffffffffffffffffffffffffffffffffffffffffffffffffffffffffffddddddddddddddddddddcca
accdddddddddddddddddddddfgggggggggggfgggggggggggfgggggggggfgggggggfffgggfgggggggggggggfgggggggggfddddddddddddddddddddcca
accdddddddddddddddddddddfgfgggggggggfgfgggggggggfgggggggggfgggggfgfffgggfgggggggggggfgfgggggggfgfddddddddddddddddddddcca
accdddddddddddddddddddddfgfgggggggggfgggggggggggfgggggggggggggggfgggfgggggggggggggggfgfgggggggfgfddddddddddddddddddddcca
accdddddddedddddddddddddfgfgggggggggfgfgggggggggfgggggggggfffffffgggfgggfffffffffffffgfgggggggfgfddddddddddddddddddddcca
accddddddddddcddddddddddfgfgggghggggfgfggghgggggfgggggggggfgggggggggfgggfgggggggggggggfgggggggfgfdddddddddcddddddddddcca
accdddddddddddddddddddddfgfgggggggggfgfgggggggggfgggghggggfgggggfgggggggfgggggfffgggggfgggggggfgfddddddddddddddddddddcca
accdddddddddddddddddddddfgggggggggggfgfgggggggggfgggggggggfgggggfgggfgggfgggggfffgggggfgggggggfgfddddddddddddddddddddcca
accdddddddddddddddddddddfffgggggggggfgfgggggggggfgggggggggfgggggfgggfgggfgggggfffgggggfgggggggfgfddddddddddddddddddddcca
accdddddddddddddddddddddfffgggggggggfgfgggggggggfffffffffffffffgfffgfgggfghgggggggggggfgggggggfgfddddddddddddddddddddcca
accdddddddddddddddddddddfffgfffffgfffgfgggggggggggggggggggggfgggggggfgggfgggggfffffgfgfffffgfgfgfddddddddddddddddddddcca
accdddddddddddddddddddddfffgggggggggggfffffffffffgggggggggggfgggggggfgggfgggggfgggggfgggggggfgggfddddddddddddddddddddcca
accdddddddddddddddddddddfffgggggfgggggfgggggggggggggggggggggfgggggggfgfgfgggggfgggggfgggggggfgggfddddddddddddddddddddcca
accdddddddddddddddddddddfgggggggfgggggfgggggggfffgghggggggggfgggggggfgggggggggfgghggfgghggggfgggfddddddddddddddddddddcca
accdddddddddddddddddddddfgfgggggfgggggfgggggggfffggggghgggggfgggggggggfffffffffgggggfgggggggfgggfddddddddddddddddcdddcca
accdddddddddddddddddddddfgfgggggfgghggfgggggggfgggggggggggggfggghgggfffgggggggggggggfgggggggfgggfddddddddddddddddddddcca
accdddddddddddddddddddddfgfgghggfgggggfgggggggfgfgggggggggggfgggggggggggggggggfffffffggghgggfgggfddddddddddddddddddddcca
accdddddddddddddddddddddfgggggggfgggggfggghgggfgggggggggggggggggggggfffgggggggfffgggggggggggfgggfddddddddddddddddddddcca
accdddddddddddddddddddddfffgggggfgggggfgggggggfffffffgfffffffgggggggfffgggggggfffgfffgggggggggggfddddddddddddddddddddcca
accdddddddddddddddddddddfgggggggfgggggfgggggggggggfgggggfgggggggggggfffgggggggfffgggfgggggggfgggfddddddddddddddddddddcca
accdddddddddddddddddddddfgfgggggfgfffffgggggggfgggfgggggfgfffffffgfffffffffffffffgggfgggggggfgggfdddddddddddeddddddddcca
accddddddddddcddddddddddfgggggggfgggggggggggggfgggfgggggfgggfgggfgggggggfgggggggfgggfffffffffgfffddddddddddddddddddddcca
accdddddddddddddddddddddfffffffffffffffffffffffgggfgggggfffgfgfgfffffffgfgfgghggfgggfgggggggggggfdddddddddddddddddcddcca
accdddddddddddddddddddddfgggggggggggggggggggfgfgggfgggggggggfgfgggggggggfgggggggggggfgggggggggfgfddddddddddddddddddddcca
accddcddddddddddddddddddfgggggggggggfgggggggfgfgfffffffffffffffffffffffffffgggggfgggfgggghggggfgfddddddddddddddddddddcca
accdddddddddddddddddddddfgggggggggggfgggggggfgggfffffffffffffffffffffffffgfgggggfgggfgggggggggfgfddddddddddddddddddddcca
accdddddddddddddddddddddfgfffffgfffffggghgggfgggfffffffffffffffffffffffffgfgggggfgggfgggggggggfgfddddddddddddddddddddcca
accdddddddddddddddddddddfgggggggfgggggggggggfgggfffffffffffffffffffffffffgggggggfgggggggggggggfgfddddddddddddddddddddcca
accdddddddcdddddddddddddfffgggfgfffgfgggggggfgggfffffffffffffffffffffffffgfffffgfgfffffffgfffgfgfddddddddddddddddddddcca
accdddddddddddddddddddddfffgggfgggggfgggggggfgggfffffffffffffffffffffffffgggggggggfgggggggggfgggfdddddddddcddddddddddcca
accdddddddddddddddddddddfffgggfffgfffggghgggfgggffffffgggggggggggggffffffghgggggggfgggggggggfgggfddddddddddddddddddddcca
accdddddddddddddddddddddfffgggfgggfgggggggggfgggffffffgigggggggggigffffffgggggggggfgggggggggfgggfddddddddddddddddddddcca
accddddddddddddddddeddddfffgggfffffgfgggggggfgggffffffgggggggggggggffffffgggggggggfgggghggggfgggfddddddddddddddddddddcca
bccdddddddddddddddddddddfffgggfgggfgfgggggggfgggffffffgggggggggggggffffffgggggggggfgggggggggfgggfddddddddddddddddddddccj
bccdddddddddddddddddddddfffffffgggfgfffffffgfgggffffffggggkggggggggffffffgggggggggfgggggggggfgggfddddddddddddddddddddccj
bccdddddddddddddddddddddfgggfgggggfgggggggfgggggffffffggggggiggggggffffffgggggggggfgggggggggfgggfddddddddddddddddddddccj
bccdddddddddddddddddddddfgggfgfghgfgggggggffffffffffffgggggglggggggffffffgfffffffffgfffffffgfgggfddddddddddddddddddddccj
bccddddddddddcddddddddddfgggggfgggfgggggggfgggggffffffggggggmggggggffffffgggggggfgggggggfgggfgggfdddddcddddddddddddddccj
bccdddddddddddddddddddddfgggfffgggfggghgggfgfgggffffffgggkgngggggggffffffghgggggfgggggggfgggfgfffddddddddddddddddddddccj
bccdddddddddddddddddddddfgggggfgggggggggggfgfgggffffffgggggggggkgggffffffgggggggfgggggggfgggfgggfddddddddddddddddddddccj
bccdddddddddddddddddddddfgfffgfgggfgggggggfgfgggffffffgggggggggggggffffffgggggggfgggggggfgggfgggfddddddddddddddddddddccj
bccdddddddddddddddddddddfgggfgfgggfggghgggfgfgggffffffgigggggggggigffffffgggggggfgggggggfgggfgggfddddddddddddddddddddccj
accdddddddddddddddddddddfgggfgfffffgggggggfgfgggffffffgggggggggggggffffffgggggggfggghgggfgggfgggfddddddddddddddddddddcca
accdddddddddddddddddddddfgggfgggggfgggggggggggggfffffffffffffffffffffffffgggggggfgggggggfgggfgggfddddddddddddddddddddcca
accdddddddddddddddddddddfgggfgfgfffffffffffffgggfffffffffffffffffffffffffgggggggfgggggggfgggfffgfddddddddddddddddddddcca
accdddddddddddddddddddddfgggfgggggggggfgggggfgggfffffffffffffffffffffffffgggggggfgggggggfgggfgggfddddddddddddddddddddcca
accdddddddcdddddddddddddfgggfgggggggggfgggfgfgggfffffffffffffffffffffffffgfffffgfgggggggfffffgggfdddddddddddeddddddddcca
accdddddddddddddddddddddfgggggggggggggfgggggfgggfffffffffffffffffffffffffgggggfgggggggggggggfgggfddddddddddcdddddddddcca
accdddddddddddddddddddddfffffgggggggggfgggfffffffffffffffffffffffffffffffffgggfffffffffffgggfgggfddddddddddddddddddddcca
accdddddddddddddddddddddfggggggghgggggggggggggggggggggggggggfgggggggggfgggfgggfgggggggfgggggfgggfddddddddddddddddddddcca
accdddddddddddddddddddddfgfffgggggggggfffgfgggggfgggggggggggfgggggggggfgggfgfffgggggggfgfgggfffgfddddddddddddddddddddcca
accdddddddddddddddddddddfgggggggggggggggfgfgggggfgggggggggggfggggghgggggggfgggfgggggggggfgggfgggfddddddddddddddddddddcca
accdcdddddddddddddddddddfffgfggggghgggfgfgfffffgfgggggggggggfgggggggggfgggfffgfffffgfffffgggfgggfddddddddddddddddddddcca
accdddddddddddddddddddddfgggfgggggggggfgggggfgggfgggghggggggfgggggggggfgggfgggggggfgggfffgggfgggfddddddddddddddddddddcca
accdddddddddddddddddddddfgfffgggggggggfffffffgfffgggggggggggfgfgfffffffgggfgggggggfffgfffffgfgggfddddddddddddddddddcdcca
accdddddddddddddddddddddfgggfgggggggggfgggggfgfgggggggggggggfgfgggggfffgggfgggggggggggggfgggggggfddddddddddddddddddddcca
accddddddddddcddddddddddfgggfffffffffffgggggfgfgfggggggghgggfgfgggggfffgggfggghgggfgggggfffffgggfddddddddddddddddddddcca
accdddddddddddddddddddddfgggfgggggggggggggggfgfgfgggggggggggggfgggggfffgggggggggggfgggggggggfgggfddddddddddddddddddddcca
accdddddddddddddddddddddfgggfgggggggggfgggggfgfgfgggggggggggfffgghggfffgggfgggggggfffffffgggfgggfdddcddddddddddddddddcca
accdddddddddddddddddddddfgggggggggggggfgggggfgggfgggggggggggggfgggggfffgggfgggggggggfffffgggfgggfddddddddddddddddddddcca
accdddddddddddddddddddddfffffggghgggggfffffgfffffffgfffffffffgfgggggfffffffgggghggfgfffffghgfgggfddddddddddddddddddddcca
accdddddddddddddedddddddfgggggggggggggfgggggggggggggggfgggggggfgggggfgggggfgggggggfgfffffgggfgggfddddddddddddddddddddcca
accdddddddddddddddddddddfgfffggggghgggfgggfgggggggggggfgggggfffffgfffgggfgfgggggggfgfffffgggfgfffddddddddddddddddddddcca
accdddddddddddddddddddddfgfffgggggggggfgggfgggggggggggfgggggfgggggggfgggfgfgggggggfgggfffgggfgggfddddddddddddddddddddcca
accdddddddddddddddddddddfgfffgggggggggfgggfffffhfffffffgfffffgggggggfgggfgfgfgfffffgggfffgfffgggfddddddddddddddddddddcca
accdddddddddddddddddddddfgggggggggggggfgggggggfgggggggggggggggggggggggggfgggfgggfffgggggggfgggggfddddddddddddddddddddcca
accdddddddddddddddddddddfffgfffffgfffffgggfgggfgggfgggggggggfffffffffffgfgggfffgfffgggfgggfgfgggfddddddddddddddddcdddcca
accdddddddddddddddddddddfgggggggggggggggggfgggggggfgggggggggfgggggggfffgfgggggggggfgggfgggggfgggfdddddddddddeddddddddcca
accdddddddddddddddddddddfgggggggggfffffffgfgggfffgfffffgfffgfggghgggfffgfffffgggggfgggfffffffgggfddddddddddddddddddddcca
accdddddddddddddddddddddfgggggggggggggggfgfgggffggggggggfffgfgggggggggggggfffgggggfgggfgggggggggfddddddddddddddddddddcca
accdddddddddddcdddddddddfffgffffffggggggfgffffffggggggggfffgfffffgfffgggggfffffffgfffffgfgggfffgfddddddddddddddddddddcca
accdddddddddddddddddddddfgggffffffggggggfgggggggggggggggggggggggggggfgggggfffffffgggggggfgggggggfddddddddddddddddddddcca
accdddddddddddddddddddddfffffffffffffffffffffffffffffffffffffffffffffffffffffffffffffffffffffffffddddddddddddddddddddcca
accdddddddddddddddddddddddddddddddddddddddddddddddddddddddddddddddddddddddddcddddddddddddddddddddddddddddddddddddddddcca
accdddddcdddddddddddddddddddcddddddddddddddddddddddddddddddddddddddddddddddddddddddddddddddddddddddddddddddddddddddddcca
accdddddddddddddddddddddddddddddddddddddddddddddddddddddddddddddddddddddddddddddddddddddddddddddddddcddddddddddddddddcca
accddddddddddddddddddddddddddddddddddddddddddddddddddddddddddddddddddddddddddddddddddddddddddddddddddddddddddddddddddcca
accdddddddddddddddddddddddddddddddddddddddddddddddddddddddddddddddddddddddddddddddddddddddddcdddddddddddddddddddcddddcca
accddddddddddddddddddddddddddddddddddddddddddddddddddddddddddddddddddddddddddddddddddddddddddddddddddddddddddddddddddcca
accddddddddddddddddddddddddddddddddddddddddddddddddddddddddddddddddddddddddddddddddddddddddddddddddddddddddddddddddddcca
accddddddddddddddddddddddddddddddddddddddddddddddddddddddddddddddddddddddddddddddddddddddddddddddddddddddddddddddddddcca
accddddddddddddddddddddddddddddddddddddcddddddddddddddddddddddddddddddddddddddddddddddddddddddddeddddddddddddddddddddcca
accddddddddddddddcdddddddddddddddddddddddddddedddddddddddddddddddddddddddddddddddddddddddddddddddddddddddddddddddddddcca
accddddddddedddddddddddddddddddddddddddddddddddddddddddddddcddddddddedddddddddddddcddddddddddddddddddddcdddddddddddddcca
accddddddddddddddddddddddddddddddddddddddddddddddddddddddddddddddddddddddddddddddddddddddddddddddddddddddddddddddddddcca
accddddddddddddddddddddddddddddddddddddddddddddddddddddddddddddddddddddddddddddddddddddddddddddddddddddddddddddddddddcca
accddddddddddddddddddddddddddddddddddddddddddddddcdddddddddddddddddddcdddddddddddddddddddddddddddddddddddddddddddddddcca
accddddddddddddddddddddddddddddddddddddddddddddddddddddddddddddddddddddddddddddddddddddddddddddddddddddddddddddddddddcca
accddddddddddddddddddddddddddddddddddddddddddddddddddddddddddddddddddddddddddddddddddddddddddddddddddddddddddddddddddcca
accddddddddddddddddddddddddddddddddddddddddddddddddddddddddddddddddddddddddddddddddddddddddddddddddddddddddddddddddddcca
accddddddddddddddddddddddddddddddddddddddddddddddddddddddddddddddddddddddddddddddddddddddddddddddddddddddddddddddddddcca
accddddddcddddddddddddddddddcdddddddddddddddddddddddddddddddddddddddddddddddddddddddddddddddcdddddddddddddddddddcddddcca
accddddddddddddddddddddddddddddddddddddddddddddddddddddddddddddddddddddddddddddddcdddddddddddddddddddddddddddddddddddcca
accddddddddddddddddddddddddddddddddddddddcdddddddddddddddddddddddddddddddddddddddddddddddddddddddddddddddddddddddddddcca
acccccccccccccccccccccccccccccccccccccccccccccccccccccccccccccccccccccccccccccccccccccccccccccccccccccccccccccccccccccca
acccccccccccccccccccccccccccccccccccccccccccccccccccccccccccccccccccccccccccccccccccccccccccccccccccccccccccccccccccccca
aaaaaaaaaaaaaaaaaaaaaaaaaaaaaaaaaaaaaaaaaaaaaaaaaaaaaaaoooooooooaaaaaaaaaaaaaaaaaaaaaaaaaaaaaaaaaaaaaaaaaaaaaaaaaaaaaaaa
"}

