"a" = (/turf/space,/area/space)
"b" = (/turf/simulated/wall/r_wall,/area/space)
"c" = (/turf/simulated/floor/reinforced,/area/space)
"f" = (/obj/turbolift_map_holder/junglebase,/turf/simulated/shuttle/floor/voidcraft/dark,/area/junglebase/turboshaft)
"i" = (/turf/simulated/floor/torris_indoors,/area/space)
"p" = (/turf/simulated/sky/torris,/area/space)
"r" = (/turf/simulated/floor/torris,/area/space)
"u" = (/turf/simulated/floor/reinforced/torris,/area/space)
"x" = (/turf/simulated/shuttle/floor/voidcraft/dark,/area/junglebase/turboshaft)
"J" = (/turf/simulated/shuttle/wall/voidcraft,/area/junglebase/turboshaft)

(1,1,1) = {"
pppppppppppppppppppppppppppppppppppppppppppppppppppppppppppppppppppppppppppppppppppppppppppppppppppppppppppppppppppppppppppppppppppppppppppp
pppppppppppppppppppppppppppppppppppppppppppppppppppppppppppppppppppppppppppppppppppppppppppppppppppppppppppppppppppppppppppppppppppppppppppp
pppppppppppppppppppppppppppppppppppppppppppppppppppppppppppppppppppppppppppppppppppppppppppppppppppppppppppppppppppppppppppppppppppppppppppp
pppppppppppppppppppppppppppppppppppppppppppppppppppppppppppppppppppppppppppppppppppppppppppppppppppppppppppppppppppppppppppppppppppppppppppp
pppppppppppppppppppppppppppppppppppppppppppppppppppppppppppppppppppppppppppppppppppppppppppppppppppppppppppppppppppppppppppppppppppppppppppp
pppppppppppppppppppppppppppppppppppppppppppppppppppppppppppppppppppppppppppppppppppppppppppppppppppppppppppppppppppppppppppppppppppppppppppp
pppppppppppppppppppppppppppppppppppppppppppppppppppppppppppppppppppppppppppppppppppppppppppppppppppppppppppppppppppppppppppppppppppppppppppp
pppppppppppppppppppppppppppppppppppppppppppppppppppppppppppppppppppppppppppppppppppppppppppppppppppppppppppppppppppppppppppppppppppppppppppp
pppppppppppppppppppppppppppppppppppppppppppppppppppppppppppppppppppppppppppppppppppppppppppppppppppppppppppppppppppppppppppppppppppppppppppp
pppppppppppppppppppppppppppppppppppppppppppppppppppppppppppppppppppppppppppppppppppppppppppppppppppppppppppppppppppppppppppppppppppppppppppp
pppppppppppppppppppppppppppppppppppppppppppppppppppppppppppppppppppppppppppppppppppppppppppppppppppppppppppppppppppppppppppppppppppppppppppp
pppppppppppppppppppppppppppppppppppppppppppppppppppppppppppppppppppppppppppppppppppppppppppppppppppppppppppppppppppppppppppppppppppppppppppp
pppppppppppppppppppppppppppppppppppppppppppppppppppppppppppppppppppppppppppppppppppppppppppppppppppppppppppppppppppppppppppppppppppppppppppp
pppppppppppppppppppppppppppppppppppppppppppppppppppppppppppppppppppppppppppppppppppppppppppppppppppppppppppppppppppppppppppppppppppppppppppp
pppaaaaaaaaaaaaaaaaaaaaaaaaaaaaaaaaaaaaaaaaaaaaaaaaaaaaaaaaaaaaaaaaaaaaaaaaaaaaaaaaaaaaaaaaaaaaaaaaaaaaaaaaaaaaaaaaaaaaaaaaaaaaaaaaaaaaaaapp
pppaaaaaaaaaaaaaaaaaaaaaaaaaaaaaaaaaaaaaaaaaaaaaaaaaaaaaaaaaaaaaaaaaaaaaaaaaaaaaaaaaaaaaaaaaaaaaaaaaaaaaaaaaaaaaaaaaaaaaaaaaaaaaaaaaaaaaaapp
pppaaaaaaaaaaaaaaaaaaaaaaaaaaaaaaaaaaaaaaaaaaaaaaaaaaaaaaaaaaaaaaaaaaaaaaaaaaaaaaaaaaaaaaaaaaaaaaaaaaaaaaaaaaaaaaaaaaaaaaaaaaaaaaaaaaaaaaapp
pppaaaaaaaaaaaaaaaaaaaaaaaaaaaaaaaaaaaaaaaaaaaaaaaaaaaaaaaaaaaaaaaaaaaaaaaaaaaaaaaaaaaaaaaaaaaaaaaaaaaaaaaaaaaaaaaaaaaaaaaaaaaaaaaaaaaaaaapp
pppaaaaaaaaaaaaaaaaaaaaaaaaaaaaaaaaaaaaaaaaaaaaaaaaaaaaaaaaaaaaaaaaaaaaaaaaaaaaaaaaaaaaaaaaaaaaaaaaaaaaaaaaaaaaaaaaaaaaaaaaaaaaaaaaaaaaaaapp
pppaaaaaaaaaaaaaaaaaaaaaaaaaaaaaaaaaaaaaaaaaaaaaaaaaaaaaaaaaaaaaaaaaaaaaaaaaaaaaaaaaaaaaaaaaaaaaaaaaaaaaaaaaaaaaaaaaaaaaaaaaaaaaaaaaaaaaaapp
pppaaaaaaaaaaaaaaaaaaaaaaaaaaaaaaaaaaaaaaaaaaaaaaaaaaaaaaaaaaaaaaaaaaaaaaaaaaaaaaaaaaaaaaaaaaaaaaaaaaaaaaaaaaaaaaaaaaaaaaaaaaaaaaaaaaaaaaapp
pppaaaaaaaaaaaaaaaaaaaaaaaaaaaaaaaaaaaaaaaaaaaaaaaaaaaaaaaaaaaaaaaaaaaaaaaaaaaaaaaaaaaaaaaaaaaaaaaaaaaaaaaaaaaaaaaaaaaaaaaaaaaaaaaaaaaaaaapp
pppaaaaaaaaaaaaaaaaaaaaaaaaaaaaaaaaaaaaaaaaaaaaaaaaaaaaaaaaaaaaaaaaaaaaaaaaaaaaaaaaaaaaaaaaaaaaaaaaaaaaaaaaaaaaaaaaaaaaaaaaaaaaaaaaaaaaaaapp
pppaaaaaaaaaaaaaaaaaaaaaaaaaaaaaaaaaaaaaaaaaaaaaaaaaaaaaaaaaaaaaaaaaaaaaaaaaaaaaaaaaaaaaaaaaaaaaaaaaaaaaaaaaaaaaaaaaaaaaaaaaaaaaaaaaaaaaaapp
pppaaaaaaaaaaaaaaaaaaaaaaaaaaaaaaaaaaaaaaaaaaaaaaaaaaaaaaaaaaaaaaaaaaaaaaaaaaaaaaaaaaaaaaaaaaaaaaaaaaaaaaaaaaaaaaaaaaaaaaaaaaaaaaaaaaaaaaapp
pppaaaaaaaaaaaaaaaaaaaaaaaaaaaaaaaaaaaaaaaaaaaaaaaaaaaaaaaaaaaaaaaaaaaaaaaaaaaaaaaaaaaaaaaaaaaaaaaaaaaaaaaaaaaaaaaaaaaaaaaaaaaaaaaaaaaaaaapp
pppaaaaaaaaaaaaaaaaaaaaaaaaaaaaaaaaaaaaaaaaaaaaaaaaaaaaaaaaaaaaaaaaaaaaaaaaaaaaaaaaaaaaaaaaaaaaaaaaaaaaaaaaaaaaaaaaaaaaaaaaaaaaaaaaaaaaaaapp
pppaaaaaaaaaaaaaaaaaaaaaaaaaaaaaaaaaaaaaaaaaaaaaaaaaaaaaaaaaaaaaaaaaaaaaaaaaaaaaaaaaaaaaaaaaaaaaaaaaaaaaaaaaaaaaaaaaaaaaaaaaaaaaaaaaaaaaaapp
pppaaaaaaaaaaaaaaaaaaaaaaaaaaaaaaaaaaaaaaaaaaaaaaaaaaaaaaaaaaaaaaaaaaaaaaaaaaaaaaaaaaaaaaaaaaaaaaaaaaaaaaaaaaaaaaaaaaaaaaaaaaaaaaaaaaaaaaapp
pppaaaaaaaaaaaaaaaaaaaaaaaaaaaaaaaaaaaaaaaaaaaaaaaaaaaaaaaaaaaaaaaaaaaaaaaaaaaaaaaaaaaaaaaaaaaaaaaaaaaaaaaaaaaaaaaaaaaaaaaaaaaaaaaaaaaaaaapp
pppaaaaaaaaaaaaaaaaaaaaaaaaaaaaaaaaaaaaaaaaaaaaaaaaaaaaaaaaaaaaaaaaaaaaaaaaaaaaaaaaaaaaaaaaaaaaaaaaaaaaaaaaaaaaaaaaaaaaaaaaaaaaaaaaaaaaaaapp
pppaaaaaaaaaaaaaaaaaaaaaaaaaaaaaaaaaaaaaaaaaaaaaaaaaaaaaaaaaaaaaaaaaaaaaaaaaaaaaaaaaaaaaaaaaaaaaapaaaaaaaaaaaaaaaaaaaapaaaaaaaaaaaaaaaaaaapp
pppaaaaaaaaaaaaaaaaaaaapaaaaaaaaaaaaaaaaaaaapaaaaaaaaaaaaaaaaaaaaaaaaaaaaaaaaaaaaaaaaaaaaaaaaaaaapaaaaaaaaaaaaaaaaaaaapaaaaaaaaaaaaaaaaaaapp
pppuuuuuuuuuuuuuuuuuuuupauuuuuuuuuuuuuuuuuuuupauuuuuuuuuuuuuuuuuuuuaaaaaaaauuuuuuuuuuuuuuuuuuuuapuuuuuuuuuuuuuuuuuuuuapuuuuuuuuuuuuuuuuuuupp
pppuuuuuuuuuuuuuuuuuuuupauuuuuuuuuuuuuuuuuuuupauuuuuuuuuuuuuuuuuuuuaaaaaaaauuuuuuuuuuuuuuuuuuuuapuuuuuuuuuuuuuuuuuuuuapuuuuuuuuuuuuuuuuuuupp
pppuuuuuuuuuuuuuuuuuuuupauuuuuuuuuuuuuuuuuuuupauuuuuuuuuuuuuuuuuuuuaaaaaaaauuuuuuuuuuuuuuuuuuuuapuuuuuuuuuuuuuuuuuuuuapuuuuuuuuuuuuuuuuuuupp
pppuuuuuuuuuuuuuuuuuuuupauuuuuuuuuuuuuuuuuuuupauuuuuuuuuuuuuuuuuuuuaaaaaaaauuuuuuuuuuuuuuuuuuuuapuuuuuuuuuuuuuuuuuuuuapuuuuuuuuuuuuuuuuuuupp
pppuuuuuuuuuuuuuuuuuuuupauuuuuuuuuuuuuuuuuuuupauuuuuuuuuuuuuuuuuuuuaaaaaaaauuuuuuuuuuuuuuuuuuuuapuuuuuuuuuuuuuuuuuuuuapuuuuuuuuuuuuuuuuuuupp
pppuuuuuuuuuuuuuuuuuuuupauuuuuuuuuuuuuuuuuuuupauuuuuuuuuuuuuuuuuuuuaaaaaaaauuuuuuuuuuuuuuuuuuuuapuuuuuuuuuuuuuuuuuuuuapuuuuuuuuuuuuuuuuuuupp
pppuuuuuuuuuuuuuuuuuuuupauuuuuuuuuuuuuuuuuuuupauuuuuuuuuuuuuuuuuuuuaaaaaaaauuuuuuuuuuuuuuuuuuuuapuuuuuuuuuuuuuuuuuuuuapuuuuuuuuuuuuuuuuuuupp
pppuuuuuuuuuuuuuuuuuuuupauuuuuuuuuuuuuuuuuuuupauuuuuuuuuuuuuuuuuuuuaaaaaaaauuuuuuuuuuuuuuuuuuuuapuuuuuuuuuuuuuuuuuuuuapuuuuuuuuuuuuuuuuuuupp
pppuuuuuuuuuuuuuuuuuuuupauuuuuuuuuuuuuuuuuuuupauuuuuuuuuuuuuuuuuuuuaaaaaaaauuuuuuuuuuuuuuuuuuuuapuuuuuuuuuuuuuuuuuuuuapuuuuuuuuuuuuuuuuuuupp
pppuuuuuuuuuuuuuuuuuuuupauuuuuuuuuuuuuuuuuuuupauuuuuuuuuuuuuuuuuuuuaaaaaaaauuuuuuuuuuuuuuuuuuuuapuuuuuuuuuuuuuuuuuuuuapuuuuuuuuuuuuuuuuuuupp
pppuuuuuuuuuuuuuuuuuuuupauuuuuuuuuuuuuuuuuuuupauuuuuuuuuuuuuuuuuuuuaaaaaaaauuuuuuuuuuuuuuuuuuuuapuuuuuuuuuuuuuuuuuuuuapuuuuuuuuuuuuuuuuuuupp
pppuuuuuuuuuuuuuuuuuuuupauuuuuuuuuuuuuuuuuuuupauuuuuuuuuuuuuuuuuuuuaaaaaaaauuuuuuuuuuuuuuuuuuuuapuuuuuuuuuuuuuuuuuuuuapuuuuuuuuuuuuuuuuuuupp
pppuuuuuuuuuuuuuuuuuuuupauuuuuuuuuuuuuuuuuuuupauuuuuuuuuuuuuuuuuuuuaaaaaaaauuuuuuuuuuuuuuuuuuuuapuuuuuuuuuuuuuuuuuuuuapuuuuuuuuuuuuuuuuuuupp
pppuuuuuuuuuuuuuuuuuuuupauuuuuuuuuuuuuuuuuuuupauuuuuuuuuuuuuuuuuuuuaaaaaaaauuuuuuuuuuuuuuuuuuuuapuuuuuuuuuuuuuuuuuuuuapuuuuuuuuuuuuuuuuuuupp
pppuuuuuuuuuuuuuuuuuuuupauuuuuuuuuuuuuuuuuuuupauuuuuuuuuuuuuuuuuuuuaaaaaaaauuuuuuuuuuuuuuuuuuuuapuuuuuuuuuuuuuuuuuuuuapuuuuuuuuuuuuuuuuuuupp
pppuuuuuuuuuuuuuuuuuuuupauuuuuuuuuuuuuuuuuuuupauuuuuuuuuuuuuuuuuuuuaaaaaaaauuuuuuuuuuuuuuuuuuuuapuuuuuuuuuuuuuuuuuuuuapuuuuuuuuuuuuuuuuuuupp
pppuuuuuuuuuuuuuuuuuuuupauuuuuuuuuuuuuuuuuuuupauuuuuuuuuuuuuuuuuuuuaaaaaaaauuuuuuuuuuuuuuuuuuuuapuuuuuuuuuuuuuuuuuuuuapuuuuuuuuuuuuuuuuuuupp
pppuuuuuuuuuuuuuuuuuuuupauuuuuuuuuuuuuuuuuuuupauuuuuuuuuuuuuuuuuuuuaaaaaaaauuuuuuuuuuuuuuuuuuuuapuuuuuuuuuuuuuuuuuuuuapuuuuuuuuuuuuuuuuuuupp
pppuuuuuuuuuuuuuuuuuuuupauuuuuuuuuuuuuuuuuuuupauuuuuuuuuuuuuuuuuuuuaaaaaaaauuuuuuuuuuuuuuuuuuuuapuuuuuuuuuuuuuuuuuuuuapuuuuuuuuuuuuuuuuuuupp
pppuuuuuuuuuuuuuuuuuuuupauuuuuuuuuuuuuuuuuuuupauuuuuuuuuuuuuuuuuuuuaaaaaaaauuuuuuuuuuuuuuuuuuuuapuuuuuuuuuuuuuuuuuuuuapuuuuuuuuuuuuuuuuuuupp
pppuuuuuuuuuuuuuuuuuuuupauuuuuuuuuuuuuuuuuuuupauuuuuuuuuuuuuuuuuuuuaaaaaaaauuuuuuuuuuuuuuuuuuuuapuuuuuuuuuuuuuuuuuuuuapuuuuuuuuuuuuuuuuuuupp
pppuuuuuuuuuuuuuuuuuuuupauuuuuuuuuuuuuuuuuuuupauuuuuuuuuuuuuuuuuuuuaaaaaaaauuuuuuuuuuuuuuuuuuuuapuuuuuuuuuuuuuuuuuuuuapuuuuuuuuuuuuuuuuuuupp
pppuuuuuuuuuuuuuuuuuuuupauuuuuuuuuuuuuuuuuuuupauuuuuuuuuuuuuuuuuuuuaaaaaaaauuuuuuuuuuuuuuuuuuuuapuuuuuuuuuuuuuuuuuuuuapuuuuuuuuuuuuuuuuuuupp
pppaaaaaaaaaaaaaaaaaaaapaaaaaaaaaaaaaaaaaaaapaaaaaaaaaaaaaaaaaaaaaaaaaaaaaaaaaaaaaaaaaaaaaaaaaaaapaaaaaaaaaaaaaaaaaaaapaaaaaaaaaaaaaaaaaaapp
pppaaaaaaaaaaaaaaaaaaaaaaaaaaaaaaaaaaaaaaaaaaaaaaaaaaaaaaaaaaaaaaaaaaaaaaaaaaaaaaaaaaaaaaaaaaaaaapaaaaaaaaaaaaaaaaaaaapaaaaaaaaaaaaaaaaaaapp
pppaaaaaaaaaaaaaaaaaaaaaaaaaaaaaaaaaaaaaaaaaaaaaaaaaaaaaaaaaaaaaaaaaaaaaaaaaaaaaaaaaaaaaaaaaaaaaapaaaaaaaaaaaaaaaaaaaapaaaaaaaaaaaaaaaaaaapp
pppaaaaaaaaaaaaaaaaaaaaaaaaaaaaaaaaaaaaaaaaaaaaaaaaaaaaaaaaaaaaaaaaaaaaaaaaaaaaaaaaaaaaaaaaaaaaaaaaaaaaaaaaaaaaaaaaaaaaaaaaaaaaaaaaaaaaaaapp
pppaaaaaaaaaaaaaaaaaaaaaaaaaaaaaaaaaaaaaaaaaaaaaaaaaaaaaaaaaaaaaaaaaaaaaaaaaaaaaaaaaaaaaaaaaaaaaaaaaaaaaaaaaaaaaaaaaaaaaaaaaaaaaaaaaaaaaaapp
pppaaaaaaaaaaaaaaaaaaaaaaaaaaaaaaaaaaaaaaaaaaaaaaaaaaaaaaaaaaaaaaaaaaaaaaaaaaaaaaaaaaaaaaaaaaaaaaaaaaaaaaaaaaaaaaaaaaaaaaaaaaaaaaaaaaaaaaapp
pppaaaaaaaaaaaaaaaaaaaaaaaaaaaaaaaaaaaaaaaaaaaaaaaaaaaaaaaaaaaaaaaabbbbbbbbaaaaaaaaaaaaaaaaaaaaaaaaaaaaaaaaaaaaaaaaaaaaaaaaaaaaaaaaaaaaaaapp
pppaaaaaaaaaaaaaaaaaaaaaaaaaaaaaaaaaaaaaaaaaaaaaaaaaaaaaaaaaaaaaaaabiiiiiibaaaaaaaaaaaaaaaaaaaaaaaaaaaaaaaaaaaaaaaaaaaaaaaaaaaaaaaaaaaaaaapp
pppaaaaaaaaaaaaaaaaaaaaaaaaaaaaaaaaaaaaaaaaaaaaaaaaaaaaaaaaaaaaaaaariiiiiiraaaaaaaaaaaaaaaaaaaaaaaaaaaaaaaaaaaaaaaaaaaaaaaaaaaaaaaaaaaaaaapp
pppaaaaaaaaaaaaaaaaaaaaaaaaaaaaaaaaaaaaaaaaaaaaaaaaaaaaaaaaaaaaaaaabiiiiiibaaaaaaaaaaaaaaaaaaaaaaaaaaaaaaaaaaaaaaaaaaaaaaaaaaaaaaaaaaaaaaapp
pppaaaaaaaaaaaaaaaaaaaaaaaaaaaaaaaaaaaaaaaaaaaaaaaaaaaaaaaaaaaaaaaabJJJJJJbaaaaaaaaaaaaaaaaaaaaaaaaaaaaaaaaaaaaaaaaaaaaaaaaaaaaaaaaaaaaaaapp
pppaaaaaaaaaaaaaaaaaaaaaaaaaaaaaaaaaaaaaaaaaaaaaaaaaaaaaaaaaaaaaaaabJxxxxJbaaaaaaaaaaaaaaaaaaaaaaaaaaaaaaaaaaaaaaaaaaaaaaaaaaaaaaaaaaaaaaapp
pppaaaaaaaaaaaaaaaaaaaaaaaaaaaaaaaaaaaaaaaaaaaaaaaaaaaaaaaaaaaaaaaabJxxxxJbaaaaaaaaaaaaaaaaaaaaaaaaaaaaaaaaaaaaaaaaaaaaaaaaaaaaaaaaaaaaaaapp
pppaaaaaaaaaaaaaaaaaaaaaaaaaaaaaaaaaaaaaaaaaaaaaaaaaaaaaaaaaaaaaaaabJxxxxJbaaaaaaaaaaaaaaaaaaaaaaaaaaaaaaaaaaaaaaaaaaaaaaaaaaaaaaaaaaaaaaapp
pppaaaaaaaaaaaaaaaaaaaaaaaaaaaaaaaaaaaaaaaaaaaaaaaaaaaaaaaaaaaaaaaabJfxxxJbaaaaaaaaaaaaaaaaaaaaaaaaaaaaaaaaaaaaaaaaaaaaaaaaaaaaaaaaaaaaaaapp
pppaaaaaaaaaaaaaaaaaaaaaaaaaaaaaaaaaaaaaaaaaaaaaaaaaaaaaaaaaaaaaaaabJJxxJJbaaaaaaaaaaaaaaaaaaaaaaaaaaaaaaaaaaaaaaaaaaaaaaaaaaaaaaaaaaaaaaapp
pppaaaaaaaaaaaaaaaaaaaaaaaaaaaaaaaaaaaaaaaaaaaaaaaaaaaaaaaaaaaaaaaaaaaaaaaaaaaaaaaaaaaaaaaaaaaaaaaaaaaaaaaaaaaaaaaaaaaaaaaaaaaaaaaaaaaaaaapp
pppaaaaaaaaaaaaaaaaaaaaaaaaaaaaaaaaaaaaaaaaaaaaaaaaaaaaaaaaaaaaaaaaaaaaaaaaaaaaaaaaaaaaaaaaaaaaaaaaaaaaaaaaaaaaaaaaaaaaaaaaaaaaaaaaaaaaaaapp
pppaaaaaaaaaaaaaaaaaaaaaaaaaaaaaaaaaaaaaaaaaaaaaaaaaaaaaaaaaaaaaaaaaaaaaaaaaaaaaaaaaaaaaaaaaaaaaaaaaaaaaaaaaaaaaaaaaaaaaaaaaaaaaaaaaaaaaaapp
pppaaaaaaaaaaaaaaaaaaaaaaaaaaaaaaaaaaaaaaaaaaaaaaaaaaaaaaaaaaaaaaaaaaaaaaaaaaaaaaaaaaaaaaaaaaaaaaaaaaaaaaaaaaaaaaaaaaaaaaaaaaaaaaaaaaaaaaapp
pppaaaaaaaaaaaaaaaaaaaaaaaaaaaaaaaaaaaaaaaaaaaaaaaaaaaaaaaaaaaaaaaaaaaaaaaaaaaaaaaaaaaaaaaaaaaaaaaaaaaaaaaaaaaaaaaaaaaaaaaaaaaaaaaaaaaaaaapp
pppaaaaaaaaaaaaaaaaaaaaaaaaaaaaaaaaaaaaaaaaaaaaaaaaaaaaaaaaaaaaaaaaaaaaaaaaaaaaaaaaaaaaaaaaaaaaaaaaaaaaaaaaaaaaaaaaaaaaaaaaaaaaaaaaaaaaaaapp
pppaaaaaaaaaaaaaaaaaaaaaaaaaaaaaaaaaaaaaaaaaaaaaaaaaaaaaaaaaaaaaaaaaaaaaaaaaaaaaaaaaaaaaaaaaaaaaaaaaaaaaaaaaaaaaaaaaaaaaaaaaaaaaaaaaaaaaaapp
pppaaaaaaaaaaaaaaaaaaaaaaaaaaaaaaaaaaaaaaaaaaaaaaaaaaaaaaaaaaaaaaaaaaaaaaaaaaaaaaaaaaaaaaaaaaaaaaaaaaaaaaaaaaaaaaaaaaaaaaaaaaaaaaaaaaaaaaapp
pppaaaaaaaaaaaaaaaaaaaaaaaaaaaaaaaaaaaaaaaaaaaaaaaaaaaaaaaaaaaaaaaaaaaaaaaaaaaaaaaaaaaaaaaaaaaaaaaaaaaaaaaaaaaaaaaaaaaaaaaaaaaaaaaaaaaaaaapp
pppaaaaaaaaaaaaaaaaaaaaaaaaaaaaaaaaaaaaaaaaaaaaaaaaaaaaaaaaaaaaaaaaaaaaaaaaaaaaaaaaaaaaaaaaaaaaaaaaaaaaaaaaaaaaaaaaaaaaaaaaaaaaaaaaaaaaaaapp
pppaaaaaaaaaaaaaaaaaaaaaaaaaaaaaaaaaaaaaaaaaaaaaaaaaaaaaaaaaaaaaaaaaaaaaaaaaaaaaaaaaaaaaaaaaaaaaaaaaaaaaaaaaaaaaaaaaaaaaaaaaaaaaaaaaaaaaaapp
pppaaaaaaaaaaaaaaaaaaaaaaaaaaaaaaaaaaaaaaaaaaaaaaaaaaaaaaaaaaaaaaaaaaaaaaaaaaaaaaaaaaaaaaaaaaaaaaaaaaaaaaaaaaaaaaaaaaaaaaaaaaaaaaaaaaaaaaapp
pppaaaaaaaaaaaaaaaaaaaapaaaaaaaaaaaaaaaaaaaapaaaaaaaaaaaaaaaaaaaaaaaaaaaaaaaaaaaaaaaaaaaaaaaaaaaapaaaaaaaaaaaaaaaaaaaapaaaaaaaaaaaaaaaaaaapp
pppaaaaaaaaaaaaaaaaaaaapaaaaaaaaaaaaaaaaaaaapaaaaaaaaaaaaaaaaaaaaaaaaaaaaaaaaaaaaaaaaaaaaaaaaaaaapaaaaaaaaaaaaaaaaaaaapaaaaaaaaaaaaaaaaaaapp
pppuuuuuuuuuuuuuuuuuuuupauuuuuuuuuuuuuuuuuuuupauuuuuuuuuuuuuuuuuuuuaaaaaaaaccccccccccccccccccccapuuuuuuuuuuuuuuuuuuuuapuuuuuuuuuuuuuuuuuuupp
pppuuuuuuuuuuuuuuuuuuuupauuuuuuuuuuuuuuuuuuuupauuuuuuuuuuuuuuuuuuuuaaaaaaaaccccccccccccccccccccapuuuuuuuuuuuuuuuuuuuuapuuuuuuuuuuuuuuuuuuupp
pppuuuuuuuuuuuuuuuuuuuupauuuuuuuuuuuuuuuuuuuupauuuuuuuuuuuuuuuuuuuuaaaaaaaaccccccccccccccccccccapuuuuuuuuuuuuuuuuuuuuapuuuuuuuuuuuuuuuuuuupp
pppuuuuuuuuuuuuuuuuuuuupauuuuuuuuuuuuuuuuuuuupauuuuuuuuuuuuuuuuuuuuaaaaaaaaccccccccccccccccccccapuuuuuuuuuuuuuuuuuuuuapuuuuuuuuuuuuuuuuuuupp
pppuuuuuuuuuuuuuuuuuuuupauuuuuuuuuuuuuuuuuuuupauuuuuuuuuuuuuuuuuuuuaaaaaaaaccccccccccccccccccccapuuuuuuuuuuuuuuuuuuuuapuuuuuuuuuuuuuuuuuuupp
pppuuuuuuuuuuuuuuuuuuuupauuuuuuuuuuuuuuuuuuuupauuuuuuuuuuuuuuuuuuuuaaaaaaaaccccccccccccccccccccapuuuuuuuuuuuuuuuuuuuuapuuuuuuuuuuuuuuuuuuupp
pppuuuuuuuuuuuuuuuuuuuupauuuuuuuuuuuuuuuuuuuupauuuuuuuuuuuuuuuuuuuuaaaaaaaaccccccccccccccccccccapuuuuuuuuuuuuuuuuuuuuapuuuuuuuuuuuuuuuuuuupp
pppuuuuuuuuuuuuuuuuuuuupauuuuuuuuuuuuuuuuuuuupauuuuuuuuuuuuuuuuuuuuaaaaaaaaccccccccccccccccccccapuuuuuuuuuuuuuuuuuuuuapuuuuuuuuuuuuuuuuuuupp
pppuuuuuuuuuuuuuuuuuuuupauuuuuuuuuuuuuuuuuuuupauuuuuuuuuuuuuuuuuuuuaaaaaaaaccccccccccccccccccccapuuuuuuuuuuuuuuuuuuuuapuuuuuuuuuuuuuuuuuuupp
pppuuuuuuuuuuuuuuuuuuuupauuuuuuuuuuuuuuuuuuuupauuuuuuuuuuuuuuuuuuuuaaaaaaaaccccccccccccccccccccapuuuuuuuuuuuuuuuuuuuuapuuuuuuuuuuuuuuuuuuupp
pppuuuuuuuuuuuuuuuuuuuupauuuuuuuuuuuuuuuuuuuupauuuuuuuuuuuuuuuuuuuuaaaaaaaaccccccccccccccccccccapuuuuuuuuuuuuuuuuuuuuapuuuuuuuuuuuuuuuuuuupp
pppuuuuuuuuuuuuuuuuuuuupauuuuuuuuuuuuuuuuuuuupauuuuuuuuuuuuuuuuuuuuaaaaaaaaccccccccccccccccccccapuuuuuuuuuuuuuuuuuuuuapuuuuuuuuuuuuuuuuuuupp
pppuuuuuuuuuuuuuuuuuuuupauuuuuuuuuuuuuuuuuuuupauuuuuuuuuuuuuuuuuuuuaaaaaaaaccccccccccccccccccccapuuuuuuuuuuuuuuuuuuuuapuuuuuuuuuuuuuuuuuuupp
pppuuuuuuuuuuuuuuuuuuuupauuuuuuuuuuuuuuuuuuuupauuuuuuuuuuuuuuuuuuuuaaaaaaaaccccccccccccccccccccapuuuuuuuuuuuuuuuuuuuuapuuuuuuuuuuuuuuuuuuupp
pppuuuuuuuuuuuuuuuuuuuupauuuuuuuuuuuuuuuuuuuupauuuuuuuuuuuuuuuuuuuuaaaaaaaaccccccccccccccccccccapuuuuuuuuuuuuuuuuuuuuapuuuuuuuuuuuuuuuuuuupp
pppuuuuuuuuuuuuuuuuuuuupauuuuuuuuuuuuuuuuuuuupauuuuuuuuuuuuuuuuuuuuaaaaaaaaccccccccccccccccccccapuuuuuuuuuuuuuuuuuuuuapuuuuuuuuuuuuuuuuuuupp
pppuuuuuuuuuuuuuuuuuuuupauuuuuuuuuuuuuuuuuuuupauuuuuuuuuuuuuuuuuuuuaaaaaaaaccccccccccccccccccccapuuuuuuuuuuuuuuuuuuuuapuuuuuuuuuuuuuuuuuuupp
pppuuuuuuuuuuuuuuuuuuuupauuuuuuuuuuuuuuuuuuuupauuuuuuuuuuuuuuuuuuuuaaaaaaaaccccccccccccccccccccapuuuuuuuuuuuuuuuuuuuuapuuuuuuuuuuuuuuuuuuupp
pppuuuuuuuuuuuuuuuuuuuupauuuuuuuuuuuuuuuuuuuupauuuuuuuuuuuuuuuuuuuuaaaaaaaaccccccccccccccccccccapuuuuuuuuuuuuuuuuuuuuapuuuuuuuuuuuuuuuuuuupp
pppuuuuuuuuuuuuuuuuuuuupauuuuuuuuuuuuuuuuuuuupauuuuuuuuuuuuuuuuuuuuaaaaaaaaccccccccccccccccccccapuuuuuuuuuuuuuuuuuuuuapuuuuuuuuuuuuuuuuuuupp
pppuuuuuuuuuuuuuuuuuuuupauuuuuuuuuuuuuuuuuuuupauuuuuuuuuuuuuuuuuuuuaaaaaaaaccccccccccccccccccccapuuuuuuuuuuuuuuuuuuuuapuuuuuuuuuuuuuuuuuuupp
pppuuuuuuuuuuuuuuuuuuuupauuuuuuuuuuuuuuuuuuuupauuuuuuuuuuuuuuuuuuuuaaaaaaaaccccccccccccccccccccapuuuuuuuuuuuuuuuuuuuuapuuuuuuuuuuuuuuuuuuupp
pppuuuuuuuuuuuuuuuuuuuupauuuuuuuuuuuuuuuuuuuupauuuuuuuuuuuuuuuuuuuuaaaaaaaaccccccccccccccccccccapuuuuuuuuuuuuuuuuuuuuapuuuuuuuuuuuuuuuuuuupp
pppaaaaaaaaaaaaaaaaaaaapaaaaaaaaaaaaaaaaaaaapaaaaaaaaaaaaaaaaaaaaaaaaaaaaaaaaaaaaaaaaaaaaaaaaaaaapaaaaaaaaaaaaaaaaaaaapaaaaaaaaaaaaaaaaaaapp
pppaaaaaaaaaaaaaaaaaaaapaaaaaaaaaaaaaaaaaaaapaaaaaaaaaaaaaaaaaaaaaaaaaaaaaaaaaaaaaaaaaaaaaaaaaaaapaaaaaaaaaaaaaaaaaaaapaaaaaaaaaaaaaaaaaaapp
pppaaaaaaaaaaaaaaaaaaaaaaaaaaaaaaaaaaaaaaaaaaaaaaaaaaaaaaaaaaaaaaaaaaaaaaaaaaaaaaaaaaaaaaaaaaaaaaaaaaaaaaaaaaaaaaaaaaaaaaaaaaaaaaaaaaaaaaapp
pppaaaaaaaaaaaaaaaaaaaaaaaaaaaaaaaaaaaaaaaaaaaaaaaaaaaaaaaaaaaaaaaaaaaaaaaaaaaaaaaaaaaaaaaaaaaaaaaaaaaaaaaaaaaaaaaaaaaaaaaaaaaaaaaaaaaaaaapp
pppaaaaaaaaaaaaaaaaaaaaaaaaaaaaaaaaaaaaaaaaaaaaaaaaaaaaaaaaaaccccccccccccccccccccaaaaaaaaaaaaaaaaaaaaaaaaaaaaaaaaaaaaaaaaaaaaaaaaaaaaaaaaapp
pppaaaaaaaaaaaaaaaaaaaaaaaaaaaaaaaaaaaaaaaaaaaaaaaaaaaaaaaaaaccccccccccccccccccccaaaaaaaaaaaaaaaaaaaaaaaaaaaaaaaaaaaaaaaaaaaaaaaaaaaaaaaaapp
pppaaaaaaaaaaaaaaaaaaaaaaaaaaaaaaaaaaaaaaaaaaaaaaaaaaaaaaaaaaccccccccccccccccccccaaaaaaaaaaaaaaaaaaaaaaaaaaaaaaaaaaaaaaaaaaaaaaaaaaaaaaaaapp
pppaaaaaaaaaaaaaaaaaaaaaaaaaaaaaaaaaaaaaaaaaaaaaaaaaaaaaaaaaaccccccccccccccccccccaaaaaaaaaaaaaaaaaaaaaaaaaaaaaaaaaaaaaaaaaaaaaaaaaaaaaaaaapp
pppaaaaaaaaaaaaaaaaaaaaaaaaaaaaaaaaaaaaaaaaaaaaaaaaaaaaaaaaaaccccccccccccccccccccaaaaaaaaaaaaaaaaaaaaaaaaaaaaaaaaaaaaaaaaaaaaaaaaaaaaaaaaapp
pppaaaaaaaaaaaaaaaaaaaaaaaaaaaaaaaaaaaaaaaaaaaaaaaaaaaaaaaaaaccccccccccccccccccccaaaaaaaaaaaaaaaaaaaaaaaaaaaaaaaaaaaaaaaaaaaaaaaaaaaaaaaaapp
pppaaaaaaaaaaaaaaaaaaaaaaaaaaaaaaaaaaaaaaaaaaaaaaaaaaaaaaaaaaccccccccccccccccccccaaaaaaaaaaaaaaaaaaaaaaaaaaaaaaaaaaaaaaaaaaaaaaaaaaaaaaaaapp
pppaaaaaaaaaaaaaaaaaaaaaaaaaaaaaaaaaaaaaaaaaaaaaaaaaaaaaaaaaaccccccccccccccccccccaaaaaaaaaaaaaaaaaaaaaaaaaaaaaaaaaaaaaaaaaaaaaaaaaaaaaaaaapp
pppaaaaaaaaaaaaaaaaaaaaaaaaaaaaaaaaaaaaaaaaaaaaaaaaaaaaaaaaaaccccccccccccccccccccaaaaaaaaaaaaaaaaaaaaaaaaaaaaaaaaaaaaaaaaaaaaaaaaaaaaaaaaapp
pppaaaaaaaaaaaaaaaaaaaaaaaaaaaaaaaaaaaaaaaaaaaaaaaaaaaaaaaaaaccccccccccccccccccccaaaaaaaaaaaaaaaaaaaaaaaaaaaaaaaaaaaaaaaaaaaaaaaaaaaaaaaaapp
pppaaaaaaaaaaaaaaaaaaaaaaaaaaaaaaaaaaaaaaaaaaaaaaaaaaaaaaaaaaccccccccccccccccccccaaaaaaaaaaaaaaaaaaaaaaaaaaaaaaaaaaaaaaaaaaaaaaaaaaaaaaaaapp
pppaaaaaaaaaaaaaaaaaaaaaaaaaaaaaaaaaaaaaaaaaaaaaaaaaaaaaaaaaaccccccccccccccccccccaaaaaaaaaaaaaaaaaaaaaaaaaaaaaaaaaaaaaaaaaaaaaaaaaaaaaaaaapp
pppppppppppppppppppppppppppppppppppppppppppppppppppppppppppppccccccccccccccccccccppppppppppppppppppppppppppppppppppppppppppppppppppppppppppp
pppppppppppppppppppppppppppppppppppppppppppppppppppppppppppppccccccccccccccccccccppppppppppppppppppppppppppppppppppppppppppppppppppppppppppp
pppppppppppppppppppppppppppppppppppppppppppppppppppppppppppppccccccccccccccccccccppppppppppppppppppppppppppppppppppppppppppppppppppppppppppp
pppppppppppppppppppppppppppppppppppppppppppppppppppppppppppppccccccccccccccccccccppppppppppppppppppppppppppppppppppppppppppppppppppppppppppp
pppppppppppppppppppppppppppppppppppppppppppppppppppppppppppppccccccccccccccccccccppppppppppppppppppppppppppppppppppppppppppppppppppppppppppp
pppppppppppppppppppppppppppppppppppppppppppppppppppppppppppppccccccccccccccccccccppppppppppppppppppppppppppppppppppppppppppppppppppppppppppp
pppppppppppppppppppppppppppppppppppppppppppppppppppppppppppppccccccccccccccccccccppppppppppppppppppppppppppppppppppppppppppppppppppppppppppp
pppppppppppppppppppppppppppppppppppppppppppppppppppppppppppppccccccccccccccccccccppppppppppppppppppppppppppppppppppppppppppppppppppppppppppp
pppppppppppppppppppppppppppppppppppppppppppppppppppppppppppppccccccccccccccccccccppppppppppppppppppppppppppppppppppppppppppppppppppppppppppp
pppppppppppppppppppppppppppppppppppppppppppppppppppppppppppppccccccccccccccccccccppppppppppppppppppppppppppppppppppppppppppppppppppppppppppp
pppppppppppppppppppppppppppppppppppppppppppppppppppppppppppppccccccccccccccccccccppppppppppppppppppppppppppppppppppppppppppppppppppppppppppp
pppppppppppppppppppppppppppppppppppppppppppppppppppppppppppppppppppppppppppppppppppppppppppppppppppppppppppppppppppppppppppppppppppppppppppp
pppppppppppppppppppppppppppppppppppppppppppppppppppppppppppppppppppppppppppppppppppppppppppppppppppppppppppppppppppppppppppppppppppppppppppp
pppppppppppppppppppppppppppppppppppppppppppppppppppppppppppppppppppppppppppppppppppppppppppppppppppppppppppppppppppppppppppppppppppppppppppp
pppppppppppppppppppppppppppppppppppppppppppppppppppppppppppppppppppppppppppppppppppppppppppppppppppppppppppppppppppppppppppppppppppppppppppp
"}
