//MAP CONVERTED BY dmm2tgm.py THIS HEADER COMMENT PREVENTS RECONVERSION, DO NOT REMOVE
"a" = (
/turf/template_noop,
/area/template_noop)
"b" = (
/turf/template_noop,
/area/submap/virgo2/Rocky1)
"c" = (
/turf/simulated/mineral/floor/ignore_mapgen/virgo2,
/area/submap/virgo2/Rocky1)
"d" = (
/obj/structure/boulder,
/turf/simulated/mineral/floor/ignore_mapgen/virgo2,
/area/submap/virgo2/Rocky1)
"e" = (
/turf/simulated/mineral/ignore_mapgen/virgo2,
/area/submap/virgo2/Rocky1)
"g" = (
/obj/random/handgun/sec,
/obj/effect/decal/remains/human,
/obj/item/weapon/storage/secure/briefcase/money,
/turf/simulated/mineral/floor/ignore_mapgen/virgo2,
/area/submap/virgo2/Rocky1)

(1,1,1) = {"
a
a
a
a
a
a
a
a
a
a
a
a
a
a
a
a
a
a
a
a
a
a
a
a
a
"}
(2,1,1) = {"
a
a
a
a
a
a
a
a
a
a
a
a
a
a
a
a
a
a
a
a
a
a
a
a
a
"}
(3,1,1) = {"
a
a
b
b
b
b
b
b
b
b
b
b
b
b
b
b
b
b
b
b
b
b
b
a
a
"}
(4,1,1) = {"
a
a
b
b
c
c
b
b
b
b
b
b
b
b
b
c
c
c
b
b
b
b
b
a
a
"}
(5,1,1) = {"
a
a
b
c
c
c
c
c
b
b
b
b
b
b
c
c
e
e
c
b
b
b
b
a
a
"}
(6,1,1) = {"
a
a
b
c
e
e
e
c
c
b
b
c
c
c
c
e
e
e
c
c
b
b
b
a
a
"}
(7,1,1) = {"
a
a
b
d
e
e
e
c
b
b
b
b
c
e
e
e
e
e
e
c
b
b
b
a
a
"}
(8,1,1) = {"
a
a
b
e
e
e
e
c
b
c
c
b
c
e
e
e
c
c
c
c
b
b
b
a
a
"}
(9,1,1) = {"
a
a
b
b
c
c
d
c
c
c
c
c
c
e
e
c
c
b
b
c
b
b
b
a
a
"}
(10,1,1) = {"
a
a
b
b
b
c
c
c
c
c
c
c
c
e
e
c
b
b
b
b
b
b
b
a
a
"}
(11,1,1) = {"
a
a
b
b
b
b
c
c
b
c
c
c
e
e
e
b
b
b
b
b
b
b
b
a
a
"}
(12,1,1) = {"
a
a
b
b
b
b
b
b
b
b
c
c
e
e
e
b
b
b
b
b
b
b
b
a
a
"}
(13,1,1) = {"
a
a
b
b
b
b
b
b
b
b
b
c
e
e
e
e
b
b
b
b
b
b
b
a
a
"}
(14,1,1) = {"
a
a
b
b
b
b
b
b
b
b
b
c
e
e
e
e
b
b
b
b
b
b
b
a
a
"}
(15,1,1) = {"
a
a
b
b
b
b
b
c
c
c
b
c
e
e
e
e
b
b
b
b
b
b
b
a
a
"}
(16,1,1) = {"
a
a
b
b
b
b
c
c
c
c
c
c
e
e
e
b
b
b
b
b
b
b
b
a
a
"}
(17,1,1) = {"
a
a
b
b
b
c
c
c
c
c
c
c
c
e
e
b
b
b
b
b
b
b
b
a
a
"}
(18,1,1) = {"
a
a
b
b
e
c
c
c
c
c
c
c
d
e
b
b
b
b
b
b
b
b
b
a
a
"}
(19,1,1) = {"
a
a
b
e
e
d
c
c
c
c
d
e
e
e
b
b
b
b
b
b
b
b
b
a
a
"}
(20,1,1) = {"
a
a
b
e
e
e
c
g
c
e
e
e
e
b
b
b
b
b
b
b
b
b
b
a
a
"}
(21,1,1) = {"
a
a
b
e
e
e
e
e
e
e
e
e
e
b
b
b
b
b
b
b
b
b
b
a
a
"}
(22,1,1) = {"
a
a
b
e
e
e
e
e
e
e
e
e
e
b
b
b
b
b
b
b
b
b
b
a
a
"}
(23,1,1) = {"
a
a
b
b
b
e
e
e
e
e
e
e
b
b
b
b
b
b
b
b
b
b
b
a
a
"}
(24,1,1) = {"
a
a
a
a
a
a
a
a
a
a
a
a
a
a
a
a
a
a
a
a
a
a
a
a
a
"}
(25,1,1) = {"
a
a
a
a
a
a
a
a
a
a
a
a
a
a
a
a
a
a
a
a
a
a
a
a
a
"}
