//MAP CONVERTED BY dmm2tgm.py THIS HEADER COMMENT PREVENTS RECONVERSION, DO NOT REMOVE
"a" = (
/turf/simulated/wall/titanium,
/area/mine/explored/underdark)
"b" = (
/turf/simulated/mineral/ignore_cavegen/virgo3b,
/area/mine/explored/underdark)
"c" = (
/obj/structure/closet/crate/mimic/dangerous,
/obj/random/multiple/underdark/treasure,
/turf/simulated/floor/tiled/freezer/virgo3b,
/area/mine/explored/underdark)
"d" = (
/turf/simulated/floor/tiled/freezer/virgo3b,
/area/mine/explored/underdark)
"e" = (
/obj/structure/closet/crate/mimic,
/obj/random/underdark,
/turf/simulated/floor/tiled/freezer/virgo3b,
/area/mine/explored/underdark)
"f" = (
/obj/structure/simple_door/silver,
/turf/simulated/floor/tiled/freezer/virgo3b,
/area/mine/explored/underdark)

(1,1,1) = {"
a
a
a
a
a
"}
(2,1,1) = {"
a
c
d
d
a
"}
(3,1,1) = {"
a
d
d
d
f
"}
(4,1,1) = {"
b
b
e
d
a
"}
(5,1,1) = {"
b
b
b
a
a
"}
