//MAP CONVERTED BY dmm2tgm.py THIS HEADER COMMENT PREVENTS RECONVERSION, DO NOT REMOVE
"a" = (
/obj/machinery/light/bigfloorlamp,
/turf/template_noop,
/area/submap/groundbase/poi/wildvillage)
"k" = (
/obj/structure/bed/chair/sofa/bench/left{
	dir = 8
	},
/turf/simulated/floor/outdoors/grass/seasonal/notrees_nomobs,
/area/submap/groundbase/poi/wildvillage/long/long1)
"l" = (
/obj/structure/bed/chair/sofa/bench/left{
	dir = 4
	},
/turf/simulated/floor/outdoors/grass/seasonal/notrees_nomobs,
/area/submap/groundbase/poi/wildvillage/long/long1)
"m" = (
/turf/simulated/floor/outdoors/grass/seasonal/dark,
/area/submap/groundbase/poi/wildvillage/long/long1)
"t" = (
/turf/simulated/floor/outdoors/grass/seasonal/notrees_nomobs,
/area/submap/groundbase/poi/wildvillage/long/long1)
"z" = (
/turf/simulated/floor/outdoors/newdirt,
/area/submap/groundbase/poi/wildvillage/long/long1)
"E" = (
/turf/simulated/floor/water,
/area/submap/groundbase/poi/wildvillage/long/long1)
"L" = (
/obj/structure/bed/chair/sofa/bench/right{
	dir = 4
	},
/turf/simulated/floor/outdoors/grass/seasonal/notrees_nomobs,
/area/submap/groundbase/poi/wildvillage/long/long1)
"M" = (
/turf/simulated/floor/outdoors/newdirt,
/area/submap/groundbase/poi/wildvillage)
"P" = (
/turf/template_noop,
/area/submap/groundbase/poi/wildvillage)
"S" = (
/obj/structure/bed/chair/sofa/bench/right{
	dir = 8
	},
/turf/simulated/floor/outdoors/grass/seasonal/notrees_nomobs,
/area/submap/groundbase/poi/wildvillage/long/long1)
"T" = (
/obj/machinery/light/bigfloorlamp,
/turf/simulated/floor/outdoors/grass/seasonal/notrees_nomobs,
/area/submap/groundbase/poi/wildvillage/long/long1)

(1,1,1) = {"
a
P
P
P
P
P
P
P
P
P
M
M
M
P
P
P
P
P
P
P
P
P
P
a
"}
(2,1,1) = {"
P
t
t
t
t
t
t
t
t
t
t
z
t
t
t
t
t
t
t
t
t
t
t
P
"}
(3,1,1) = {"
P
t
m
m
m
m
m
m
m
m
t
z
t
m
m
m
m
m
m
m
m
m
t
P
"}
(4,1,1) = {"
P
t
m
m
m
m
m
m
m
m
t
z
t
m
m
m
m
m
m
m
m
m
t
P
"}
(5,1,1) = {"
P
t
m
m
m
m
m
m
m
m
t
z
t
m
m
m
m
m
m
m
m
m
t
P
"}
(6,1,1) = {"
P
t
m
m
m
m
m
T
l
L
t
z
t
l
L
T
m
m
m
m
m
m
t
P
"}
(7,1,1) = {"
P
t
m
m
m
m
m
t
z
z
z
z
z
z
z
t
m
m
m
m
m
m
t
P
"}
(8,1,1) = {"
M
t
t
t
t
t
t
t
z
E
E
E
E
E
z
t
t
t
t
t
t
t
t
M
"}
(9,1,1) = {"
M
z
z
z
z
z
z
z
z
E
E
E
E
E
z
z
z
z
z
z
z
z
z
M
"}
(10,1,1) = {"
M
t
t
t
t
t
t
t
z
E
E
E
E
E
z
t
t
t
t
t
t
t
t
M
"}
(11,1,1) = {"
P
t
m
m
m
m
m
t
z
z
z
z
z
z
z
t
m
m
m
m
m
m
t
P
"}
(12,1,1) = {"
P
t
m
m
m
m
m
T
S
k
t
z
t
S
k
T
m
m
m
m
m
m
t
P
"}
(13,1,1) = {"
P
t
m
m
m
m
m
m
m
m
t
z
t
m
m
m
m
m
m
m
m
m
t
P
"}
(14,1,1) = {"
P
t
m
m
m
m
m
m
m
m
t
z
t
m
m
m
m
m
m
m
m
m
t
P
"}
(15,1,1) = {"
P
t
m
m
m
m
m
m
m
m
t
z
t
m
m
m
m
m
m
m
m
m
t
P
"}
(16,1,1) = {"
P
t
t
t
t
t
t
t
t
t
t
z
t
t
t
t
t
t
t
t
t
t
t
P
"}
(17,1,1) = {"
a
P
P
P
P
P
P
P
P
P
M
M
M
P
P
P
P
P
P
P
P
P
P
a
"}
