//MAP CONVERTED BY dmm2tgm.py THIS HEADER COMMENT PREVENTS RECONVERSION, DO NOT REMOVE
"a" = (
/obj/machinery/light/bigfloorlamp,
/turf/template_noop,
/area/submap/groundbase/poi/wildvillage)
"j" = (
/obj/item/weapon/beach_ball/dodgeball,
/turf/simulated/floor/outdoors/newdirt/virgo3c,
/area/submap/groundbase/poi/wildvillage/long/long4)
"s" = (
/turf/simulated/floor/outdoors/newdirt/virgo3c,
/area/submap/groundbase/poi/wildvillage)
"x" = (
/turf/template_noop,
/area/submap/groundbase/poi/wildvillage)
"H" = (
/turf/simulated/floor/outdoors/grass/virgo3c,
/area/submap/groundbase/poi/wildvillage/long/long4)
"J" = (
/turf/simulated/floor/outdoors/newdirt/virgo3c,
/area/submap/groundbase/poi/wildvillage/long/long4)

(1,1,1) = {"
a
x
x
x
x
x
x
x
x
x
x
s
s
s
x
x
x
x
x
x
x
x
x
a
"}
(2,1,1) = {"
x
H
H
H
H
H
H
H
H
H
H
H
J
H
H
H
H
H
H
H
H
H
H
x
"}
(3,1,1) = {"
x
H
J
J
J
H
H
H
H
H
H
H
J
H
H
H
H
H
H
J
J
J
H
x
"}
(4,1,1) = {"
x
H
J
H
H
H
H
H
H
H
H
H
J
H
H
H
H
H
H
H
H
J
H
x
"}
(5,1,1) = {"
x
H
J
H
H
H
H
H
H
H
H
H
J
H
H
H
H
H
H
H
H
J
H
x
"}
(6,1,1) = {"
x
H
H
H
H
H
H
H
H
H
H
H
J
H
H
H
H
H
H
H
H
H
H
x
"}
(7,1,1) = {"
x
H
H
H
H
H
H
H
H
H
H
H
J
H
H
H
H
H
H
H
H
H
H
x
"}
(8,1,1) = {"
x
H
H
H
H
H
H
H
H
H
H
J
J
J
H
H
H
H
H
H
H
H
H
x
"}
(9,1,1) = {"
x
H
H
H
H
H
H
H
H
H
H
J
j
J
H
H
H
H
H
H
H
H
H
x
"}
(10,1,1) = {"
x
H
H
H
H
H
H
H
H
H
H
J
J
J
H
H
H
H
H
H
H
H
H
x
"}
(11,1,1) = {"
x
H
H
H
H
H
H
H
H
H
H
H
J
H
H
H
H
H
H
H
H
H
H
x
"}
(12,1,1) = {"
x
H
H
H
H
H
H
H
H
H
H
H
J
H
H
H
H
H
H
H
H
H
H
x
"}
(13,1,1) = {"
x
H
J
H
H
H
H
H
H
H
H
H
J
H
H
H
H
H
H
H
H
J
H
x
"}
(14,1,1) = {"
x
H
J
H
H
H
H
H
H
H
H
H
J
H
H
H
H
H
H
H
H
J
H
x
"}
(15,1,1) = {"
x
H
J
J
J
H
H
H
H
H
H
H
J
H
H
H
H
H
H
J
J
J
H
x
"}
(16,1,1) = {"
x
H
H
H
H
H
H
H
H
H
H
H
J
H
H
H
H
H
H
H
H
H
H
x
"}
(17,1,1) = {"
a
x
x
x
x
x
x
x
x
x
x
s
s
s
x
x
x
x
x
x
x
x
x
a
"}
