//MAP CONVERTED BY dmm2tgm.py THIS HEADER COMMENT PREVENTS RECONVERSION, DO NOT REMOVE
"a" = (
/obj/machinery/light/bigfloorlamp,
/turf/template_noop,
/area/submap/groundbase/poi/wildvillage)
"w" = (
/turf/simulated/floor/outdoors/grass/seasonal/notrees_nomobs,
/area/submap/groundbase/poi/wildvillage/long/long3)
"F" = (
/turf/simulated/floor/water,
/area/submap/groundbase/poi/wildvillage/long/long3)
"Q" = (
/turf/template_noop,
/area/submap/groundbase/poi/wildvillage)
"Z" = (
/turf/simulated/floor/outdoors/grass/seasonal/dark,
/area/submap/groundbase/poi/wildvillage/long/long3)

(1,1,1) = {"
a
Q
Q
Q
Q
Q
Q
Q
Q
Q
Q
Q
Q
Q
Q
Q
Q
Q
Q
Q
Q
Q
Q
a
"}
(2,1,1) = {"
Q
w
w
w
w
w
w
w
w
w
w
w
w
w
w
w
w
w
w
w
w
w
w
Q
"}
(3,1,1) = {"
Q
w
w
w
w
w
w
w
w
w
w
w
w
Z
Z
Z
Z
w
w
w
w
w
w
Q
"}
(4,1,1) = {"
Q
w
w
Z
w
w
w
Z
Z
w
w
w
w
w
w
w
w
w
w
w
Z
w
w
Q
"}
(5,1,1) = {"
Q
w
w
Z
Z
w
w
Z
Z
w
w
Z
Z
Z
Z
Z
Z
w
w
Z
Z
w
w
Q
"}
(6,1,1) = {"
Q
w
w
Z
Z
w
w
Z
w
w
w
w
w
Z
Z
Z
Z
Z
w
Z
Z
w
w
Q
"}
(7,1,1) = {"
Q
w
w
Z
Z
Z
w
w
w
Z
Z
Z
w
w
Z
Z
w
Z
w
Z
Z
w
w
Q
"}
(8,1,1) = {"
Q
w
w
Z
Z
Z
w
w
Z
Z
Z
F
F
w
w
Z
Z
Z
w
Z
Z
w
w
Q
"}
(9,1,1) = {"
Q
w
w
w
Z
Z
w
w
Z
Z
F
F
F
F
w
w
Z
Z
w
Z
Z
w
w
Q
"}
(10,1,1) = {"
Q
w
w
w
Z
Z
Z
w
w
Z
Z
F
F
w
w
w
Z
Z
Z
Z
Z
w
w
Q
"}
(11,1,1) = {"
Q
w
w
w
w
Z
Z
Z
w
w
w
Z
Z
w
Z
w
Z
Z
Z
Z
Z
w
w
Q
"}
(12,1,1) = {"
Q
w
Z
Z
w
Z
Z
Z
Z
Z
w
w
w
w
w
w
Z
Z
Z
Z
Z
w
w
Q
"}
(13,1,1) = {"
Q
w
Z
Z
w
w
w
Z
Z
Z
Z
Z
Z
Z
w
w
w
Z
Z
Z
Z
w
w
Q
"}
(14,1,1) = {"
Q
w
Z
Z
Z
w
w
w
w
w
w
w
w
w
w
Z
Z
Z
w
w
w
w
w
Q
"}
(15,1,1) = {"
Q
w
w
Z
Z
Z
w
w
Z
Z
Z
Z
w
w
w
w
w
w
w
w
w
w
w
Q
"}
(16,1,1) = {"
Q
w
w
w
w
w
w
w
w
w
w
w
w
w
w
w
w
w
w
w
w
w
w
Q
"}
(17,1,1) = {"
a
Q
Q
Q
Q
Q
Q
Q
Q
Q
Q
Q
Q
Q
Q
Q
Q
Q
Q
Q
Q
Q
Q
a
"}
