//MAP CONVERTED BY dmm2tgm.py THIS HEADER COMMENT PREVENTS RECONVERSION, DO NOT REMOVE
"a" = (
/turf/template_noop,
/area/submap/groundbase/poi/wildvillage/square/square2)
"b" = (
/turf/simulated/floor/outdoors/sidewalk/side/virgo3c,
/area/submap/groundbase/poi/wildvillage/square/square2)
"c" = (
/obj/structure/undies_wardrobe,
/turf/simulated/floor/carpet,
/area/submap/groundbase/poi/wildvillage/square/square2)
"d" = (
/obj/structure/bed/chair/office/light{
	dir = 4
	},
/turf/simulated/floor/wood/virgo3c{
	edge_blending_priority = -1;
	outdoors = 0
	},
/area/submap/groundbase/poi/wildvillage/square/square2)
"e" = (
/obj/structure/bed/double/padded,
/obj/item/weapon/bedsheet/browndouble,
/obj/structure/curtain/open/bed{
	color = "#5e0c1d"
	},
/turf/simulated/floor/carpet,
/area/submap/groundbase/poi/wildvillage/square/square2)
"f" = (
/obj/structure/bed/chair/sofa/brown{
	dir = 4
	},
/turf/simulated/floor/wood/virgo3c{
	edge_blending_priority = -1;
	outdoors = 0
	},
/area/submap/groundbase/poi/wildvillage/square/square2)
"j" = (
/obj/structure/simple_door/iron,
/turf/simulated/floor/tiled/steel_ridged,
/area/submap/groundbase/poi/wildvillage/square/square2)
"k" = (
/turf/simulated/floor/outdoors/newdirt/virgo3c,
/area/submap/groundbase/poi/wildvillage/square/square2)
"n" = (
/obj/structure/table/standard,
/obj/random/maintenance/misc,
/obj/random/maintenance/misc,
/turf/simulated/floor/carpet,
/area/submap/groundbase/poi/wildvillage/square/square2)
"p" = (
/obj/structure/simple_door/iron,
/turf/simulated/floor/bmarble,
/area/submap/groundbase/poi/wildvillage/square/square2)
"s" = (
/obj/structure/table/standard,
/obj/random/maintenance/misc,
/obj/random/maintenance/misc,
/turf/simulated/floor/wood/virgo3c{
	edge_blending_priority = -1;
	outdoors = 0
	},
/area/submap/groundbase/poi/wildvillage/square/square2)
"u" = (
/obj/structure/bed/chair/sofa/left/brown{
	dir = 4
	},
/turf/simulated/floor/wood/virgo3c{
	edge_blending_priority = -1;
	outdoors = 0
	},
/area/submap/groundbase/poi/wildvillage/square/square2)
"v" = (
/turf/simulated/wall,
/area/submap/groundbase/poi/wildvillage/square/square2)
"A" = (
/obj/structure/table/standard,
/turf/simulated/floor/carpet,
/area/submap/groundbase/poi/wildvillage/square/square2)
"B" = (
/turf/simulated/floor/wood/virgo3c{
	edge_blending_priority = -1;
	outdoors = 0
	},
/area/submap/groundbase/poi/wildvillage/square/square2)
"D" = (
/turf/simulated/floor/carpet,
/area/submap/groundbase/poi/wildvillage/square/square2)
"H" = (
/obj/structure/bed/chair/sofa/right/brown{
	dir = 4
	},
/turf/simulated/floor/wood/virgo3c{
	edge_blending_priority = -1;
	outdoors = 0
	},
/area/submap/groundbase/poi/wildvillage/square/square2)
"O" = (
/turf/simulated/floor/outdoors/grass/virgo3c,
/area/submap/groundbase/poi/wildvillage/square/square2)
"U" = (
/obj/structure/bed/chair/comfy/black{
	dir = 8
	},
/turf/simulated/floor/wood/virgo3c{
	edge_blending_priority = -1;
	outdoors = 0
	},
/area/submap/groundbase/poi/wildvillage/square/square2)
"Z" = (
/obj/structure/grille,
/obj/structure/window/reinforced/full,
/turf/simulated/floor,
/area/submap/groundbase/poi/wildvillage/square/square2)

(1,1,1) = {"
a
a
a
a
a
a
a
a
a
a
a
a
"}
(2,1,1) = {"
a
v
v
v
v
v
v
v
O
O
O
a
"}
(3,1,1) = {"
a
v
n
D
D
D
A
v
O
O
O
a
"}
(4,1,1) = {"
a
v
n
D
D
D
e
v
O
O
O
a
"}
(5,1,1) = {"
a
v
n
D
D
D
c
v
v
v
v
a
"}
(6,1,1) = {"
a
v
v
v
j
v
v
v
s
s
v
a
"}
(7,1,1) = {"
a
v
B
B
B
u
f
H
B
B
Z
a
"}
(8,1,1) = {"
a
Z
B
B
B
B
B
B
B
B
Z
a
"}
(9,1,1) = {"
a
Z
d
B
B
B
B
B
B
U
v
a
"}
(10,1,1) = {"
a
v
s
s
v
v
v
p
v
v
v
a
"}
(11,1,1) = {"
a
v
v
v
v
O
k
b
k
O
O
a
"}
(12,1,1) = {"
a
a
a
a
a
a
a
b
a
a
a
a
"}
