//MAP CONVERTED BY dmm2tgm.py THIS HEADER COMMENT PREVENTS RECONVERSION, DO NOT REMOVE
"a" = (
/turf/template_noop,
/area/submap/groundbase/poi/wildvillage/square/square4)
"n" = (
/turf/simulated/floor/wood/virgo3c{
	edge_blending_priority = -1;
	outdoors = 0
	},
/area/submap/groundbase/poi/wildvillage/square/square4)
"r" = (
/turf/simulated/floor/outdoors/sidewalk/side/virgo3c,
/area/submap/groundbase/poi/wildvillage/square/square4)
"v" = (
/turf/simulated/wall,
/area/submap/groundbase/poi/wildvillage/square/square4)
"w" = (
/obj/structure/simple_door/iron,
/turf/simulated/floor/tiled/steel_ridged,
/area/submap/groundbase/poi/wildvillage/square/square4)
"G" = (
/obj/structure/simple_door/iron,
/turf/simulated/floor/bmarble,
/area/submap/groundbase/poi/wildvillage/square/square4)
"U" = (
/turf/simulated/floor/outdoors/newdirt/virgo3c,
/area/submap/groundbase/poi/wildvillage/square/square4)

(1,1,1) = {"
a
a
a
a
U
r
U
a
a
a
a
a
"}
(2,1,1) = {"
a
v
v
v
v
G
v
v
v
v
v
a
"}
(3,1,1) = {"
a
v
n
n
n
n
n
n
n
n
v
a
"}
(4,1,1) = {"
a
v
n
n
n
n
n
n
n
n
v
a
"}
(5,1,1) = {"
a
v
n
n
n
n
n
n
n
n
v
a
"}
(6,1,1) = {"
a
v
n
n
n
n
n
n
n
n
v
a
"}
(7,1,1) = {"
a
v
v
w
v
v
v
w
v
v
v
a
"}
(8,1,1) = {"
a
v
n
n
n
v
n
n
n
v
a
a
"}
(9,1,1) = {"
a
v
n
n
n
v
n
n
n
v
a
a
"}
(10,1,1) = {"
a
v
n
n
n
v
n
n
n
v
a
a
"}
(11,1,1) = {"
a
v
v
v
v
v
v
v
v
v
a
a
"}
(12,1,1) = {"
a
a
a
a
a
a
a
a
a
a
a
a
"}
