//MAP CONVERTED BY dmm2tgm.py THIS HEADER COMMENT PREVENTS RECONVERSION, DO NOT REMOVE
"a" = (
/turf/template_noop,
/area/submap/groundbase/poi/wildvillage/square/square6)
"j" = (
/obj/structure/fence{
	dir = 4
	},
/turf/simulated/floor/outdoors/grass/virgo3c,
/area/submap/groundbase/poi/wildvillage/square/square6)
"l" = (
/obj/structure/fence/corner,
/turf/simulated/floor/outdoors/grass/virgo3c,
/area/submap/groundbase/poi/wildvillage/square/square6)
"n" = (
/turf/simulated/floor/outdoors/grass/virgo3c,
/area/submap/groundbase/poi/wildvillage/square/square6)
"p" = (
/obj/structure/fence/corner{
	dir = 5
	},
/turf/simulated/floor/outdoors/grass/virgo3c,
/area/submap/groundbase/poi/wildvillage/square/square6)
"s" = (
/obj/structure/fence/corner{
	dir = 10
	},
/turf/simulated/floor/outdoors/grass/virgo3c,
/area/submap/groundbase/poi/wildvillage/square/square6)
"v" = (
/obj/structure/fence/corner{
	dir = 8
	},
/turf/simulated/floor/outdoors/grass/virgo3c,
/area/submap/groundbase/poi/wildvillage/square/square6)
"y" = (
/obj/structure/fence/door,
/turf/simulated/floor/outdoors/grass/virgo3c,
/area/submap/groundbase/poi/wildvillage/square/square6)
"A" = (
/obj/structure/fence,
/turf/simulated/floor/outdoors/grass/virgo3c,
/area/submap/groundbase/poi/wildvillage/square/square6)
"B" = (
/obj/structure/sink/puddle,
/turf/simulated/floor/outdoors/grass/virgo3c,
/area/submap/groundbase/poi/wildvillage/square/square6)
"M" = (
/obj/machinery/portable_atmospherics/hydroponics/soil,
/turf/simulated/floor/outdoors/newdirt/virgo3c,
/area/submap/groundbase/poi/wildvillage/square/square6)
"N" = (
/obj/item/weapon/material/minihoe,
/turf/simulated/floor/outdoors/grass/virgo3c,
/area/submap/groundbase/poi/wildvillage/square/square6)
"R" = (
/obj/item/weapon/reagent_containers/glass/bucket/wood,
/turf/simulated/floor/outdoors/grass/virgo3c,
/area/submap/groundbase/poi/wildvillage/square/square6)
"Z" = (
/obj/random/mob/semirandom_mob_spawner/animal,
/turf/simulated/floor/outdoors/grass/virgo3c,
/area/submap/groundbase/poi/wildvillage/square/square6)

(1,1,1) = {"
a
a
a
a
a
a
a
a
a
a
a
a
"}
(2,1,1) = {"
a
v
A
A
A
A
A
A
A
A
s
a
"}
(3,1,1) = {"
a
j
n
n
B
M
M
n
n
n
j
a
"}
(4,1,1) = {"
a
j
n
Z
n
n
n
n
Z
n
j
a
"}
(5,1,1) = {"
a
y
n
n
n
n
n
n
n
n
y
a
"}
(6,1,1) = {"
a
j
n
n
n
n
n
n
n
n
j
a
"}
(7,1,1) = {"
a
j
n
n
n
n
n
n
n
n
j
a
"}
(8,1,1) = {"
a
y
n
n
n
n
n
n
n
n
y
a
"}
(9,1,1) = {"
a
j
n
Z
n
n
n
n
Z
n
j
a
"}
(10,1,1) = {"
a
j
n
n
N
M
M
R
n
n
j
a
"}
(11,1,1) = {"
a
p
A
A
A
A
A
A
A
A
l
a
"}
(12,1,1) = {"
a
a
a
a
a
a
a
a
a
a
a
a
"}
