//MAP CONVERTED BY dmm2tgm.py THIS HEADER COMMENT PREVENTS RECONVERSION, DO NOT REMOVE
"a" = (
/turf/template_noop,
/area/submap/groundbase/poi/wildvillage/square/square1)
"b" = (
/obj/structure/undies_wardrobe,
/turf/simulated/floor/carpet,
/area/submap/groundbase/poi/wildvillage/square/square1)
"d" = (
/obj/structure/bed/double/padded,
/obj/item/weapon/bedsheet/browndouble,
/obj/structure/curtain/open/bed{
	color = "#5e0c1d"
	},
/turf/simulated/floor/carpet,
/area/submap/groundbase/poi/wildvillage/square/square1)
"h" = (
/obj/random/maintenance/misc,
/obj/random/maintenance/misc,
/obj/random/maintenance/misc,
/obj/random/maintenance/misc,
/obj/random/maintenance/misc,
/obj/structure/table/standard,
/turf/simulated/floor/carpet,
/area/submap/groundbase/poi/wildvillage/square/square1)
"k" = (
/obj/structure/table/standard,
/obj/random/maintenance/misc,
/obj/random/maintenance/misc,
/turf/simulated/floor/wood/virgo3c{
	edge_blending_priority = -1;
	outdoors = 0
	},
/area/submap/groundbase/poi/wildvillage/square/square1)
"l" = (
/turf/simulated/floor/outdoors/newdirt/virgo3c,
/area/submap/groundbase/poi/wildvillage/square/square1)
"m" = (
/obj/structure/curtain/black{
	pixel_x = 32
	},
/turf/simulated/floor/wood/virgo3c{
	edge_blending_priority = -1;
	outdoors = 0
	},
/area/submap/groundbase/poi/wildvillage/square/square1)
"n" = (
/obj/structure/table/rack/steel,
/obj/random/maintenance/misc,
/obj/random/maintenance/misc,
/obj/random/maintenance/misc,
/obj/random/maintenance/misc,
/obj/random/maintenance/misc,
/turf/simulated/floor/wood/virgo3c{
	edge_blending_priority = -1;
	outdoors = 0
	},
/area/submap/groundbase/poi/wildvillage/square/square1)
"p" = (
/obj/structure/table/standard,
/obj/item/device/flashlight/lamp/green,
/turf/simulated/floor/carpet,
/area/submap/groundbase/poi/wildvillage/square/square1)
"r" = (
/obj/structure/bed/chair/sofa/left/brown,
/obj/structure/curtain/black{
	pixel_y = 32
	},
/turf/simulated/floor/wood/virgo3c{
	edge_blending_priority = -1;
	outdoors = 0
	},
/area/submap/groundbase/poi/wildvillage/square/square1)
"s" = (
/turf/simulated/floor/outdoors/sidewalk/virgo3c,
/area/submap/groundbase/poi/wildvillage/square/square1)
"t" = (
/turf/simulated/floor/carpet,
/area/submap/groundbase/poi/wildvillage/square/square1)
"v" = (
/turf/simulated/wall,
/area/submap/groundbase/poi/wildvillage/square/square1)
"w" = (
/obj/structure/simple_door/iron,
/turf/simulated/floor/tiled/steel_ridged,
/area/submap/groundbase/poi/wildvillage/square/square1)
"z" = (
/obj/structure/table/standard,
/obj/item/device/flashlight/lamp/green{
	pixel_y = 8
	},
/turf/simulated/floor/wood/virgo3c{
	edge_blending_priority = -1;
	outdoors = 0
	},
/area/submap/groundbase/poi/wildvillage/square/square1)
"D" = (
/obj/structure/table/standard,
/obj/random/maintenance/misc,
/obj/structure/curtain/black{
	pixel_x = -32
	},
/turf/simulated/floor/wood/virgo3c{
	edge_blending_priority = -1;
	outdoors = 0
	},
/area/submap/groundbase/poi/wildvillage/square/square1)
"E" = (
/obj/random/maintenance/misc,
/obj/random/maintenance/misc,
/obj/random/maintenance/misc,
/obj/structure/table/rack/steel,
/turf/simulated/floor/carpet,
/area/submap/groundbase/poi/wildvillage/square/square1)
"F" = (
/obj/structure/bed/chair/sofa/right/brown,
/obj/structure/curtain/black{
	pixel_y = 32
	},
/turf/simulated/floor/wood/virgo3c{
	edge_blending_priority = -1;
	outdoors = 0
	},
/area/submap/groundbase/poi/wildvillage/square/square1)
"G" = (
/obj/structure/grille,
/obj/structure/window/reinforced/full,
/turf/simulated/floor,
/area/submap/groundbase/poi/wildvillage/square/square1)
"I" = (
/obj/structure/bed/chair/sofa/brown,
/obj/structure/curtain/black{
	pixel_y = 32
	},
/turf/simulated/floor/wood/virgo3c{
	edge_blending_priority = -1;
	outdoors = 0
	},
/area/submap/groundbase/poi/wildvillage/square/square1)
"L" = (
/obj/structure/bed/chair/sofa/brown,
/turf/simulated/floor/wood/virgo3c{
	edge_blending_priority = -1;
	outdoors = 0
	},
/area/submap/groundbase/poi/wildvillage/square/square1)
"O" = (
/obj/structure/simple_door/iron,
/turf/simulated/floor/bmarble,
/area/submap/groundbase/poi/wildvillage/square/square1)
"R" = (
/turf/simulated/floor/wood/virgo3c{
	edge_blending_priority = -1;
	outdoors = 0
	},
/area/submap/groundbase/poi/wildvillage/square/square1)
"S" = (
/obj/structure/curtain/black{
	pixel_x = -32
	},
/turf/simulated/floor/wood/virgo3c{
	edge_blending_priority = -1;
	outdoors = 0
	},
/area/submap/groundbase/poi/wildvillage/square/square1)
"W" = (
/obj/structure/table/standard,
/obj/random/maintenance/misc,
/obj/random/maintenance/misc,
/obj/structure/curtain/black{
	pixel_x = -32
	},
/turf/simulated/floor/wood/virgo3c{
	edge_blending_priority = -1;
	outdoors = 0
	},
/area/submap/groundbase/poi/wildvillage/square/square1)

(1,1,1) = {"
a
a
a
a
a
a
a
a
a
a
a
a
"}
(2,1,1) = {"
a
v
v
G
G
v
v
G
G
v
v
a
"}
(3,1,1) = {"
a
v
n
S
S
R
R
W
D
z
v
a
"}
(4,1,1) = {"
a
G
F
R
R
R
R
R
R
k
v
l
"}
(5,1,1) = {"
a
G
I
R
R
R
R
R
R
R
O
s
"}
(6,1,1) = {"
a
v
L
k
k
R
R
R
R
R
v
l
"}
(7,1,1) = {"
a
v
L
k
z
R
v
v
w
v
v
a
"}
(8,1,1) = {"
a
G
I
R
R
R
v
b
t
E
v
a
"}
(9,1,1) = {"
a
G
r
R
R
R
v
t
t
t
v
a
"}
(10,1,1) = {"
a
v
n
m
m
n
v
d
p
h
v
a
"}
(11,1,1) = {"
a
v
v
G
G
v
v
v
v
v
v
a
"}
(12,1,1) = {"
a
a
a
a
a
a
a
a
a
a
a
a
"}
