//MAP CONVERTED BY dmm2tgm.py THIS HEADER COMMENT PREVENTS RECONVERSION, DO NOT REMOVE
"a" = (
/turf/template_noop,
/area/submap/groundbase/poi/wildvillage/square/square5)
"d" = (
/obj/structure/sink/puddle,
/turf/simulated/floor/outdoors/grass/virgo3c,
/area/submap/groundbase/poi/wildvillage/square/square5)
"e" = (
/obj/structure/fence/corner{
	dir = 5
	},
/turf/simulated/floor/outdoors/grass/virgo3c,
/area/submap/groundbase/poi/wildvillage/square/square5)
"m" = (
/obj/structure/fence/corner,
/turf/simulated/floor/outdoors/grass/virgo3c,
/area/submap/groundbase/poi/wildvillage/square/square5)
"n" = (
/obj/machinery/portable_atmospherics/hydroponics/soil,
/turf/simulated/floor/outdoors/newdirt/virgo3c,
/area/submap/groundbase/poi/wildvillage/square/square5)
"v" = (
/obj/structure/fence/corner{
	dir = 8
	},
/turf/simulated/floor/outdoors/grass/virgo3c,
/area/submap/groundbase/poi/wildvillage/square/square5)
"w" = (
/obj/structure/fence{
	dir = 4
	},
/turf/simulated/floor/outdoors/grass/virgo3c,
/area/submap/groundbase/poi/wildvillage/square/square5)
"y" = (
/obj/structure/fence,
/turf/simulated/floor/outdoors/grass/virgo3c,
/area/submap/groundbase/poi/wildvillage/square/square5)
"C" = (
/turf/simulated/floor/outdoors/grass/virgo3c,
/area/submap/groundbase/poi/wildvillage/square/square5)
"J" = (
/obj/item/weapon/material/minihoe,
/turf/simulated/floor/outdoors/grass/virgo3c,
/area/submap/groundbase/poi/wildvillage/square/square5)
"O" = (
/obj/structure/fence/corner{
	dir = 10
	},
/turf/simulated/floor/outdoors/grass/virgo3c,
/area/submap/groundbase/poi/wildvillage/square/square5)
"T" = (
/obj/structure/fence/door,
/turf/simulated/floor/outdoors/grass/virgo3c,
/area/submap/groundbase/poi/wildvillage/square/square5)
"X" = (
/obj/item/weapon/reagent_containers/glass/bucket/wood,
/turf/simulated/floor/outdoors/grass/virgo3c,
/area/submap/groundbase/poi/wildvillage/square/square5)

(1,1,1) = {"
a
a
a
a
a
a
a
a
a
a
a
a
"}
(2,1,1) = {"
a
v
y
y
y
y
y
y
y
y
O
a
"}
(3,1,1) = {"
a
w
n
n
n
d
C
n
n
n
w
a
"}
(4,1,1) = {"
a
w
C
C
C
C
C
C
C
C
w
a
"}
(5,1,1) = {"
a
T
C
C
C
C
C
C
C
C
T
a
"}
(6,1,1) = {"
a
w
n
n
n
C
X
n
n
n
w
a
"}
(7,1,1) = {"
a
w
n
n
n
C
C
n
n
n
w
a
"}
(8,1,1) = {"
a
T
C
C
C
C
C
C
C
C
T
a
"}
(9,1,1) = {"
a
w
J
C
C
C
C
C
C
C
w
a
"}
(10,1,1) = {"
a
w
n
n
n
C
C
n
n
n
w
a
"}
(11,1,1) = {"
a
e
y
y
y
y
y
y
y
y
m
a
"}
(12,1,1) = {"
a
a
a
a
a
a
a
a
a
a
a
a
"}
