//MAP CONVERTED BY dmm2tgm.py THIS HEADER COMMENT PREVENTS RECONVERSION, DO NOT REMOVE
"a" = (
/turf/template_noop,
/area/submap/groundbase/poi/wildvillage)
"b" = (
/obj/structure/table/rack/shelf/steel,
/obj/random/maintenance/misc,
/obj/random/maintenance/misc,
/obj/random/maintenance/misc,
/obj/random/maintenance/misc,
/obj/random/maintenance/misc,
/turf/simulated/floor/wood,
/area/submap/groundbase/poi/wildvillage/wide/wide1)
"c" = (
/obj/structure/bed/chair/sofa/left/brown{
	dir = 1
	},
/turf/simulated/floor/wood,
/area/submap/groundbase/poi/wildvillage/wide/wide1)
"d" = (
/turf/simulated/floor/outdoors/newdirt,
/area/submap/groundbase/poi/wildvillage)
"f" = (
/obj/machinery/door/airlock/silver{
	name = "automatic door"
	},
/turf/simulated/floor/bmarble,
/area/submap/groundbase/poi/wildvillage/wide/wide1)
"g" = (
/obj/structure/undies_wardrobe,
/turf/simulated/floor/carpet/sblucarpet,
/area/submap/groundbase/poi/wildvillage/wide/wide1)
"h" = (
/obj/machinery/light/small{
	dir = 8
	},
/turf/simulated/floor/wood,
/area/submap/groundbase/poi/wildvillage/wide/wide1)
"i" = (
/obj/machinery/light/small{
	dir = 1
	},
/turf/simulated/floor/outdoors/newdirt,
/area/submap/groundbase/poi/wildvillage)
"k" = (
/obj/structure/bonfire,
/turf/simulated/floor,
/area/submap/groundbase/poi/wildvillage/wide/wide1)
"l" = (
/obj/structure/table/standard,
/obj/random/maintenance/misc,
/obj/random/maintenance/misc,
/turf/simulated/floor/wood,
/area/submap/groundbase/poi/wildvillage/wide/wide1)
"m" = (
/obj/structure/bed/chair/sofa/right/brown{
	dir = 8
	},
/obj/machinery/light/small{
	dir = 4
	},
/turf/simulated/floor/wood,
/area/submap/groundbase/poi/wildvillage/wide/wide1)
"n" = (
/obj/structure/bed/chair/comfy/black{
	dir = 4
	},
/obj/machinery/light/small{
	dir = 1
	},
/turf/simulated/floor/wood,
/area/submap/groundbase/poi/wildvillage/wide/wide1)
"p" = (
/obj/structure/table/standard,
/obj/item/device/flashlight/lamp/green{
	pixel_y = 8
	},
/turf/simulated/floor/carpet/sblucarpet,
/area/submap/groundbase/poi/wildvillage/wide/wide1)
"q" = (
/obj/random/pottedplant,
/turf/simulated/floor/wmarble,
/area/submap/groundbase/poi/wildvillage/wide/wide1)
"r" = (
/obj/structure/bed/chair/sofa/brown{
	dir = 8
	},
/turf/simulated/floor/wood,
/area/submap/groundbase/poi/wildvillage/wide/wide1)
"s" = (
/obj/structure/table/standard,
/obj/item/device/flashlight/lamp/green{
	pixel_y = 8
	},
/turf/simulated/floor/wood,
/area/submap/groundbase/poi/wildvillage/wide/wide1)
"t" = (
/obj/structure/table/rack/shelf/steel,
/obj/item/clothing/shoes/boots/jackboots,
/obj/random/maintenance/misc,
/turf/simulated/floor/wmarble,
/area/submap/groundbase/poi/wildvillage/wide/wide1)
"u" = (
/obj/machinery/light/small{
	dir = 4
	},
/turf/simulated/floor/wood,
/area/submap/groundbase/poi/wildvillage/wide/wide1)
"v" = (
/obj/machinery/light/small,
/turf/simulated/floor/bmarble,
/area/submap/groundbase/poi/wildvillage/wide/wide1)
"w" = (
/obj/machinery/light_switch{
	dir = 1;
	pixel_y = -30
	},
/turf/simulated/floor/wmarble,
/area/submap/groundbase/poi/wildvillage/wide/wide1)
"x" = (
/obj/structure/table/standard,
/obj/random/maintenance/misc,
/obj/random/maintenance/misc,
/turf/simulated/floor/carpet/sblucarpet,
/area/submap/groundbase/poi/wildvillage/wide/wide1)
"y" = (
/obj/structure/grille,
/obj/structure/window/reinforced/full,
/obj/structure/window/reinforced/polarized{
	color = "#222222";
	dir = 1;
	id = "village_wide1";
	opacity = 1
	},
/turf/simulated/floor,
/area/submap/groundbase/poi/wildvillage/wide/wide1)
"A" = (
/obj/structure/bed/chair/sofa/brown{
	dir = 1
	},
/turf/simulated/floor/wood,
/area/submap/groundbase/poi/wildvillage/wide/wide1)
"B" = (
/turf/simulated/wall,
/area/submap/groundbase/poi/wildvillage/wide/wide1)
"C" = (
/obj/random/pottedplant,
/turf/simulated/floor/wood,
/area/submap/groundbase/poi/wildvillage/wide/wide1)
"D" = (
/obj/structure/bed/chair/sofa/corner/brown{
	dir = 8
	},
/obj/machinery/light/small,
/turf/simulated/floor/wood,
/area/submap/groundbase/poi/wildvillage/wide/wide1)
"E" = (
/obj/structure/table/rack/steel,
/obj/random/maintenance/misc,
/obj/random/mainttoyloot,
/turf/simulated/floor/wood,
/area/submap/groundbase/poi/wildvillage/wide/wide1)
"F" = (
/obj/structure/grille,
/obj/structure/window/reinforced/full,
/obj/structure/window/reinforced/polarized{
	color = "#222222";
	id = "village_wide1";
	opacity = 1
	},
/turf/simulated/floor,
/area/submap/groundbase/poi/wildvillage/wide/wide1)
"H" = (
/obj/structure/coatrack,
/turf/simulated/floor/wmarble,
/area/submap/groundbase/poi/wildvillage/wide/wide1)
"I" = (
/obj/machinery/button/windowtint{
	id = "village_wide1";
	layer = 3.3;
	pixel_x = -30
	},
/turf/simulated/floor/wood,
/area/submap/groundbase/poi/wildvillage/wide/wide1)
"J" = (
/obj/structure/grille,
/obj/structure/window/reinforced/full,
/obj/structure/window/reinforced/polarized{
	color = "#222222";
	dir = 8;
	id = "village_wide1";
	opacity = 1
	},
/turf/simulated/floor,
/area/submap/groundbase/poi/wildvillage/wide/wide1)
"M" = (
/turf/simulated/floor/wood,
/area/submap/groundbase/poi/wildvillage/wide/wide1)
"N" = (
/obj/structure/bed/double/padded,
/obj/item/weapon/bedsheet/browndouble,
/obj/structure/curtain/open/bed{
	color = "#5e0c1d"
	},
/obj/random/plushie,
/turf/simulated/floor/carpet/sblucarpet,
/area/submap/groundbase/poi/wildvillage/wide/wide1)
"O" = (
/turf/simulated/floor/outdoors/sidewalk,
/area/submap/groundbase/poi/wildvillage)
"P" = (
/obj/structure/table/rack/steel,
/obj/fiftyspawner/log,
/obj/random/maintenance/misc,
/obj/random/maintenance/misc,
/turf/simulated/floor/bmarble,
/area/submap/groundbase/poi/wildvillage/wide/wide1)
"Q" = (
/obj/structure/table/standard,
/obj/machinery/light/small,
/obj/machinery/button/windowtint{
	id = "village_wide1_bedroom";
	layer = 3.3;
	pixel_x = 30
	},
/obj/random/maintenance/misc,
/obj/random/maintenance/misc,
/turf/simulated/floor/carpet/sblucarpet,
/area/submap/groundbase/poi/wildvillage/wide/wide1)
"R" = (
/obj/structure/table/rack/steel,
/obj/random/maintenance/misc,
/obj/random/tool,
/obj/random/tool,
/obj/random/mainttoyloot,
/turf/simulated/floor/wood,
/area/submap/groundbase/poi/wildvillage/wide/wide1)
"S" = (
/obj/machinery/light/small{
	dir = 8
	},
/turf/simulated/floor/bmarble,
/area/submap/groundbase/poi/wildvillage/wide/wide1)
"T" = (
/obj/structure/grille,
/obj/structure/window/reinforced/full,
/obj/structure/window/reinforced/polarized{
	color = "#222222";
	dir = 4;
	id = "village_wide1_bedroom";
	opacity = 1
	},
/turf/simulated/floor,
/area/submap/groundbase/poi/wildvillage/wide/wide1)
"V" = (
/obj/structure/bed/chair/comfy/black{
	dir = 8
	},
/obj/machinery/light/small{
	dir = 1
	},
/turf/simulated/floor/wood,
/area/submap/groundbase/poi/wildvillage/wide/wide1)
"W" = (
/turf/simulated/floor/carpet/sblucarpet,
/area/submap/groundbase/poi/wildvillage/wide/wide1)
"X" = (
/turf/simulated/floor/bmarble,
/area/submap/groundbase/poi/wildvillage/wide/wide1)
"Y" = (
/obj/machinery/door/airlock/silver{
	name = "automatic door"
	},
/turf/simulated/floor/tiled/steel_ridged,
/area/submap/groundbase/poi/wildvillage/wide/wide1)
"Z" = (
/obj/structure/table/standard,
/obj/machinery/light/small{
	dir = 1
	},
/obj/random/maintenance/misc,
/obj/random/maintenance/misc,
/turf/simulated/floor/carpet/sblucarpet,
/area/submap/groundbase/poi/wildvillage/wide/wide1)

(1,1,1) = {"
a
a
a
a
a
a
B
B
B
B
a
a
"}
(2,1,1) = {"
a
B
B
J
J
B
B
k
k
B
B
a
"}
(3,1,1) = {"
a
B
n
M
M
I
P
X
X
v
B
a
"}
(4,1,1) = {"
a
y
s
M
M
M
M
M
M
c
F
a
"}
(5,1,1) = {"
a
y
l
M
M
M
M
s
l
A
F
a
"}
(6,1,1) = {"
a
B
V
M
M
M
m
r
r
D
B
a
"}
(7,1,1) = {"
a
B
B
B
Y
B
B
B
B
B
B
a
"}
(8,1,1) = {"
a
B
b
M
M
M
B
t
S
q
B
i
"}
(9,1,1) = {"
a
y
M
M
M
M
Y
X
X
X
f
O
"}
(10,1,1) = {"
a
B
b
u
M
C
B
H
X
w
B
d
"}
(11,1,1) = {"
a
B
B
B
Y
B
B
B
B
B
B
a
"}
(12,1,1) = {"
a
B
Z
x
W
W
B
b
h
E
B
a
"}
(13,1,1) = {"
a
B
g
W
W
W
Y
M
M
R
B
a
"}
(14,1,1) = {"
a
B
N
W
W
p
B
M
M
R
B
a
"}
(15,1,1) = {"
a
B
p
W
W
Q
B
b
u
E
B
a
"}
(16,1,1) = {"
a
B
B
T
T
B
B
B
B
B
B
a
"}
(17,1,1) = {"
a
a
a
a
a
a
a
a
a
a
a
a
"}
