//MAP CONVERTED BY dmm2tgm.py THIS HEADER COMMENT PREVENTS RECONVERSION, DO NOT REMOVE
"a" = (
/turf/simulated/floor/outdoors/newdirt_nograss{
	outdoors = 0
	},
/area/maintenance/groundbase/poi/caves)
"o" = (
/turf/template_noop,
/area/template_noop)

(1,1,1) = {"
a
a
o
o
o
o
o
a
a
"}
(2,1,1) = {"
a
a
a
o
o
o
a
a
a
"}
(3,1,1) = {"
a
a
a
a
a
a
a
a
a
"}
(4,1,1) = {"
a
a
a
o
o
o
a
a
a
"}
(5,1,1) = {"
a
a
o
o
o
o
o
a
a
"}
