//MAP CONVERTED BY dmm2tgm.py THIS HEADER COMMENT PREVENTS RECONVERSION, DO NOT REMOVE
"a" = (
/turf/template_noop,
/area/template_noop)
"k" = (
/obj/random/maintenance/misc,
/turf/simulated/floor/outdoors/newdirt_nograss{
	outdoors = 0
	},
/area/maintenance/groundbase/poi/caves)
"w" = (
/obj/random/trash_pile,
/turf/simulated/floor/outdoors/newdirt_nograss{
	outdoors = 0
	},
/area/maintenance/groundbase/poi/caves)
"L" = (
/turf/simulated/floor/outdoors/newdirt_nograss{
	outdoors = 0
	},
/area/maintenance/groundbase/poi/caves)

(1,1,1) = {"
a
a
a
L
L
L
L
a
a
"}
(2,1,1) = {"
a
a
a
L
L
L
L
a
a
"}
(3,1,1) = {"
a
a
a
a
k
L
L
a
a
"}
(4,1,1) = {"
a
a
a
a
a
L
L
L
a
"}
(5,1,1) = {"
a
a
a
a
a
a
a
L
k
"}
(6,1,1) = {"
a
a
a
a
a
a
a
L
a
"}
(7,1,1) = {"
a
a
a
a
w
L
L
k
a
"}
(8,1,1) = {"
a
a
k
L
L
L
L
a
a
"}
(9,1,1) = {"
L
L
L
L
a
a
a
a
a
"}
