//MAP CONVERTED BY dmm2tgm.py THIS HEADER COMMENT PREVENTS RECONVERSION, DO NOT REMOVE
"a" = (
/turf/template_noop,
/area/template_noop)
"g" = (
/turf/simulated/floor/outdoors/newdirt_nograss{
	outdoors = 0
	},
/area/maintenance/groundbase/poi/caves)

(1,1,1) = {"
g
g
g
g
g
a
"}
(2,1,1) = {"
a
g
g
g
g
g
"}
(3,1,1) = {"
a
g
g
a
g
g
"}
(4,1,1) = {"
a
a
g
g
g
a
"}
