//MAP CONVERTED BY dmm2tgm.py THIS HEADER COMMENT PREVENTS RECONVERSION, DO NOT REMOVE
"a" = (
/turf/template_noop,
/area/template_noop)
"j" = (
/obj/random/maintenance/misc,
/obj/random/maintenance/misc,
/turf/simulated/floor/outdoors/newdirt_nograss{
	outdoors = 0
	},
/area/maintenance/groundbase/poi/caves)
"p" = (
/obj/random/crate,
/obj/random/maintenance/misc,
/obj/random/maintenance/misc,
/obj/random/maintenance/misc,
/obj/random/maintenance/misc,
/turf/simulated/floor/outdoors/newdirt_nograss{
	outdoors = 0
	},
/area/maintenance/groundbase/poi/caves)
"T" = (
/turf/simulated/floor/outdoors/newdirt_nograss{
	outdoors = 0
	},
/area/maintenance/groundbase/poi/caves)
"Y" = (
/obj/random/maintenance/misc,
/turf/simulated/floor/outdoors/newdirt_nograss{
	outdoors = 0
	},
/area/maintenance/groundbase/poi/caves)

(1,1,1) = {"
a
a
a
a
a
a
a
j
a
"}
(2,1,1) = {"
T
T
j
a
T
Y
T
T
a
"}
(3,1,1) = {"
T
T
T
T
T
T
T
T
T
"}
(4,1,1) = {"
T
T
T
T
a
p
a
T
T
"}
(5,1,1) = {"
T
T
T
a
a
a
a
Y
T
"}
(6,1,1) = {"
a
a
a
a
a
a
a
a
T
"}
