//MAP CONVERTED BY dmm2tgm.py THIS HEADER COMMENT PREVENTS RECONVERSION, DO NOT REMOVE
"a" = (
/turf/template_noop,
/area/template_noop)
"o" = (
/obj/random/maintenance/misc,
/turf/simulated/floor/outdoors/newdirt_nograss{
	outdoors = 0
	},
/area/maintenance/groundbase/poi/caves)
"q" = (
/turf/simulated/floor/outdoors/newdirt_nograss{
	outdoors = 0
	},
/area/maintenance/groundbase/poi/caves)
"w" = (
/obj/random/maintenance/misc,
/obj/random/maintenance/misc,
/turf/simulated/floor/outdoors/newdirt_nograss{
	outdoors = 0
	},
/area/maintenance/groundbase/poi/caves)
"N" = (
/obj/random/crate,
/obj/random/maintenance/misc,
/obj/random/maintenance/misc,
/obj/random/maintenance/misc,
/obj/random/maintenance/misc,
/turf/simulated/floor/outdoors/newdirt_nograss{
	outdoors = 0
	},
/area/maintenance/groundbase/poi/caves)

(1,1,1) = {"
a
a
a
q
q
a
a
a
a
"}
(2,1,1) = {"
a
q
q
q
N
a
a
a
a
"}
(3,1,1) = {"
a
q
q
a
a
a
a
a
a
"}
(4,1,1) = {"
o
q
q
a
a
a
a
a
w
"}
(5,1,1) = {"
q
q
q
a
a
a
a
a
q
"}
(6,1,1) = {"
a
q
q
q
a
a
a
w
q
"}
(7,1,1) = {"
a
q
q
q
q
a
q
q
q
"}
(8,1,1) = {"
a
a
a
q
q
o
q
q
a
"}
