//MAP CONVERTED BY dmm2tgm.py THIS HEADER COMMENT PREVENTS RECONVERSION, DO NOT REMOVE
"a" = (
/turf/simulated/floor/outdoors/newdirt_nograss{
	outdoors = 0
	},
/area/maintenance/groundbase/poi/caves)
"M" = (
/turf/template_noop,
/area/template_noop)

(1,1,1) = {"
M
M
M
a
a
a
"}
(2,1,1) = {"
M
M
a
a
a
a
"}
(3,1,1) = {"
a
a
a
a
a
M
"}
(4,1,1) = {"
M
a
a
M
a
a
"}
(5,1,1) = {"
M
M
a
a
M
M
"}
