//MAP CONVERTED BY dmm2tgm.py THIS HEADER COMMENT PREVENTS RECONVERSION, DO NOT REMOVE
"a" = (
/turf/simulated/floor/outdoors/newdirt_nograss{
	outdoors = 0
	},
/area/maintenance/groundbase/poi/caves)
"p" = (
/obj/random/maintenance/misc,
/obj/random/maintenance/misc,
/turf/simulated/floor/outdoors/newdirt_nograss{
	outdoors = 0
	},
/area/maintenance/groundbase/poi/caves)
"t" = (
/turf/template_noop,
/area/template_noop)
"z" = (
/obj/random/maintenance/misc,
/turf/simulated/floor/outdoors/newdirt_nograss{
	outdoors = 0
	},
/area/maintenance/groundbase/poi/caves)
"P" = (
/obj/random/trash_pile,
/turf/simulated/floor/outdoors/newdirt_nograss{
	outdoors = 0
	},
/area/maintenance/groundbase/poi/caves)

(1,1,1) = {"
t
t
a
a
z
"}
(2,1,1) = {"
t
t
t
a
a
"}
(3,1,1) = {"
t
t
z
a
a
"}
(4,1,1) = {"
a
a
a
a
t
"}
(5,1,1) = {"
P
a
a
t
t
"}
(6,1,1) = {"
t
a
a
p
t
"}
(7,1,1) = {"
t
a
a
t
t
"}
(8,1,1) = {"
a
a
a
t
t
"}
(9,1,1) = {"
z
a
a
a
t
"}
