//MAP CONVERTED BY dmm2tgm.py THIS HEADER COMMENT PREVENTS RECONVERSION, DO NOT REMOVE
"a" = (
/turf/template_noop,
/area/template_noop)
"z" = (
/obj/random/maintenance/misc,
/turf/simulated/floor/outdoors/newdirt_nograss{
	outdoors = 0
	},
/area/maintenance/groundbase/poi/caves)
"N" = (
/turf/simulated/floor/outdoors/newdirt_nograss{
	outdoors = 0
	},
/area/maintenance/groundbase/poi/caves)
"O" = (
/obj/random/maintenance/misc,
/obj/random/maintenance/misc,
/turf/simulated/floor/outdoors/newdirt_nograss{
	outdoors = 0
	},
/area/maintenance/groundbase/poi/caves)
"Y" = (
/obj/random/trash_pile,
/turf/simulated/floor/outdoors/newdirt_nograss{
	outdoors = 0
	},
/area/maintenance/groundbase/poi/caves)

(1,1,1) = {"
a
N
N
N
a
a
a
"}
(2,1,1) = {"
a
N
N
N
a
a
a
"}
(3,1,1) = {"
O
N
N
N
z
a
a
"}
(4,1,1) = {"
a
N
N
N
N
N
N
"}
(5,1,1) = {"
a
N
Y
N
N
N
O
"}
(6,1,1) = {"
a
a
a
a
a
N
N
"}
(7,1,1) = {"
a
a
a
a
z
N
N
"}
(8,1,1) = {"
a
a
N
N
N
N
a
"}
(9,1,1) = {"
a
a
N
N
a
a
a
"}
