//MAP CONVERTED BY dmm2tgm.py THIS HEADER COMMENT PREVENTS RECONVERSION, DO NOT REMOVE
"a" = (
/turf/simulated/floor/outdoors/newdirt_nograss{
	outdoors = 0
	},
/area/maintenance/groundbase/poi/caves)
"t" = (
/turf/template_noop,
/area/template_noop)

(1,1,1) = {"
t
t
a
a
a
"}
(2,1,1) = {"
t
t
t
a
a
"}
(3,1,1) = {"
t
t
a
a
a
"}
(4,1,1) = {"
a
a
a
a
t
"}
(5,1,1) = {"
a
a
a
t
t
"}
(6,1,1) = {"
t
a
a
a
t
"}
(7,1,1) = {"
t
a
a
t
t
"}
(8,1,1) = {"
a
a
a
t
t
"}
(9,1,1) = {"
a
a
a
a
t
"}
