"a" = (/turf/simulated/mineral/cave,/area/tether_away/cave/unexplored/deep)
"b" = (/turf/simulated/mineral/floor/ignore_mapgen/cave,/area/tether_away/cave/explored/deep)
"c" = (/turf/simulated/mineral/cave,/area/tether_away/cave/unexplored/normal)
"d" = (/turf/simulated/mineral/floor/ignore_mapgen/cave,/area/tether_away/cave/explored/normal)
"e" = (/turf/simulated/mineral/cave,/area/tether_away/cave/explored/normal)
"f" = (/obj/effect/step_trigger/teleporter/away_beach_tobeach,/turf/simulated/mineral/floor/ignore_mapgen/cave,/area/tether_away/cave/explored/normal)
"g" = (/turf/unsimulated/wall/planetary/normal,/area/tether_away/cave/unexplored/deep)
"h" = (/turf/unsimulated/wall/planetary/normal,/area/tether_away/cave/unexplored/normal)
"i" = (/obj/away_mission_init/beachcave,/turf/simulated/mineral/cave,/area/tether_away/cave/explored/normal)
"j" = (/turf/unsimulated/wall/planetary/normal,/area/tether_away/cave/explored/normal)
"k" = (/mob/living/simple_animal/hostile/deathclaw,/turf/simulated/mineral/floor/ignore_mapgen/cave,/area/tether_away/cave/explored/deep)
"l" = (/mob/living/simple_animal/hostile/deathclaw,/turf/simulated/mineral/floor/ignore_mapgen/cave,/area/tether_away/cave/explored/normal)

(1,1,1) = {"
gggggggggggggggggggggggggggggggggggggggggggggggggggggggggggggggggggggggggggggggggggggggggggggggggggggggggggggggggggggggg
gaaaaaaaaaaaaaaaaaaaaaaaaaaaaaaaaaaaaaaaaaaaaaaaaaaaaaaaaaaaaaaaaaaaaaaaaaaaaaaaaaaaaaaaaaaaaaaaaaaaaaaaaaaaaaaaaaaaaaag
gaaaaaaaaaaaaaaaaaaaaaaaaaaaaaaaaaaaaaaaaaaaaaaaaaaaaaaaaaaaaaaaaaaaaaaaaaaaaaaaaaaaaaaaaaaaaaaaaaaaaaaaaaaaaaaaaaaaaaag
gaaaaaaaaaaaaaaaaaaaaaaaaaaaaaaaaaaaaaaaaaaaaaaaaaaaaaaaaaaaaaaaaaaaaaaaaaaaaaaaaaaaaaaaaaaaaaaaaaaaaaaaaaaaaaaaaaaaaaag
gaaaaaaaaaaaaaaaaaaaaaaaaaaaaaaaaaaaaaaaaaaaaaaaaaaaaaaaaaaaaaaaaaaaaaaaaaaaaaaaaaaaaaaaaaaaaaaaaaaaaaaaaaaaaaaaaaaaaaag
gaaaaaaaaaaaaaaaaaaaaaaaaaaaaaaaaaaaaaaaaaaaaaaaaaaaaaaaaaaaaaaaaaaaaaaaaaaaaaaaaaaaaaaaaaaaaaaaaaaaaaaaaaaaaaaaaaaaaaag
gaaaaaaaaaaaaaaaaaaaaaaaaaaaaaaaaaaaaaaaaaaaaaaaaaaaaaaaaaaaaaaaaaaaaaaaaaaaaaaaaaaaaaaaaaaaaaaaaaaaaaaaaaaaaaaaaaaaaaag
gaaaaaaaaaaaaaaaaaaaaaaaaaaaaaaaaaaaaaaaaaaaaaaaaaaaaaaaaaaaaaaaaaaaaaaaaaaaaaaaaaaaaaaaaaaaaaaaaaaaaaaaaaaaaaaaaaaaaaag
gaaaaaaaaaaaaaaaaaaaaaaaaaaaaaaaaaaaaaaaaaaaaaaaaaaaaaaaaaaaaaaaaaaaaaaaaaaaaaaaaaaaaaaaaaaaaaaaaaaaaaaaaaaaaaaaaaaaaaag
gaaaaaaaaaaaaaaaaaaaaaaaaaaaaaaaaaaaaaaaaaaaaaaaaaaaaaaaaaaaaaaaaaaaaaaaaaaaaaaaaaaaaaaaaaaaaaaaaaaaaaaaaaaaaaaaaaaaaaag
gaaaaaaaaaaaaaaaaaaaaaaaaaaaaaaaaaaaaaaaaaaaaaaaaaaaaaaaaaaaaaaaaaaaaaaaaaaaaaaaaaaaaaaaaaaaaaaaaaaaaaaaaaaaaaaaaaaaaaag
gaaaaaaaaaaaaaaaaaaaaaaaaaaaaaaaaaaaaaaaaaaaaaaaaaaaaaaaaaaaaaaaaaaaaaaaaaaaaaaaaaaaaaaaaaaaaaaaaaaaaaaaaaaaaaaaaaaaaaag
gaaaaaaaaaaaaaaaaaaaaaaaaaaaaaaaaaaaaaaaaaaaaaaaaaaaaaaaaaaaaaaaaaaaaaaaaaaaaaaaaaaaaaaaaaaaaaaaaaaaaaaaaaaaaaaaaaaaaaag
gaaaaaaaaaaaaaaaaaaaaaaaaaaaaaaaaaaaaaaaaaaaaaaaaaaaaaaaaaaaaaaaaaaaaaaaaaaaaaaaaaaaaaaaaaaaaaaaaaaaaaaaaaaaaaaaaaaaaaag
gaaaaaaaaaaaaaaaaaaaaaaaaaaaaaaaaaaaaaaaaaaaaaaaaaaaaaaaaaaaaaaaaaaaaaaaaaaaaaaaaaaaaaaaaaaaaaaaaaaaaaaaaaaaaaaaaaaaaaag
gaaaaaaaaaaaaaaaaaaaaaaaaaaaaaaaaaaaaaaaaaaaaaaaaaaaaaaaaaaaaaaaaaaaaaaaaaaaaaaaaaaaaaaaaaaaaaaaaaaaaaaaaaaaaaaaaaaaaaag
gaaaaaaaaaaaaaaaaaaaaaaaaaaaaaaaaaaaaaaaaaaaaaaaaaaaaaaaaaaaaaaaaaaaaaaaaaaaaaaaaaaaaaaaaaaaaaaaaaaaaaaaaaaaaaaaaaaaaaag
gaaaaaaaaaaaaaaaaaaaaaaaaaaaaaaaaaaaaaaaaaaaaaaaaaaaaaaaaaaaaaaaaaaaaaaaaaaaaaaaaaaaaaaaaaaaaaaaaaaaaaaaaaaaaaaaaaaaaaag
gaaaaaaaaaaaaaaaaaaaaaaaaaaaaaaaaaaaaaaaaaaaaaaaaaaaaaaaaaaaaaaaaaaaaaaaaaaaaaaaaaaaaaaaaaaaaaaaaaaaaaaaaaaaaaaaaaaaaaag
gaaaaaaaaaaaaaaaaaaaaaaaaaaaaaaaaaaaaaaaaaaaaaaaaaaaaaaaaaaaaaaaaaaaaaaaaaaaaaaaaaaaaaaaaaaaaaaaaaaaaaaaaaaaaaaaaaaaaaag
gaaaaaaaaaaaaaaaaaaaaaaaaaaaaaaaaaaaaaaaaaaaaaaaaaaaaaaaaaaaaaaaaaaaaaaaaaaaaaaaaaaaaaaaaaaaaaaaaaaaaaaaaaaaaaaaaaaaaaag
gaaaaaaaaaaaaaaaaaaaaaaaaaaaaaaaaaaaaaaaaaaaaaaaaaaaaaaaaaaaaaaaaaaaaaaaaaaaaaaaaaaaaaaaaaaaaaaaaaaaaaaaaaaaaaaaaaaaaaag
gaaaaaaaaaaaaaaaaaaaaaaaaaaaaaaaaaaaaaaaaaaaaaaaaaaaaaaaaaaaaaaaaaaaaaaaaaaaaaaaaaaaaaaaaaaaaaaaaaaaaaaaaaaaaaaaaaaaaaag
gaaaaaaaaaaaaaaaaaaaaaaaaaaaaaaaaaaaaaaaaaaaaaaaaaaaaaaaaaaaaaaaaaaaaaaaaaaaaaaaaaaaaaaaaaaaaaaaaabbaaaaaaaaaaaaaaaaaaag
gaaaaaaaaaaaaaaaaaaaaaaaaaaaaaaaaaaaaaaaaaaaaaaaaaaaaaaaaaaaaaaaaaaaaaaaaaaaaaaaaaaaaaaaaaaaaaaaabbaaaaaaaaaaaaaaaaaaaag
gaaaaaaaaaaaaaaaaaaaaaaaaaaaaaaaaaaaaaaaaaaaaaaaaaaaaaaaaaaaaaaaaaaaaaaaaaaaaaaaaaaaaaaaaaaaaaaabbbaaaaaaaaaaaaaaaaaaaag
gaaaaaaaaaaaaaaaaaaaaaaaaaaaaaaaaaaaaaaaaaaaaaaaaaaaaaaaaaaaaaaaaaaaaaaaaaaaaaaaaaaaaaaaaaaaaaaabbaaaaaaaaaaaaaaaaaaaaag
gaaaaaaaaaaaaaaaaaaaaaaaaaaaaaaaaaaaaaaaaaaaaaaaaaaaaaaaaaaaaaaaaaaaaaaaaaaaaaaaaaaaaaaaaaaaaaabbbaaaaaaaaaaaaaaaaaaaaag
gaaaaaaaaaaaaaaaaaaaaaaaaaaaaaaaaaaaaaaaaaaaaaaaaaaaaaaaaaaaaaaaaaaaaaaaaaaaaaaaaaaaaaaaaaaaaabbbaaaaaaaaaaaaaaaaaaaaaag
gaaaaaaaaaaaaaaaaaaaaaaaaaaaaaaaaaaaaaaaaaaaaaaaaaaaaaaaaaaaaaaaaaaaaaaaaaaaaaaaaaaaaaaaaaaaaabaaaaaaaaaaaaaaaaaaaaaaaag
gaaaaaaaaaaaaaaaaaaaaaaaaaaaaaaaaaaaaaaaaaaaaaaaaaaaaaaaaaaaaaaaaaaaaaaaaaaaaaaaaaaaaaaaaaabbbaaaaaaaaaaaaaaaaaaaaaaaaag
gaaaaaaaaaaaaaaaaaaaaaaaaaaaaaaaaaaaaaaaaaaaaaaaaaaaaaaaaaaaaaaaaaaaaaaaaaaaaaaaaaaaaaaaabbbaaaaaaaaaaaaaaaaaaaaaaaaaaag
gaaaaaaaaaaaaaaaaaaaaaaaaaaaaaaaaaaaaaaaaaaaaaaaaaaaaaaaaaaaaaaaaaaaaaaaaaaaaaaabbbaaaaabbaaaaaaaaaaaaaaaaaaaaaaaaaaaaag
gaaaaaaaaaaaaaaaaaaaaaaaaaaaaaaaaaaaaaaaaaaaaaaaaaaaaaaaaaaaaaaaaaaaaaaaaaaaaaaaabbaaabbaaaaaaaaaaaaaaaaaaaaaaaaaaaaaaag
gaaaaaaaaaaaaaaaaaaaaaaaaaaaaaaaaaaaaaaaaaaaaaaaaaaaaaaaaaaaaaaaaaaaaaaaaaaaaaaaabbabbbaaaaaaaaaaaaaaaaaaaaaaaaaaaaaaaag
gaaaaaaaaaaaaaaaaaaaaaaaaaaaaaaaaaaaaaaaaaaaaaaaaaaaaaaaaaaaaaaaaaaaaaaaaaaaaaababbabaaaaaaaaaaaaaaaaaaaaaaaaaaaaaaaaaag
gaaaaaaaaaaaaaaaaaaaaaaaaaaaaaaaaaaaaaaaaaaaaaaaaaaaaaaaaaaaaaaaaaaaaaaaaaaaaaabbbbbaaaaaaaaaaaaaaaaaaaaaaaaaaaaaaaaaaag
gaaaaaaaaaaaaaaaaaaaaaaaaaaaaaaaaaaaaaaaaaaaaaaaaaaaaaaaaaaaaaaaaaaaaaaaaaaaaaaabkbbaaaaaaaaaaaaaaaaaaaaaaaaaaaaaaaaaaag
gaaaaaaaaaaaaaaaaaaaaaaaaaaaaaaaaaaaaaaaaaaaaaaaaaaaaaaaaaaaaaaaaaaaaaaaaaaaaaaaabbabaaaaaaaaaaaaaaaaaaaaaaaaaaaaaaaaaag
gaaaaaaaaaaaaaaaaaaaaaaaaaaaaaaaaaaaaaaaaaaaaaaaaaaaaaaaaaaaaaaaaaaaaaaaaaaaaaaaaabbbaaaaaaaaaaaaaaaaaaaaaaaaaaaaaaaaaag
gaaaaaaaaaaaaaaaaaaaaaaaaaaaaaaaaaaaaaaaaaaaaaaaaaaaaaaaaaaaaaaaaaaaaaaaaaaaaaaaabbbbaaaaaaaaaaaaaaaaaaaaaaaaaaaaaaaaaag
gaaaaaaaaaaaaaaaaaaaaaaaaaaaaaaaaaaaaaaaaaaaaaaaaaaaaaaaaaaaaaaaaaaaaaaaaaaaaaaaaabbbaaaaaaaaaaaaaaaaaaaaaaaaaaaaaaaaaag
gaaaaaaaaaaaaaaaaaaaaaaaaaaaaaaaaaaaaaaaaaaaaaaaaaaaaaaaaaaaaaaaaaaaaaaaaaaaaaaaaaabbbaaaaaaaaaaaaaaaaaaaaaaaaaaaaaaaaag
gaaaaaaaaaaaaaaaaaaaaaaaaaaaaaaaaaaaaaaaaaaaaaaaaaaaaaaaaaaaaaaaaaaaaaaaaaaaaaaaaaaabbaaaaaaaaaaaaaaaaaaaaaaaaaaaaaaaaag
gaaaaaaaaaaaaaaaaaaaaaaaaaaaaaaaaaaaaaaaaaaaaaaaaaaaaaaaaaaaaaaaaaaaaaaaaaaaaaaaaaaabbbaaaaaaaaaaaaaaaaaaaaaaaaaaaaaaaag
gaaaaaaaaaaaaaaaaaaaaaaaaaaaaaaaaaaaaaaaaaaaaaaaaaaaaaaaaaaaaaaaaaaaaaaaaaaaaaaaaaaaabbaaaaaaaaaaaaaaaaaaaaaaaaaaaaaaaag
gaaaaaaaaaaaaaaaaaaaaaaaaaaaaaaaaaaaaaaaaaaaaaaaaaaaaaaaaaaaaaaaaaaaaaaaaaaaaaaaaaaaaabaaaaaaaaaaaaaaaaaaaaaaaaaaaaaaaag
gaaaaaaaaaaaaaaaaaaaaaaaaaaaaaaaaaaaaaaaaaaaaaaaaaaaaaaaaaaaaaaaaaaaaaaaaaaaaaaaaaaaaababaaaaaaaaaaaaaaaaaaaaaaaaaaaaaag
gaaaaaaaaaaaaaaaaaaaaaaaaaaaaaaaaaaaaaaaaaaaaaaaaaaaaaaaaaaaaaaaaaaaaaaaaaaaaaaaaaaaaababaaaaaaaaaaaaaaaaaaaaaaaaaaaaaag
gaaaaaaaaaaaaaaaaaaaaaaaaaaaaaaaaaaaaaaaaaaaaaaaaaaaaaaaaaaaaaaaaaaaaaaaaaaaaaaaaaaaaababaaaaaaaaaaaaaaaaaaaaaaaaaaaaaag
gaaaaaaaaaaaaaaaaaaaaaaaaaaaaaaaaaaaaaaaaaaaaaaaaaaaaaaaaaaaaaaaaaaaaaaaaaaaaaaaaaaaaabbbaaaaaaaaaaaaaaaaaaaaaaaaaaaaaag
gaaaaaaaaaaaaaaaaaaaaaaaaaaaaaaaaaaaaaaaaaaaaaaaaaaaaaaaaaaaaaaaaaaaaaaaaaaaaaaaaaaaaaabbaaaaaaaaaaaaaaaaaaaaaaaaaaaaaag
gaaaaaaaaaaaaaaaaaaaaaaaaaaaaaaaaaaaaaaaaaaaaaaaaaaaaaaaaaaaaaaaaaaaaaaaaaaaaaaaaaaaaaabbaaaaaaaaaaaaaaaaaaaaaaaaaaaaaag
gaaaaaaaaaabbbbaaaaaaaaaaaaaaaaaaaaaaaaaaaaaaaaaaaaaaaaaaaaaaaaaaaaaaaaaaaaaaaaaaaaaaaaabaaaaaaaaaaaaaaaaaaaaaaaaaaaaaag
gaaaaaaaaaabkbbaaaaaaaaaaaaaaaaaaaaaaaaaaaaaaaaaaaaaaaaaaaaaaaaaaaaaaaaaaaaaaaaaaaaaaaaabbaaaaaaaaaaaaaaaaaaaaaaaaaaaaag
gaaaaaaaaaaabbbbbaaaaaaaaaaaaaaaaaaaaaaaaaaaaaaaaaaaaaaaaaaaaaaaaaaaaaaaaaaaaaaaaaaaaaaabbaaaaaaaaaaaaaaaaaaaaaaaaaaaaag
gaaaaaaaaaaaabbbbbaaaaaaaaaaaaaaaaaaaaaaaaaaaaaaaaaaaaaaaaaaaaaaaaaaaaaaaaaaaaaaaaaaaaaaabbaaaaaaaaaaaaaaaaaaaaaaaaaaaag
gaaaaaaaaaaaaabbbbbbaaaaaaaaaaaaaaaaaaaaaaaaaaaaaaaaaaaaaaaaaaaaaaaaaaaaaaaaaaaaaaaaaaaaaabaaaaaaaaaaaaaaaaaaaaaaaaaaaag
gaaaaaaaaaaaaaabbbbbaaaaaaaaaaaaaaaaaaaaaaaaaaaaaaaaaaaaaaaaaaaaaaaaaaaaaaaaaaaaaaaaaaaaaabaaaaaaaaaaaaaaaaaaaaaaaaaaaag
gaaaaaaaaaaaaaaabbbbbaaaaaaaaaaaaaaaaaaaaaaaaaaaaaaaaaaaaaaaaaaaaaaaaaaaaaaaaaaaaaaaaaaaaabaaaaaaaaaaaaaaaaaaaaaaaaaaaag
gaaaaaaaaaaaaaaaabbbbbaaaaaaaaaaaaaaaaaaaaaaaaaaaaaaaaaaaaaaaaaaaaaaaaaaaaaaaaaaaaaaaaaaaabaaaaaaaaaaaaaaaaaaaaaaaaaaaag
gaaaaaaaaaaaaaaaabbbbbaaaaaaaaaaaaaaaaaaaaaaaaaaaaaaaaaaaaaaaaaaaaaaaaaaaaaaaaaaaaaaaaaaaabaaaaaaaaaaaaaaaaaaaaaaaaaaaag
hcccccccccccccccccdddddccccccccccccccccccccccccccccccccccccccccccccccccccccccccccccccccccddcccccccccccccccccccccccccccch
hcccccccccccccccccccdddddcccccccccccccccccccccccccccccccccccccccccccccccccccccccccccccccdddcccccccccccccccccccccccccccch
hccccccccccccccccccccdddddccccccccccccccccccccccccccccccccccccccccccccccccccccccccccccccddccccccccccccccccccccccccccccch
hccccccccccccccccccccccddddccccccccccccccccccccccccccccccccccccccccccccccccccccccccccccdddccccccccccccccccccccccccccccch
hccccccccccccccccccccccdddddcccccccccccccccccccccccccccccccccccccccccccccccccccccccccccdddccccccccccccccccccccccccccccch
hcccccccccccccccccccccccdddddccccccccccccccccccccccccccccccccccccccccccccccccccccccccccdddccccccccccccccccccccccccccccch
hcccccccccccccccccccccdddddddcccccccccccccccccccccccccccccccccccccccccccccccccccccccccdddcccccccccccccccccccccccccccccch
hcccccccccccccccccccccdcddddddcccccccccccccccccccccccccccccccccccccccccccccccccccccccdddccccccccccccccccccccccccccccccch
hcccccccccccccccccccccccccdlddcccccccccccccccccccccccccccccccccccccccccccccccccccccccdddccccccccccccccccccccccccccccccch
hccccccccccccccccccccccccccddddccccccccccccccccccccccccccccccccccccccccccccccccccccccdddccccccccccccccccccccccccccccccch
hccccccccccccccccccccccccccdcddddccccccccccccccccccccccccccccccccccccccccccccccccccdddddccccccccccccccccccccccccccccccch
hccccccccccccccccccccccccccddcdddcccccccccccccccccccccccccccccccccccccccccccccccccddddccccccccccccccccccccccccccccccccch
hccccccccccccccccccccccccccddccdddccccccccccccccccccccccccccccccccccccccccccccccccdddcccccccccccccccccccccccccccccccccch
hcccccccccccccccccccccccccdddcccddcccccccccccccccccccccccccccccccccccccccccccccccddddcccccccccccccccccccccccccccccccccch
hccccccccccccccccccccccccddddccccddccccccccccccccccccccccccccccccccccccccccccccddddddcccccccccccccccccccccccccccccccccch
hccccccccccccccccccccccdddddccccccdddccccccccccccccccccccccccccccccccccccccccccdddddccccccccccccccccccccccccccccccccccch
hccccccccccccccccccccccdcddccccccccddddddccccccccccccccccccccccccccccccccccccccdddddccccccccccccccccccccccccccccccccccch
hccccccccccccccccccccccdddcccccccccccddddddcccccccccccccccccccccccccccccccccccdddccddcccccccccccccccccccccccccccccccccch
hccccccccccccccccccccddddccccccccccccccddddddccccccccccccccccccccccccccccccccdddccccdcccccccccccccccccccccccccccccccccch
hcccccccccccccccdddddddcccccccccccccccccddddddcccccccccccccccccccccccccccccccddcccccccccccccccccccccccccccccccccccccccch
hcccccccccccccccddccccccccccccccccccccccccddddddcccccccccccccccccccccccccccccddcccccccccccccccccccccccccccccccccccccccch
hccccccccccccccccccccccccccccccccccccccccccccdddddcccccccccccccccccccccccccddddcccccccccccccccccccccccccccccccccccccccch
hccccccccccccccccccccccccccccccccccccccccccccccddddddccccccccccccdcccccccccddcccccccccccccccccccccccccccccccccccccccccch
hccccccccccccccccccccccccccccccccccccccccccccccccddddddddddddccdcdcccccccccddcccccccccccccccccccccccccccccccccccccccccch
hcccccccccccccccccccccccccccccccccccccccccccccccccccdddddddddccddddccccccddddcccccccccccccccccccccccccccccccccccccccccch
hcccccccccccccccccccccccccccccccccccccccccccccccccccccddddddddddddddddddddddddccccccccccccccccccccccccccccccccccccccccch
hcccccccccccccccccccccccccccccccccccccccccccccccccccccccddddddddddddddddddddddccccccccccccccccccccccccccccccccccccccccch
hcccccccccccccccccccccccccccccccccccccccccccccccccccccccccdddddldddcccccccccccccccccccccccccccccccccccccccccccccccccccch
hcccccccccccccccccccccccccccccccccccccccccccccccccccccccccccdddddddcccccccccccccccccccccccccccccccccccccccccccccccccccch
hccccccccccccccccccccccccccccccccccccccccccccccccccccccccccccccdddddccccccccccccccccccccccccccccccccccccccccccccccccccch
hccccccccccccccccccccccccccccccccccccccccccccccccccccccccccccccccccdccccccccccccccccccccccccccccccccccccccccccccccccccch
hccccccccccccccccccccccccccccccccccccccccccccccccccccccccccccccccccddcccccccccccccccccccccccccccccccccccccccccccccccccch
hccccccccccccccccccccccccccccccccccccccccccccccccccccccccccccccccccddcccccccccccccccccccccccccccccccccccccccccccccccccch
hccccccccccccccccccccccccccccccccccccccccccccccccccccccccccccccccccdddccccccccccccccccccccccccccccccccccccccccccccccccch
hccccccccccccccccccccccccccccccccccccccccccccccccccccccccccccccccccddddcccccccccccccccccccccccccccccccccccccccccccccccch
hcccccccccccccccccccccccccccccccccccccccccccccccccccccccccccccccccccddddccccccccccccccccccccccccccccccccccccccccccccccch
hcccccccccccccccccccccccccccccccccccccccccccccccccccccccccccccccccccccddccccccccccccccccccccccccccccccccccccccccccccccch
hcccccccccccccccccccccccccccccccccccccccccccccccccccccccccccccccccccccddccccccccccccccccccccccccccccccccccccccccccccccch
hcccccccccccccccccccccccccccccccccccccccccccccccccccccccccccccccccccccddccccccccccccccccccccccccccccccccccccccccccccccch
hcccccccccccccccccccccccccccccccccccccccccccccccccccccccccccccccccccccdddcccccccccccccccccccccccccccccccccccccccccccccch
hccccccccccccccccccccccccccccccccccccccccccccccccccccccccccccccccccccccdddccccccccccccccccccccccccccccccccccccccccccccch
hccccccccccccccccccccccccccccccccccccccccccccccccccccccccccccccccccccccddddcccccccccccccccccccccccccccccccccccccccccccch
hcccccccccccccccccccccccccccccccccccccccccccccccccccccccccccccccccccccccdddcccccccccccccccccccccccccccccccccccccccccccch
hcccccccccccccccccccccccccccccccccccccccccccccccccccccccccccccccccccccccdddccccccccccceeccccccccccccccccccccccccccccccch
hcccccccccccccccccccccccccccccccccccccccccccccccccccccccccccccccccccccccccdccccccccceeeeeeecccccccccccccccccccccccccccch
hcccccccccccccccccccccccccccccccccccccccccccccccccccccccccccccccccccccccccddccccccccceeeeeecccccccccccccccccccccccccccch
hcccccccccccccccccccccccccccccccccccccccccccccccccccccccccccccccccccccccccddccccceeeeeeeeeecccccccccccccccccccccccccccch
hccccccccccccccccccccccccccccccccccccccccccccccccccccccccccccccccccccccccccdcceeeeeeeeeeeeeeeeeeecccccccccccccccccccccch
hcccccccccccccccccccccccccccccccccccccccccccccccccccccccccccccccccccccccceeddeeeeeeeeeeeeeeeeeeeeeeeeeecccccccccccccccch
hccccccccccccccccccccccccccccccccccccccccccccccccccccccccccccccccccccccceeeddeeeeeeedddddeeeeeeeeeeeeeeeccccccccccccccch
hcccccccccccccccccccccccccccccccccccccccccccccccccccccccccccccccccccccceeeedddeeeeeeddddddeeeeeeeeeeeeeeecccccccccccccch
hcccccccccccccccccccccccccccccccccccccccccccccccccccccccccccccccccccccceeeeedddeeeeedddddddddeeeeeeeeeeeecccccccccccccch
hcccccccccccccccccccccccccccccccccccccccccccccccccccccccccccccccccccccceeeeeddddddddddddddddddeeeeeeeeeeeeccccccccccccch
hcccccccccccccccccccccccccccccccccccccccccccccccccccccccccccccccccccccceeeeddddddddddddddddddddeeeeeeeeeeeccccccccccccch
hccccccccccccccccccccccccccccccccccccccccccccccccccccccccccccccccccceeeeeeedddeeeeeeeeeeedddddddeeeeeeeeeeecccccccccccch
hccccccccccccccccccccccccccccccccccccccccccccccccccccccccccccccccccceeeeeeeeeeeeeeeeeieeeeeedddddeeeeeeeeeecccccccccccch
hcccccccccccccccccccccccccccccccccccccccccccccccccccccccccccccccccceeeeeeeeeeeeeeeeeeeeeeeeeddddddeeeeeeeeeeecccccccccch
hhhhhhhhhhhhhhhhhhhhhhhhhhhhhhhhhhhhhhhhhhhhhhhhhhhhhhhhhhhhhhhhhhhjjjjjjjjjjjjjjjjjjjjjjjjjffffffjjjjjjjjjjjhhhhhhhhhhh
"}
