//MAP CONVERTED BY dmm2tgm.py THIS HEADER COMMENT PREVENTS RECONVERSION, DO NOT REMOVE
"a" = (
/turf/template_noop,
/area/mine/explored/underdark)
"b" = (
/turf/simulated/mineral/floor/ignore_cavegen/virgo3b,
/area/mine/explored/underdark)
"c" = (
/obj/random/research_sample_type2,
/turf/simulated/mineral/floor/ignore_cavegen/virgo3b,
/area/mine/explored/underdark)
"d" = (
/obj/tether_away_spawner/underdark_normal,
/turf/simulated/mineral/floor/ignore_cavegen/virgo3b,
/area/mine/explored/underdark)

(1,1,1) = {"
a
b
b
b
a
"}
(2,1,1) = {"
b
b
b
c
b
"}
(3,1,1) = {"
a
c
b
d
b
"}
(4,1,1) = {"
a
a
b
b
a
"}
