//MAP CONVERTED BY dmm2tgm.py THIS HEADER COMMENT PREVENTS RECONVERSION, DO NOT REMOVE
"a" = (
/turf/template_noop,
/area/mine/explored/underdark)
"b" = (
/turf/simulated/mineral/floor/ignore_cavegen/virgo3b,
/area/mine/explored/underdark)
"c" = (
/obj/tether_away_spawner/underdark_hard,
/turf/simulated/mineral/floor/ignore_cavegen/virgo3b,
/area/mine/explored/underdark)
"d" = (
/obj/structure/closet/crate/mimic/safe,
/obj/random/underdark,
/turf/simulated/mineral/floor/ignore_cavegen/virgo3b,
/area/mine/explored/underdark)

(1,1,1) = {"
a
a
b
"}
(2,1,1) = {"
b
b
d
"}
(3,1,1) = {"
b
b
b
"}
(4,1,1) = {"
c
b
a
"}
(5,1,1) = {"
a
b
a
"}
