"a" = (/obj/effect/floor_decal/rust,/turf/simulated/floor/virgo3b,/area/mine/explored/underdark)
"b" = (/turf/simulated/wall/iron,/area/mine/explored/underdark)
"c" = (/turf/template_noop,/area/mine/explored/underdark)
"d" = (/turf/simulated/mineral/floor/virgo3b,/area/mine/explored/underdark)

(1,1,1) = {"
bbbbcc
baddcc
badddc
baaddb
baaadb
bbbbbb
"}
