"aa" = (/turf/template_noop,/area/mine/explored/underdark)
"ab" = (/turf/simulated/wall,/area/mine/explored/underdark)
"ac" = (/turf/template_noop,/area/space)
"ad" = (/turf/simulated/mineral/floor/ignore_cavegen/virgo3b_better,/area/mine/explored/underdark)
"ae" = (/turf/simulated/floor/tiled/steel_dirty/virgo3b_better,/area/mine/explored/underdark)
"af" = (/obj/machinery/door/airlock/uranium,/turf/simulated/floor/tiled/steel_dirty/virgo3b_better,/area/mine/explored/underdark)
"ag" = (/obj/machinery/door/airlock/multi_tile/glass{dir = 1},/turf/simulated/floor/tiled/steel_dirty/virgo3b_better,/area/mine/explored/underdark)
"ah" = (/obj/machinery/floodlight,/turf/simulated/mineral/floor/ignore_cavegen/virgo3b_better,/area/mine/explored/underdark)
"aj" = (/obj/machinery/crystal,/turf/simulated/mineral/floor/ignore_cavegen/virgo3b_better,/area/mine/explored/underdark)
"ak" = (/obj/machinery/light/flicker,/turf/simulated/mineral/floor/ignore_cavegen/virgo3b_better,/area/mine/explored/underdark)
"al" = (/obj/machinery/mech_recharger,/turf/simulated/floor/tiled/steel_dirty/virgo3b_better,/area/mine/explored/underdark)
"am" = (/obj/machinery/gravity_generator,/turf/simulated/mineral/floor/ignore_cavegen/virgo3b_better,/area/mine/explored/underdark)
"an" = (/obj/machinery/implantchair,/turf/simulated/floor/tiled/steel_dirty/virgo3b_better,/area/mine/explored/underdark)
"ao" = (/obj/machinery/particle_smasher,/turf/simulated/mineral/floor/ignore_cavegen/virgo3b_better,/area/mine/explored/underdark)
"ap" = (/obj/machinery/particle_smasher,/turf/simulated/floor/tiled/steel_dirty/virgo3b_better,/area/mine/explored/underdark)
"aq" = (/obj/machinery/particle_accelerator/control_box,/turf/simulated/floor/tiled/steel_dirty/virgo3b_better,/area/mine/explored/underdark)
"ar" = (/obj/structure/old_roboprinter,/turf/simulated/floor/tiled/steel_dirty/virgo3b_better,/area/mine/explored/underdark)
"as" = (/obj/tether_away_spawner/underdark_drone_swarm,/turf/simulated/floor/tiled/steel_dirty/virgo3b_better,/area/mine/explored/underdark)
"at" = (/obj/tether_away_spawner/underdark_hard,/turf/simulated/mineral/floor/ignore_cavegen/virgo3b_better,/area/mine/explored/underdark)
"au" = (/obj/tether_away_spawner/underdark_normal,/turf/simulated/floor/tiled/steel_dirty/virgo3b_better,/area/mine/explored/underdark)
"av" = (/obj/structure/ore_box,/turf/simulated/floor/tiled/steel_dirty/virgo3b_better,/area/mine/explored/underdark)
"aw" = (/obj/structure/dogbed,/turf/simulated/floor/tiled/steel_dirty/virgo3b_better,/area/mine/explored/underdark)
"ax" = (/obj/structure/cult/forge,/turf/simulated/floor/tiled/steel_dirty/virgo3b_better,/area/mine/explored/underdark)
"ay" = (/obj/structure/cult/tome,/turf/simulated/floor/tiled/steel_dirty/virgo3b_better,/area/mine/explored/underdark)
"az" = (/obj/structure/bed,/turf/simulated/floor/tiled/steel_dirty/virgo3b_better,/area/mine/explored/underdark)
"aA" = (/obj/structure/barricade,/turf/simulated/mineral/floor/ignore_cavegen/virgo3b_better,/area/mine/explored/underdark)
"aB" = (/obj/structure/barricade,/obj/structure/boulder,/turf/simulated/mineral/floor/ignore_cavegen/virgo3b_better,/area/mine/explored/underdark)
"aC" = (/obj/structure/table/steel,/turf/simulated/floor/tiled/steel_dirty/virgo3b_better,/area/mine/explored/underdark)
"aD" = (/obj/structure/sink,/turf/simulated/floor/tiled/steel_dirty/virgo3b_better,/area/mine/explored/underdark)
"aE" = (/obj/structure/sign/ironhammer,/turf/simulated/wall,/area/mine/explored/underdark)
"aF" = (/obj/machinery/iv_drip,/obj/effect/decal/cleanable/cobweb2,/turf/simulated/floor/tiled/steel_dirty/virgo3b_better,/area/mine/explored/underdark)
"aG" = (/obj/structure/table/steel,/obj/machinery/reagentgrinder,/turf/simulated/floor/tiled/steel_dirty/virgo3b_better,/area/mine/explored/underdark)
"aH" = (/obj/machinery/smartfridge,/turf/simulated/floor/tiled/steel_dirty/virgo3b_better,/area/mine/explored/underdark)
"aI" = (/obj/structure/filingcabinet,/turf/simulated/floor/tiled/steel_dirty/virgo3b_better,/area/mine/explored/underdark)
"aJ" = (/obj/machinery/vending/cola,/turf/simulated/floor/tiled/steel_dirty/virgo3b_better,/area/mine/explored/underdark)
"aK" = (/obj/machinery/vending/coffee,/turf/simulated/floor/tiled/steel_dirty/virgo3b_better,/area/mine/explored/underdark)
"aL" = (/obj/machinery/vending/fitness,/turf/simulated/floor/tiled/steel_dirty/virgo3b_better,/area/mine/explored/underdark)
"aM" = (/obj/machinery/replicator,/turf/simulated/floor/tiled/steel_dirty/virgo3b_better,/area/mine/explored/underdark)
"aN" = (/obj/machinery/vending/snack,/turf/simulated/floor/tiled/steel_dirty/virgo3b_better,/area/mine/explored/underdark)
"aO" = (/obj/machinery/porta_turret/stationary/syndie{faction = "underdark"},/turf/simulated/floor/tiled/steel_dirty/virgo3b_better,/area/mine/explored/underdark)
"aP" = (/obj/structure/table/steel,/obj/machinery/recharger,/turf/simulated/floor/tiled/steel_dirty/virgo3b_better,/area/mine/explored/underdark)
"aQ" = (/obj/machinery/recharger/wallcharger,/turf/simulated/wall,/area/mine/explored/underdark)
"aR" = (/obj/item/frame/apc,/turf/simulated/floor/tiled/steel_dirty/virgo3b_better,/area/mine/explored/underdark)
"aS" = (/obj/structure/table/steel,/obj/machinery/light_construct{icon_state = "tube-construct-stage1"; dir = 1},/turf/simulated/floor/tiled/steel_dirty/virgo3b_better,/area/mine/explored/underdark)
"aT" = (/obj/machinery/light_construct{icon_state = "tube-construct-stage1"; dir = 1},/turf/simulated/floor/tiled/steel_dirty/virgo3b_better,/area/mine/explored/underdark)
"aU" = (/obj/machinery/light_construct{icon_state = "tube-construct-stage1"; dir = 8},/turf/simulated/floor/tiled/steel_dirty/virgo3b_better,/area/mine/explored/underdark)
"aV" = (/obj/machinery/light_construct{icon_state = "tube-construct-stage1"; dir = 4},/turf/simulated/floor/tiled/steel_dirty/virgo3b_better,/area/mine/explored/underdark)
"aW" = (/obj/machinery/light_construct,/turf/simulated/floor/tiled/steel_dirty/virgo3b_better,/area/mine/explored/underdark)
"aX" = (/obj/machinery/light/flamp/flicker,/turf/simulated/mineral/floor/ignore_cavegen/virgo3b_better,/area/mine/explored/underdark)
"aY" = (/obj/effect/decal/cleanable/cobweb,/turf/simulated/floor/tiled/steel_dirty/virgo3b_better,/area/mine/explored/underdark)
"aZ" = (/obj/machinery/clonepod/transhuman,/turf/simulated/floor/tiled/steel_dirty/virgo3b_better,/area/mine/explored/underdark)
"ba" = (/obj/effect/decal/mecha_wreckage/gygax/adv,/turf/simulated/floor/tiled/steel_dirty/virgo3b_better,/area/mine/explored/underdark)
"bb" = (/obj/effect/decal/mecha_wreckage/ripley,/turf/simulated/floor/tiled/steel_dirty/virgo3b_better,/area/mine/explored/underdark)
"bc" = (/obj/effect/decal/remains/deer,/turf/simulated/mineral/floor/ignore_cavegen/virgo3b_better,/area/mine/explored/underdark)
"bd" = (/obj/effect/decal/cleanable/blood/drip,/turf/simulated/mineral/floor/ignore_cavegen/virgo3b_better,/area/mine/explored/underdark)
"be" = (/obj/effect/decal/remains/deer,/obj/effect/decal/cleanable/blood,/turf/simulated/mineral/floor/ignore_cavegen/virgo3b_better,/area/mine/explored/underdark)
"bf" = (/obj/effect/decal/cleanable/blood/drip,/obj/effect/decal/cleanable/blood/drip,/turf/simulated/mineral/floor/ignore_cavegen/virgo3b_better,/area/mine/explored/underdark)
"bg" = (/obj/machinery/door/airlock/uranium,/obj/effect/decal/cleanable/blood/drip,/obj/effect/decal/cleanable/dirt,/turf/simulated/floor/tiled/steel_dirty/virgo3b_better,/area/mine/explored/underdark)
"bh" = (/obj/effect/decal/cleanable/blood/drip,/obj/effect/decal/cleanable/dirt,/turf/simulated/floor/tiled/steel_dirty/virgo3b_better,/area/mine/explored/underdark)
"bi" = (/obj/effect/decal/remains/human,/obj/effect/decal/cleanable/blood,/turf/simulated/floor/tiled/steel_dirty/virgo3b_better,/area/mine/explored/underdark)
"bj" = (/obj/effect/decal/cleanable/dirt,/turf/simulated/floor/tiled/steel_dirty/virgo3b_better,/area/mine/explored/underdark)
"bk" = (/obj/machinery/light_construct,/obj/effect/decal/remains/human,/obj/effect/decal/cleanable/blood,/turf/simulated/floor/tiled/steel_dirty/virgo3b_better,/area/mine/explored/underdark)
"bl" = (/obj/effect/decal/cleanable/cobweb2,/turf/simulated/floor/tiled/steel_dirty/virgo3b_better,/area/mine/explored/underdark)
"bm" = (/obj/structure/table/steel,/obj/machinery/microwave,/obj/effect/decal/cleanable/cobweb,/turf/simulated/floor/tiled/steel_dirty/virgo3b_better,/area/mine/explored/underdark)
"bn" = (/obj/structure/table/steel,/obj/machinery/microwave,/obj/effect/decal/cleanable/cobweb2,/turf/simulated/floor/tiled/steel_dirty/virgo3b_better,/area/mine/explored/underdark)
"bo" = (/obj/structure/bed,/obj/effect/decal/cleanable/cobweb2,/turf/simulated/floor/tiled/steel_dirty/virgo3b_better,/area/mine/explored/underdark)
"bp" = (/obj/tether_away_spawner/underdark_normal,/obj/effect/decal/cleanable/cobweb,/turf/simulated/floor/tiled/steel_dirty/virgo3b_better,/area/mine/explored/underdark)
"bq" = (/obj/tether_away_spawner/underdark_normal,/obj/effect/decal/cleanable/cobweb2,/turf/simulated/floor/tiled/steel_dirty/virgo3b_better,/area/mine/explored/underdark)
"br" = (/obj/effect/decal/cleanable/vomit,/turf/simulated/floor/tiled/steel_dirty/virgo3b_better,/area/mine/explored/underdark)
"bs" = (/obj/machinery/door/airlock/uranium,/obj/effect/decal/cleanable/dirt,/turf/simulated/floor/tiled/steel_dirty/virgo3b_better,/area/mine/explored/underdark)
"bt" = (/obj/effect/decal/remains/tajaran,/obj/effect/decal/cleanable/blood,/obj/effect/decal/cleanable/dirt,/turf/simulated/floor/tiled/steel_dirty/virgo3b_better,/area/mine/explored/underdark)
"bu" = (/obj/effect/decal/cleanable/spiderling_remains,/turf/simulated/mineral/floor/ignore_cavegen/virgo3b_better,/area/mine/explored/underdark)
"bv" = (/obj/item/device/assembly/prox_sensor,/turf/simulated/floor/tiled/steel_dirty/virgo3b_better,/area/mine/explored/underdark)
"bw" = (/obj/item/device/electronic_assembly/drone/genbot,/turf/simulated/floor/tiled/steel_dirty/virgo3b_better,/area/mine/explored/underdark)
"bx" = (/obj/structure/table/steel,/obj/item/device/assembly/electronic_assembly,/obj/item/weapon/circuitboard/aicore,/turf/simulated/floor/tiled/steel_dirty/virgo3b_better,/area/mine/explored/underdark)
"by" = (/obj/item/device/assembly/signaler,/turf/simulated/floor/tiled/steel_dirty/virgo3b_better,/area/mine/explored/underdark)
"bz" = (/obj/machinery/door/airlock/uranium{hasShocked = 1},/obj/effect/decal/cleanable/dirt,/turf/simulated/floor/tiled/steel_dirty/virgo3b_better,/area/mine/explored/underdark)
"bA" = (/obj/machinery/door/airlock/uranium{hasShocked = 1},/turf/simulated/floor/tiled/steel_dirty/virgo3b_better,/area/mine/explored/underdark)
"bC" = (/obj/random/underdark,/turf/simulated/floor/tiled/steel_dirty/virgo3b_better,/area/mine/explored/underdark)
"bD" = (/obj/effect/decal/cleanable/dirt,/obj/random/underdark,/turf/simulated/floor/tiled/steel_dirty/virgo3b_better,/area/mine/explored/underdark)
"bE" = (/obj/item/device/geiger,/turf/simulated/mineral/floor/ignore_cavegen/virgo3b_better,/area/mine/explored/underdark)
"DS" = (/obj/structure/salvageable/autolathe,/turf/simulated/floor/tiled/steel_dirty/virgo3b_better,/area/mine/explored/underdark)
"Vo" = (/obj/structure/salvageable/computer,/turf/simulated/floor/tiled/steel_dirty/virgo3b_better,/area/mine/explored/underdark)

(1,1,1) = {"
aaaaaaaaajajadadaAadaAaBaAaAaAadaAbuadajajaaaaaaaa
aaaaaaaaadadadadadadadaAaAaAbuadbuadadadadaaaaaaaa
aaaaaaaaadadajadaXadadajadadadaXadadadadadaaaaaaaa
aaaaaaaaadadadadadatadadadadadadadajadadaoaaaaaaaa
aaaaaaaaahadadadadadadadbdbeadadadadadadadaaaaaaaa
aaaaaaaaadadadamadbcadadbdadadadadajadadahaaaaaaaa
adadadadadadadadadadakajbfbEakadadadadadadaaaaaaaa
adadababafabababafabababbgababababababababababadad
adadabawaeaFabDSaeavabaYbhblabbmaSaCbnabaTboabadbE
bcadabaeaeaeafaeaeaeaeaebhaeaeaeaeauaeabaeazabadad
adadabaUaeaZabaeaeaeagaebhaeagaeaeaeaeafaeazabadad
adadabauaeaMabavaeaVabaNbhaeabaGaCaCaHabaeanabadad
adajababababababababababbgababababababababababadad
adadabalaebvaDaTbwaxabaRbhbiabaraeasaeaTaeapabadaj
adadabaPaeaeaeaeaeaeaQaUbjaeaEaeaeaeaebbaeaeabadad
adbEabbxaeaebaaeaebjbzbjbjbjbsbjaeVoVoaeaeaOabadad
adadabaPbyaeaeaeaeaeabaebtaeaEaeaeaeaeaeaeaeabadad
ajadabalaebCaeaIbCayabaeaeaeabaraeasaeaWaeaqabadbc
adadababababbAababababaUaeaeabababaEafaEabababadad
adajabbpaebibrbjbjbjaeaeaeaeaeaeaeaeaeaeaebqabadad
adadabaeaeaeaebjbjbDbCaJaKaLbCbCaeaebkaeaeaeabajad
ajadabababababababababababababababababababababadad
adadadadadadadadbcadadadadbcadadadadadadadadadadad
acacacacacacacacacacacacacacacacacacacacacacacacac
"}
