"a" = (/turf/simulated/mineral/floor/ignore_cavegen/virgo3b_better,/area/mine/explored/underdark)
"b" = (/turf/simulated/mineral/ignore_cavegen/virgo3b_better,/area/mine/explored/underdark)
"c" = (/turf/template_noop,/area/mine/explored/underdark)
"d" = (/obj/effect/decal/remains,/turf/simulated/mineral/floor/ignore_cavegen/virgo3b_better,/area/mine/explored/underdark)
"e" = (/obj/random/multiple/underdark/ores,/obj/random/multiple/underdark/miningdrills,/obj/item/clothing/head/helmet/space/void/mining,/obj/item/clothing/suit/space/void/mining,/obj/item/clothing/accessory/poncho/roles/cloak/mining,/obj/structure/closet/crate/mimic/safe,/turf/simulated/mineral/floor/ignore_cavegen/virgo3b_better,/area/mine/explored/underdark)

(1,1,1) = {"
aabbccc
aaabbbc
baaabbb
bbdaabb
bbbaebb
cbbbbbb
cccbbbc
"}
