"a" = (/turf/template_noop,/area/mine/explored/underdark)
"b" = (/turf/simulated/mineral/ignore_cavegen/virgo3b_better,/area/mine/explored/underdark)
"c" = (/turf/simulated/wall/r_wall,/area/mine/explored/underdark)
"d" = (/turf/simulated/floor/tiled/steel_dirty/virgo3b_better,/area/mine/explored/underdark)
"e" = (/obj/random/underdark,/obj/structure/closet/crate/mimic/safe,/turf/simulated/floor/tiled/steel_dirty/virgo3b_better,/area/mine/explored/underdark)

(1,1,1) = {"
aabbbba
abbbbbb
bbbbbbb
bbbbbbc
abbbdec
aabcccc
"}
