//MAP CONVERTED BY dmm2tgm.py THIS HEADER COMMENT PREVENTS RECONVERSION, DO NOT REMOVE
"a" = (
/turf/template_noop,
/area/space)
"b" = (
/turf/simulated/mineral/vacuum,
/area/space)
"c" = (
/turf/template_noop,
/area/tether_away/debrisfield/shuttle_buffer)
"d" = (
/turf/simulated/mineral/vacuum,
/area/tether_away/debrisfield/shuttle_buffer)

(1,1,1) = {"
a
a
a
a
a
a
a
a
a
a
a
a
b
b
"}
(2,1,1) = {"
a
a
a
a
a
a
a
a
a
a
b
b
b
b
"}
(3,1,1) = {"
a
a
a
a
a
a
a
a
a
b
b
b
a
a
"}
(4,1,1) = {"
a
a
a
c
c
c
c
d
c
c
d
b
a
a
"}
(5,1,1) = {"
a
a
a
c
c
c
c
c
c
c
c
a
a
a
"}
(6,1,1) = {"
a
a
a
d
c
c
d
d
d
c
c
b
a
a
"}
(7,1,1) = {"
a
b
b
d
c
c
c
d
d
c
c
b
b
a
"}
(8,1,1) = {"
a
b
b
d
c
c
c
c
c
c
c
b
a
a
"}
(9,1,1) = {"
a
b
b
d
d
c
c
c
d
d
c
a
a
a
"}
(10,1,1) = {"
a
a
b
d
d
c
c
c
d
d
d
a
a
a
"}
(11,1,1) = {"
a
a
b
d
d
c
c
c
d
d
c
a
a
a
"}
(12,1,1) = {"
a
a
a
b
a
a
a
a
b
a
a
a
a
a
"}
(13,1,1) = {"
a
a
a
a
a
b
b
a
a
a
a
a
a
a
"}
(14,1,1) = {"
a
a
a
a
a
b
b
a
a
a
a
a
a
a
"}
