//MAP CONVERTED BY dmm2tgm.py THIS HEADER COMMENT PREVENTS RECONVERSION, DO NOT REMOVE
"a" = (
/turf/template_noop,
/area/space)
"b" = (
/turf/simulated/mineral/vacuum,
/area/space)
"c" = (
/turf/template_noop,
/area/tether_away/debrisfield/shuttle_buffer)
"d" = (
/turf/simulated/mineral/vacuum,
/area/tether_away/debrisfield/shuttle_buffer)

(1,1,1) = {"
b
b
b
a
a
a
a
a
a
a
a
a
a
a
a
a
"}
(2,1,1) = {"
a
b
b
a
a
a
a
a
a
a
a
a
a
a
a
a
"}
(3,1,1) = {"
a
b
a
a
a
a
a
a
a
a
a
a
a
a
a
a
"}
(4,1,1) = {"
a
a
a
a
a
a
a
a
a
a
a
a
a
a
a
a
"}
(5,1,1) = {"
a
a
a
a
c
d
c
c
c
c
c
b
b
a
a
a
"}
(6,1,1) = {"
a
a
a
a
c
d
d
d
c
c
c
b
b
b
a
a
"}
(7,1,1) = {"
a
b
a
a
c
d
d
d
c
c
c
b
b
b
b
a
"}
(8,1,1) = {"
a
b
b
a
c
c
c
c
c
c
c
a
a
b
b
a
"}
(9,1,1) = {"
a
b
a
a
c
c
c
c
c
c
c
a
a
a
a
a
"}
(10,1,1) = {"
a
a
a
a
c
c
c
d
c
c
c
a
a
a
a
a
"}
(11,1,1) = {"
a
a
a
b
d
d
c
c
c
c
d
b
b
a
a
a
"}
(12,1,1) = {"
a
a
a
a
d
d
c
c
c
c
d
b
b
b
a
a
"}
(13,1,1) = {"
a
a
a
a
a
a
a
a
b
a
a
b
b
b
a
a
"}
(14,1,1) = {"
a
a
a
a
a
a
a
a
b
a
a
a
a
a
a
a
"}
(15,1,1) = {"
a
a
a
a
a
a
a
a
a
a
a
a
a
a
b
a
"}
(16,1,1) = {"
a
a
a
a
a
a
a
a
a
a
a
a
b
b
b
b
"}
