//MAP CONVERTED BY dmm2tgm.py THIS HEADER COMMENT PREVENTS RECONVERSION, DO NOT REMOVE
"a" = (
/turf/template_noop,
/area/space)
"b" = (
/turf/simulated/mineral/vacuum,
/area/space)
"c" = (
/turf/template_noop,
/area/submap/debrisfield/misc_debris)
"d" = (
/obj/tether_away_spawner/debrisfield/carp,
/turf/template_noop,
/area/submap/debrisfield/misc_debris)

(1,1,1) = {"
a
a
a
a
a
a
a
a
a
a
a
a
a
a
"}
(2,1,1) = {"
a
a
a
a
b
a
b
b
b
b
a
a
a
a
"}
(3,1,1) = {"
a
a
a
b
b
b
b
b
b
b
b
b
b
a
"}
(4,1,1) = {"
a
a
b
b
b
b
b
b
b
b
b
b
a
a
"}
(5,1,1) = {"
a
a
b
b
b
b
b
b
b
b
b
a
a
a
"}
(6,1,1) = {"
a
a
a
b
a
a
a
b
b
a
a
a
a
a
"}
(7,1,1) = {"
a
a
a
a
a
a
a
a
a
a
a
a
a
a
"}
(8,1,1) = {"
a
a
a
a
a
a
a
a
a
c
c
c
c
a
"}
(9,1,1) = {"
a
a
a
a
b
a
a
a
a
c
d
c
c
a
"}
(10,1,1) = {"
a
a
b
b
b
a
a
a
a
c
c
c
c
a
"}
(11,1,1) = {"
a
a
b
b
b
b
a
a
a
c
c
c
a
a
"}
(12,1,1) = {"
a
a
a
b
b
b
b
a
a
a
a
a
a
a
"}
(13,1,1) = {"
a
a
a
a
a
b
a
a
a
a
a
a
a
a
"}
(14,1,1) = {"
a
a
a
a
a
a
a
a
a
a
a
a
a
a
"}
