//MAP CONVERTED BY dmm2tgm.py THIS HEADER COMMENT PREVENTS RECONVERSION, DO NOT REMOVE
"a" = (
/turf/space,
/area/space)
"b" = (
/obj/structure/lattice,
/turf/space,
/area/space)

(1,1,1) = {"
b
b
a
"}
(2,1,1) = {"
b
b
b
"}
(3,1,1) = {"
b
b
a
"}
