//MAP CONVERTED BY dmm2tgm.py THIS HEADER COMMENT PREVENTS RECONVERSION, DO NOT REMOVE
"a" = (
/turf/space,
/area/space)
"b" = (
/obj/structure/lattice,
/turf/space,
/area/space)
"c" = (
/turf/simulated/floor/airless,
/area/space)

(1,1,1) = {"
a
b
c
"}
(2,1,1) = {"
a
b
c
"}
(3,1,1) = {"
a
c
a
"}
(4,1,1) = {"
b
c
a
"}
(5,1,1) = {"
a
c
b
"}
(6,1,1) = {"
c
b
b
"}
