//MAP CONVERTED BY dmm2tgm.py THIS HEADER COMMENT PREVENTS RECONVERSION, DO NOT REMOVE
"a" = (
/turf/template_noop,
/area/space)
"b" = (
/turf/simulated/mineral/vacuum,
/area/submap/debrisfield/foodstand)
"c" = (
/turf/simulated/mineral/floor/vacuum,
/area/submap/debrisfield/foodstand)
"d" = (
/turf/simulated/wall/wood,
/area/submap/debrisfield/foodstand)
"e" = (
/obj/structure/closet/secure_closet/freezer/meat,
/obj/item/reagent_containers/food/snacks/carpmeat,
/obj/item/reagent_containers/food/snacks/carpmeat,
/obj/item/reagent_containers/food/snacks/carpmeat,
/turf/simulated/floor/wood/airless,
/area/submap/debrisfield/foodstand)
"f" = (
/obj/structure/table/woodentable,
/obj/item/reagent_containers/food/condiment/coldsauce,
/obj/item/reagent_containers/food/condiment/ketchup,
/obj/item/reagent_containers/food/condiment/hotsauce,
/obj/item/reagent_containers/food/condiment/soysauce,
/turf/simulated/floor/wood/airless,
/area/submap/debrisfield/foodstand)
"g" = (
/obj/structure/table/woodentable,
/obj/machinery/microwave,
/turf/simulated/floor/wood/airless,
/area/submap/debrisfield/foodstand)
"h" = (
/obj/structure/simple_door/wood,
/turf/simulated/floor/wood/airless,
/area/submap/debrisfield/foodstand)
"i" = (
/turf/simulated/floor/wood/airless,
/area/submap/debrisfield/foodstand)
"j" = (
/obj/structure/closet/crate/freezer,
/obj/item/reagent_containers/food/snacks/taco,
/obj/item/reagent_containers/food/snacks/taco,
/obj/item/reagent_containers/food/snacks/taco,
/obj/item/reagent_containers/food/snacks/hotdog,
/obj/item/reagent_containers/food/snacks/hotdog,
/obj/item/reagent_containers/food/snacks/cheeseburrito,
/obj/item/reagent_containers/food/snacks/cheeseburrito,
/turf/simulated/floor/wood/airless,
/area/submap/debrisfield/foodstand)
"k" = (
/obj/structure/table/woodentable,
/obj/machinery/cash_register{
	dir = 1
	},
/turf/simulated/floor/wood/airless,
/area/submap/debrisfield/foodstand)
"l" = (
/obj/structure/table/woodentable,
/obj/item/reagent_containers/food/snacks/taco,
/turf/simulated/floor/wood/airless,
/area/submap/debrisfield/foodstand)
"m" = (
/obj/structure/table/woodentable,
/turf/simulated/floor/wood/airless,
/area/submap/debrisfield/foodstand)

(1,1,1) = {"
a
a
b
b
c
c
c
a
a
a
a
"}
(2,1,1) = {"
a
b
b
b
b
c
c
c
c
a
a
"}
(3,1,1) = {"
b
b
b
b
c
c
c
c
c
c
a
"}
(4,1,1) = {"
b
b
b
c
c
c
c
c
c
c
a
"}
(5,1,1) = {"
b
b
c
c
d
d
h
d
c
c
a
"}
(6,1,1) = {"
b
c
c
c
d
e
i
k
c
c
c
"}
(7,1,1) = {"
b
c
c
c
d
f
i
l
c
c
c
"}
(8,1,1) = {"
a
c
c
c
d
g
j
m
c
c
c
"}
(9,1,1) = {"
a
c
c
c
d
d
d
d
c
c
c
"}
(10,1,1) = {"
a
a
c
c
c
c
c
c
c
c
c
"}
(11,1,1) = {"
a
a
a
c
c
c
c
c
c
c
a
"}
(12,1,1) = {"
a
a
a
a
a
c
c
c
c
a
a
"}
(13,1,1) = {"
a
a
a
a
a
a
c
c
a
a
a
"}
