//MAP CONVERTED BY dmm2tgm.py THIS HEADER COMMENT PREVENTS RECONVERSION, DO NOT REMOVE
"aa" = (
/turf/space,
/area/space)
"ab" = (
/obj/item/weapon/material/twohanded/spear,
/turf/space,
/area/space)
"ac" = (
/obj/structure/grille,
/obj/structure/window/reinforced/full,
/obj/structure/window/reinforced{
	dir = 1
	},
/turf/simulated/shuttle/plating/airless,
/area/submap/debrisfield/misc_debris)
"ad" = (
/turf/simulated/shuttle/wall/voidcraft,
/area/submap/debrisfield/misc_debris)
"ae" = (
/obj/item/weapon/material/shard,
/obj/item/weapon/material/shard,
/obj/structure/grille/broken,
/turf/simulated/shuttle/plating/airless,
/area/submap/debrisfield/misc_debris)
"af" = (
/obj/structure/lattice,
/turf/space,
/area/space)
"ag" = (
/obj/structure/lattice,
/turf/space,
/area/submap/debrisfield/misc_debris)
"ah" = (
/turf/space,
/area/submap/debrisfield/misc_debris)
"ai" = (
/turf/simulated/shuttle/floor/black/airless,
/area/submap/debrisfield/misc_debris)
"aj" = (
/obj/structure/table/steel,
/obj/item/clothing/head/pilot,
/obj/random/unidentified_medicine/drug_den,
/turf/simulated/shuttle/floor/black/airless,
/area/submap/debrisfield/misc_debris)
"ak" = (
/turf/simulated/shuttle/wall/voidcraft/hard_corner,
/area/submap/debrisfield/misc_debris)
"al" = (
/obj/structure/table/steel,
/obj/item/clothing/head/pilot,
/turf/simulated/shuttle/floor/black/airless,
/area/submap/debrisfield/misc_debris)
"am" = (
/obj/structure/frame/computer,
/turf/simulated/shuttle/floor/black/airless,
/area/submap/debrisfield/misc_debris)
"an" = (
/obj/tether_away_spawner/debrisfield/carp/hard,
/turf/space,
/area/submap/debrisfield/misc_debris)
"ao" = (
/obj/structure/bed/chair/comfy/blue{
	icon_state = "comfychair_preview";
	dir = 1
	},
/turf/simulated/shuttle/floor/black/airless,
/area/submap/debrisfield/misc_debris)
"ap" = (
/obj/machinery/light{
	dir = 1
	},
/obj/structure/table/rack/shelf,
/obj/item/device/suit_cooling_unit,
/turf/simulated/shuttle/floor/black/airless,
/area/submap/debrisfield/misc_debris)
"aq" = (
/obj/structure/grille,
/obj/structure/window/reinforced/full,
/obj/structure/window/reinforced{
	dir = 4
	},
/turf/simulated/shuttle/plating/airless,
/area/submap/debrisfield/misc_debris)
"ar" = (
/obj/structure/grille,
/obj/structure/window/reinforced/full,
/obj/structure/window/reinforced{
	dir = 8
	},
/turf/simulated/shuttle/plating/airless,
/area/submap/debrisfield/misc_debris)
"as" = (
/obj/machinery/light{
	dir = 1
	},
/obj/structure/table/rack/shelf,
/obj/item/weapon/tank/oxygen,
/obj/item/device/suit_cooling_unit,
/obj/item/clothing/head/helmet/space/void/pilot,
/obj/item/clothing/shoes/magboots,
/obj/item/clothing/suit/space/void/pilot,
/obj/item/clothing/head/helmet/space/void/pilot,
/turf/simulated/shuttle/floor/black/airless,
/area/submap/debrisfield/misc_debris)
"at" = (
/obj/structure/grille,
/obj/structure/window/reinforced/full,
/turf/simulated/shuttle/plating/airless,
/area/submap/debrisfield/misc_debris)
"au" = (
/obj/machinery/door/airlock/voidcraft,
/turf/simulated/shuttle/floor/black/airless,
/area/submap/debrisfield/misc_debris)
"av" = (
/obj/structure/table/rack/shelf,
/obj/item/clothing/mask/breath,
/obj/item/clothing/mask/breath,
/obj/item/clothing/mask/breath,
/obj/item/clothing/mask/breath,
/obj/item/weapon/tank/emergency/oxygen/engi,
/obj/item/weapon/tank/emergency/oxygen/engi,
/obj/item/weapon/tank/emergency/oxygen/engi,
/obj/item/weapon/tank/emergency/oxygen/engi,
/turf/simulated/shuttle/floor/black/airless,
/area/submap/debrisfield/misc_debris)
"aw" = (
/obj/structure/bed/chair/shuttle,
/turf/simulated/shuttle/floor/black/airless,
/area/submap/debrisfield/misc_debris)
"ax" = (
/obj/machinery/light{
	icon_state = "tube1";
	dir = 8
	},
/obj/structure/closet/walllocker/emerglocker{
	pixel_x = -32
	},
/turf/simulated/shuttle/floor/black/airless,
/area/submap/debrisfield/misc_debris)
"ay" = (
/obj/machinery/light{
	icon_state = "tube1";
	dir = 4
	},
/obj/structure/closet/walllocker/emerglocker{
	pixel_x = 32
	},
/turf/simulated/shuttle/floor/black/airless,
/area/submap/debrisfield/misc_debris)
"az" = (
/obj/machinery/sleeper{
	dir = 8
	},
/turf/simulated/shuttle/floor/black/airless,
/area/submap/debrisfield/misc_debris)
"aA" = (
/obj/machinery/sleep_console,
/turf/simulated/shuttle/floor/black/airless,
/area/submap/debrisfield/misc_debris)
"aB" = (
/obj/structure/bed/chair/shuttle{
	dir = 1
	},
/turf/simulated/shuttle/floor/black/airless,
/area/submap/debrisfield/misc_debris)
"aC" = (
/obj/effect/floor_decal/industrial/outline/red,
/turf/simulated/shuttle/floor/darkred/airless,
/area/submap/debrisfield/misc_debris)
"aD" = (
/obj/effect/floor_decal/industrial/outline/yellow,
/obj/machinery/space_heater,
/turf/simulated/shuttle/floor/darkred/airless,
/area/submap/debrisfield/misc_debris)
"aE" = (
/obj/effect/floor_decal/industrial/outline/blue,
/turf/simulated/shuttle/floor/darkred/airless,
/area/submap/debrisfield/misc_debris)
"aF" = (
/obj/structure/grille,
/obj/structure/window/reinforced/full,
/obj/machinery/atmospherics/pipe/simple/visible/yellow{
	dir = 6
	},
/turf/simulated/shuttle/plating/airless,
/area/submap/debrisfield/misc_debris)
"aG" = (
/obj/effect/floor_decal/industrial/warning{
	icon_state = "warning";
	dir = 9
	},
/obj/machinery/atmospherics/unary/vent_pump/high_volume{
	dir = 8;
	frequency = 1380;
	id_tag = "expshuttle_docker_pump_out_internal"
	},
/turf/simulated/shuttle/floor/black/airless,
/area/submap/debrisfield/misc_debris)
"aH" = (
/obj/effect/floor_decal/industrial/warning{
	icon_state = "warning";
	dir = 1
	},
/turf/simulated/shuttle/floor/black/airless,
/area/submap/debrisfield/misc_debris)
"aI" = (
/obj/effect/floor_decal/industrial/warning{
	dir = 5
	},
/obj/machinery/atmospherics/unary/vent_pump/high_volume{
	dir = 4;
	frequency = 1380;
	id_tag = "expshuttle_vent"
	},
/turf/simulated/shuttle/floor/black/airless,
/area/submap/debrisfield/misc_debris)
"aJ" = (
/obj/machinery/atmospherics/pipe/simple/visible/cyan{
	dir = 10
	},
/turf/simulated/shuttle/wall/voidcraft,
/area/submap/debrisfield/misc_debris)
"aK" = (
/obj/machinery/atmospherics/pipe/manifold/visible/yellow{
	dir = 8
	},
/obj/machinery/door/airlock/voidcraft/vertical,
/turf/simulated/shuttle/floor/black/airless,
/area/submap/debrisfield/misc_debris)
"aL" = (
/obj/effect/floor_decal/industrial/warning{
	icon_state = "warning";
	dir = 8
	},
/obj/machinery/atmospherics/unary/vent_pump/high_volume{
	dir = 8;
	frequency = 1380;
	id_tag = "expshuttle_docker_pump_out_internal"
	},
/turf/simulated/shuttle/floor/black/airless,
/area/submap/debrisfield/misc_debris)
"aM" = (
/obj/effect/floor_decal/industrial/warning{
	icon_state = "warning";
	dir = 4
	},
/obj/machinery/atmospherics/unary/vent_pump/high_volume{
	dir = 4;
	frequency = 1380;
	id_tag = "expshuttle_vent"
	},
/turf/simulated/shuttle/floor/black/airless,
/area/submap/debrisfield/misc_debris)
"aN" = (
/obj/machinery/atmospherics/pipe/manifold/visible/cyan{
	dir = 4
	},
/obj/machinery/door/airlock/voidcraft/vertical,
/turf/simulated/shuttle/floor/black/airless,
/area/submap/debrisfield/misc_debris)
"aO" = (
/obj/effect/floor_decal/industrial/warning{
	icon_state = "warning";
	dir = 8
	},
/turf/simulated/shuttle/floor/black/airless,
/area/submap/debrisfield/misc_debris)
"aP" = (
/obj/machinery/atmospherics/pipe/manifold/visible/yellow{
	dir = 8
	},
/turf/simulated/shuttle/wall/voidcraft,
/area/submap/debrisfield/misc_debris)
"aQ" = (
/obj/effect/floor_decal/industrial/warning{
	dir = 10
	},
/obj/machinery/atmospherics/unary/vent_pump/high_volume{
	dir = 8;
	frequency = 1380;
	id_tag = "expshuttle_docker_pump_out_internal"
	},
/turf/simulated/shuttle/floor/black/airless,
/area/submap/debrisfield/misc_debris)
"aR" = (
/obj/effect/floor_decal/industrial/warning,
/turf/simulated/shuttle/floor/black/airless,
/area/submap/debrisfield/misc_debris)
"aS" = (
/obj/effect/floor_decal/industrial/warning{
	dir = 6
	},
/obj/machinery/light{
	icon_state = "tube1";
	dir = 4
	},
/obj/machinery/atmospherics/unary/vent_pump/high_volume{
	dir = 4;
	frequency = 1380;
	id_tag = "expshuttle_vent"
	},
/turf/simulated/shuttle/floor/black/airless,
/area/submap/debrisfield/misc_debris)
"aT" = (
/obj/machinery/atmospherics/pipe/manifold/visible/cyan{
	dir = 4
	},
/turf/simulated/shuttle/wall/voidcraft,
/area/submap/debrisfield/misc_debris)
"aU" = (
/obj/machinery/door/airlock/voidcraft/vertical,
/turf/simulated/shuttle/floor/black,
/area/submap/debrisfield/misc_debris)
"aV" = (
/obj/effect/floor_decal/industrial/warning/corner{
	icon_state = "warningcorner";
	dir = 1
	},
/turf/simulated/shuttle/floor/black/airless,
/area/submap/debrisfield/misc_debris)
"aW" = (
/obj/machinery/atmospherics/pipe/simple/visible/yellow{
	dir = 10
	},
/turf/simulated/shuttle/wall/voidcraft/hard_corner,
/area/submap/debrisfield/misc_debris)
"aX" = (
/obj/machinery/atmospherics/pipe/tank/air{
	dir = 4
	},
/turf/simulated/shuttle/floor/darkred/airless,
/area/submap/debrisfield/misc_debris)
"aY" = (
/obj/machinery/atmospherics/pipe/simple/visible/cyan{
	dir = 4
	},
/turf/simulated/shuttle/floor/darkred/airless,
/area/submap/debrisfield/misc_debris)
"aZ" = (
/obj/machinery/atmospherics/pipe/simple/visible/cyan{
	dir = 9
	},
/turf/simulated/shuttle/wall/voidcraft,
/area/submap/debrisfield/misc_debris)
"ba" = (
/obj/machinery/light,
/obj/effect/floor_decal/industrial/warning/corner,
/obj/effect/floor_decal/industrial/warning/corner{
	dir = 8
	},
/turf/simulated/shuttle/floor/black/airless,
/area/submap/debrisfield/misc_debris)
"bb" = (
/obj/machinery/atmospherics/unary/vent_pump/high_volume/wall_mounted{
	dir = 1;
	frequency = 1380;
	id_tag = "expshuttle_docker_pump_out_external";
	power_rating = 20000
	},
/turf/simulated/shuttle/wall/voidcraft,
/area/submap/debrisfield/misc_debris)
"bc" = (
/obj/structure/closet/crate/medical,
/obj/random/unidentified_medicine/old_medicine,
/obj/random/unidentified_medicine/old_medicine,
/obj/random/unidentified_medicine/old_medicine,
/obj/random/unidentified_medicine/fresh_medicine,
/obj/random/unidentified_medicine/fresh_medicine,
/obj/random/unidentified_medicine/combat_medicine,
/turf/simulated/shuttle/floor/darkred/airless,
/area/submap/debrisfield/misc_debris)
"bd" = (
/obj/item/weapon/storage/mre/random,
/obj/item/weapon/storage/mre/random,
/obj/item/weapon/storage/mre/random,
/obj/item/weapon/storage/mre/random,
/obj/item/weapon/storage/mre/random,
/obj/item/weapon/storage/mre/random,
/obj/structure/closet/crate,
/turf/simulated/shuttle/floor/darkred/airless,
/area/submap/debrisfield/misc_debris)
"be" = (
/obj/tether_away_spawner/debrisfield/carp,
/turf/space,
/area/space)
"bf" = (
/turf/simulated/mineral/floor/vacuum,
/area/space)
"bg" = (
/obj/effect/immovablerod,
/turf/simulated/mineral/floor/vacuum,
/area/space)
"bh" = (
/obj/structure/loot_pile/mecha/durand,
/turf/simulated/mineral/floor/vacuum,
/area/space)
"bi" = (
/obj/machinery/door/airlock/multi_tile/metal,
/turf/simulated/shuttle/floor/black/airless,
/area/submap/debrisfield/misc_debris)
"bj" = (
/obj/structure/shuttle/engine/propulsion,
/turf/simulated/shuttle/plating/airless,
/area/submap/debrisfield/misc_debris)

(1,1,1) = {"
aa
aa
aa
aa
aa
aa
aa
aa
aa
aa
aa
aa
aa
aa
aa
aa
aa
aa
aa
aa
aa
aa
"}
(2,1,1) = {"
aa
aa
aa
aa
aa
aa
aa
aa
aa
ad
ad
aa
aa
aa
aa
aa
aa
aa
aa
aa
aa
aa
"}
(3,1,1) = {"
aa
ab
aa
ad
ar
ad
ar
ad
ad
ad
aC
ah
ag
aU
ad
ad
ak
bj
aa
aa
aa
aa
"}
(4,1,1) = {"
aa
aa
ad
ak
as
ad
ai
ax
az
ad
aD
ah
ah
aH
aR
bc
ad
bj
aa
aa
aa
aa
"}
(5,1,1) = {"
aa
aa
ac
al
ai
ad
av
ai
aA
ad
aE
ag
ag
aH
aR
bd
ad
bj
aa
aa
aa
aa
"}
(6,1,1) = {"
aa
aa
ac
am
ao
at
aw
ai
aB
ah
ah
ag
ah
aH
ba
ak
ad
aa
aa
aa
aa
aa
"}
(7,1,1) = {"
aa
aa
ae
ai
ai
au
ai
ai
ai
ah
ah
at
aO
aV
aR
bi
aa
aa
be
aa
aa
aa
"}
(8,1,1) = {"
aa
aa
ag
ah
ah
ag
ah
ag
ag
ah
ah
au
ai
ai
aR
ai
aa
aa
aa
aa
aa
aa
"}
(9,1,1) = {"
aa
aa
ah
an
ah
ah
ah
ah
ah
ah
ah
ah
ag
ah
ah
af
aa
aa
aa
aa
aa
aa
"}
(10,1,1) = {"
aa
aa
ah
ah
ah
ah
ah
ah
ah
ah
ah
ah
ah
ah
ah
af
aa
aa
aa
aa
aa
aa
"}
(11,1,1) = {"
aa
aa
ag
ag
ah
ah
ah
ah
ah
ah
ah
ah
ah
ah
ah
aa
aa
aa
bf
bg
aa
aa
"}
(12,1,1) = {"
aa
ac
ai
ao
at
ah
ai
ai
ah
ah
ah
ah
ag
ah
ah
aa
aa
aa
aa
bh
aa
aa
"}
(13,1,1) = {"
aa
ac
aj
ai
ad
ah
aw
ag
ag
ag
ah
ag
ag
ah
ag
aa
aa
aa
aa
aa
aa
aa
"}
(14,1,1) = {"
aa
ad
ak
ap
ad
ah
ag
ag
aB
ad
aF
aK
aP
aP
bb
aa
aa
aa
aa
aa
aa
aa
"}
(15,1,1) = {"
aa
aa
ad
aq
ad
ah
ah
ai
aB
ad
aG
aL
aQ
aW
bb
aa
be
aa
aa
aa
aa
aa
"}
(16,1,1) = {"
aa
aa
aa
aa
aa
aa
aw
ay
aB
ad
aH
ai
aR
aX
ad
bj
aa
aa
aa
aa
aa
aa
"}
(17,1,1) = {"
aa
aa
aa
aa
aa
aa
aq
ad
ad
ad
aI
aM
aS
aY
ad
bj
aa
aa
aa
aa
aa
aa
"}
(18,1,1) = {"
aa
aa
aa
aa
aa
aa
aa
aa
aa
ad
aJ
aN
aT
aZ
ak
bj
aa
aa
aa
aa
aa
aa
"}
(19,1,1) = {"
aa
aa
aa
aa
aa
aa
aa
aa
aa
aa
aa
aa
aa
aa
aa
aa
aa
aa
aa
aa
aa
aa
"}
(20,1,1) = {"
aa
aa
aa
aa
aa
aa
aa
aa
aa
aa
aa
aa
aa
aa
aa
aa
aa
aa
aa
aa
aa
aa
"}
