//MAP CONVERTED BY dmm2tgm.py THIS HEADER COMMENT PREVENTS RECONVERSION, DO NOT REMOVE
"aa" = (
/turf/space,
/area/space)
"ab" = (
/obj/machinery/porta_turret/stationary/CIWS{
	dir = 8;
	icon_state = "destroyed_target_prism_industrial";
	stat = 1
	},
/obj/structure/lattice,
/obj/structure/cable/green{
	icon_state = "0-2"
	},
/turf/simulated/shuttle/plating/airless/carry,
/area/submap/debrisfield/tinyshuttle/bridge)
"ac" = (
/obj/structure/lattice,
/obj/structure/cable/green{
	icon_state = "1-2"
	},
/turf/simulated/shuttle/plating/airless/carry,
/area/submap/debrisfield/tinyshuttle/bridge)
"ad" = (
/turf/simulated/wall/thull,
/area/submap/debrisfield/tinyshuttle/crew)
"ae" = (
/obj/structure/window/titanium/full,
/obj/structure/window/titanium{
	dir = 1
	},
/obj/machinery/door/firedoor/glass,
/obj/machinery/door/blast/regular/open{
	dir = 4;
	id = "tinycarrier_bridge"
	},
/obj/structure/grille,
/turf/simulated/floor/plating,
/area/submap/debrisfield/tinyshuttle/crew)
"af" = (
/obj/structure/cable{
	icon_state = "1-2"
	},
/obj/machinery/door/airlock/external,
/obj/effect/map_helper/airlock/door/ext_door,
/obj/effect/floor_decal/steeldecal/monofloor{
	dir = 1
	},
/turf/simulated/floor/tiled/monotile,
/area/submap/debrisfield/tinyshuttle/crew)
"ag" = (
/obj/structure/lattice,
/turf/simulated/shuttle/plating/airless/carry,
/area/submap/debrisfield/tinyshuttle/bridge)
"ah" = (
/obj/machinery/atmospherics/unary/engine{
	dir = 8
	},
/turf/simulated/shuttle/plating/airless/carry,
/area/submap/debrisfield/tinyshuttle/engine)
"ai" = (
/obj/machinery/airlock_sensor/airlock_exterior/shuttle{
	dir = 9;
	pixel_x = -4;
	pixel_y = 8
	},
/obj/effect/map_helper/airlock/sensor/ext_sensor,
/turf/simulated/wall/thull,
/area/submap/debrisfield/tinyshuttle/crew)
"aj" = (
/obj/machinery/suit_storage_unit/standard_unit,
/obj/effect/floor_decal/corner/brown/full{
	dir = 8
	},
/turf/simulated/floor/tiled,
/area/submap/debrisfield/tinyshuttle/crew)
"ak" = (
/obj/structure/cable{
	icon_state = "2-4"
	},
/obj/effect/floor_decal/corner/brown/full{
	dir = 1
	},
/turf/simulated/floor/tiled,
/area/submap/debrisfield/tinyshuttle/crew)
"al" = (
/obj/structure/cable{
	icon_state = "4-8"
	},
/obj/machinery/door/airlock/glass_external/public,
/obj/effect/map_helper/airlock/door/int_door,
/obj/effect/floor_decal/steeldecal/monofloor{
	dir = 8
	},
/turf/simulated/floor/tiled/monotile,
/area/submap/debrisfield/tinyshuttle/crew)
"am" = (
/obj/machinery/atmospherics/unary/vent_pump/high_volume{
	dir = 4;
	id_tag = "temp"
	},
/obj/structure/cable{
	icon_state = "1-8"
	},
/obj/machinery/embedded_controller/radio/airlock/docking_port{
	dir = 8;
	frequency = 1380;
	id_tag = "debris_carrier_docker";
	pixel_x = 24;
	pixel_y = -6
	},
/obj/effect/shuttle_landmark/shuttle_initializer/tinycarrier,
/obj/machinery/airlock_sensor{
	pixel_x = 26;
	pixel_y = 6
	},
/obj/effect/map_helper/airlock/atmos/chamber_pump,
/obj/effect/map_helper/airlock/sensor/chamber_sensor,
/obj/effect/overmap/visitable/ship/landable/tinycarrier,
/turf/simulated/floor/tiled/monotile,
/area/submap/debrisfield/tinyshuttle/crew)
"an" = (
/obj/machinery/atmospherics/pipe/simple/hidden{
	dir = 8
	},
/turf/simulated/wall/thull,
/area/submap/debrisfield/tinyshuttle/crew)
"ao" = (
/turf/simulated/wall/thull,
/area/submap/debrisfield/tinyshuttle/bridge)
"ap" = (
/obj/structure/cable/green{
	icon_state = "1-2"
	},
/obj/structure/grille,
/obj/structure/window/titanium/full,
/obj/structure/window/titanium{
	dir = 1
	},
/obj/machinery/door/blast/regular/open{
	dir = 4;
	id = "tinycarrier_bridge"
	},
/turf/simulated/floor/plating,
/area/submap/debrisfield/tinyshuttle/bridge)
"aq" = (
/obj/structure/girder,
/turf/simulated/floor/airless,
/area/submap/debrisfield/tinyshuttle/bridge)
"ar" = (
/obj/machinery/portable_atmospherics/canister/air/airlock,
/obj/machinery/atmospherics/portables_connector{
	dir = 8
	},
/obj/machinery/door/window{
	dir = 2;
	name = "Airlock Canister Access"
	},
/turf/simulated/floor/tiled,
/area/submap/debrisfield/tinyshuttle/crew)
"as" = (
/obj/machinery/suit_storage_unit/standard_unit,
/obj/effect/floor_decal/corner/brown{
	dir = 9
	},
/turf/simulated/floor/tiled,
/area/submap/debrisfield/tinyshuttle/crew)
"at" = (
/obj/structure/cable{
	icon_state = "1-2"
	},
/obj/machinery/airlock_sensor/airlock_interior{
	dir = 8;
	pixel_x = 24
	},
/obj/effect/map_helper/airlock/sensor/int_sensor,
/obj/effect/floor_decal/corner/brown{
	dir = 6
	},
/turf/simulated/floor/tiled,
/area/submap/debrisfield/tinyshuttle/crew)
"au" = (
/obj/structure/grille,
/obj/structure/window/titanium/full,
/obj/structure/window/titanium{
	dir = 8
	},
/obj/machinery/door/firedoor/glass,
/obj/machinery/door/blast/regular/open{
	id = "tinycarrier_bridge"
	},
/turf/simulated/floor/plating,
/area/submap/debrisfield/tinyshuttle/bridge)
"av" = (
/obj/structure/cable/green{
	icon_state = "1-6"
	},
/obj/effect/floor_decal/corner/black/border{
	dir = 6
	},
/turf/simulated/floor/bluegrid/airless,
/area/submap/debrisfield/tinyshuttle/bridge)
"aw" = (
/obj/machinery/computer/ship/engines,
/obj/machinery/light{
	dir = 1
	},
/obj/effect/floor_decal/corner/blue/full{
	dir = 8
	},
/turf/simulated/floor/tiled/airless,
/area/submap/debrisfield/tinyshuttle/bridge)
"ax" = (
/obj/machinery/computer/shuttle_control/explore/tinycarrier,
/obj/effect/floor_decal/corner/blue{
	dir = 5
	},
/turf/simulated/floor/tiled/airless{
	broken = 1
	},
/area/submap/debrisfield/tinyshuttle/bridge)
"ay" = (
/obj/machinery/alarm/alarms_hidden{
	dir = 8;
	pixel_x = 24;
	req_one_access = list()
	},
/obj/effect/decal/cleanable/generic,
/obj/machinery/atmospherics/unary/vent_scrubber,
/obj/effect/floor_decal/corner/blue/full{
	dir = 1
	},
/turf/simulated/floor/tiled/airless{
	broken = 2
	},
/area/submap/debrisfield/tinyshuttle/bridge)
"az" = (
/obj/structure/grille,
/obj/structure/window/titanium/full,
/turf/simulated/floor/plating,
/area/submap/debrisfield/tinyshuttle/crew)
"aA" = (
/obj/item/modular_computer/laptop/preset/custom_loadout/rugged,
/obj/structure/table/steel,
/obj/effect/floor_decal/corner/brown/full{
	dir = 8
	},
/turf/simulated/floor/tiled,
/area/submap/debrisfield/tinyshuttle/crew)
"aB" = (
/obj/item/clothing/head/service,
/obj/item/clothing/head/service,
/obj/item/clothing/under/solgov/utility/fleet/combat,
/obj/item/clothing/under/solgov/utility/fleet/combat,
/obj/item/clothing/suit/storage/solgov/service/fleet,
/obj/item/clothing/suit/storage/solgov/service/fleet,
/obj/structure/closet/wardrobe/black{
	starts_with = list()
	},
/obj/effect/floor_decal/corner/brown/full{
	dir = 1
	},
/obj/item/clothing/shoes/boots/duty,
/obj/item/clothing/shoes/boots/duty,
/turf/simulated/floor/tiled,
/area/submap/debrisfield/tinyshuttle/crew)
"aC" = (
/obj/machinery/light_switch{
	dir = 4;
	pixel_x = -28
	},
/obj/effect/floor_decal/corner/brown{
	dir = 9
	},
/turf/simulated/floor/tiled,
/area/submap/debrisfield/tinyshuttle/crew)
"aD" = (
/obj/structure/cable{
	icon_state = "1-2"
	},
/obj/effect/floor_decal/corner/brown{
	dir = 4
	},
/turf/simulated/floor/tiled,
/area/submap/debrisfield/tinyshuttle/crew)
"aE" = (
/obj/effect/decal/cleanable/dirt,
/obj/effect/floor_decal/corner/brown{
	dir = 5
	},
/obj/structure/handrail,
/turf/simulated/floor/tiled,
/area/submap/debrisfield/tinyshuttle/crew)
"aF" = (
/obj/effect/floor_decal/corner/brown{
	dir = 5
	},
/turf/simulated/floor/tiled,
/area/submap/debrisfield/tinyshuttle/crew)
"aG" = (
/obj/machinery/power/apc{
	dir = 1;
	name = "north bump";
	pixel_y = 24
	},
/obj/structure/cable/green{
	icon_state = "0-2"
	},
/obj/effect/floor_decal/corner/brown{
	dir = 5
	},
/turf/simulated/floor/tiled,
/area/submap/debrisfield/tinyshuttle/crew)
"aH" = (
/obj/effect/floor_decal/corner/blue/full{
	dir = 8
	},
/obj/machinery/computer/ship/helm{
	dir = 4;
	req_one_access = list()
	},
/turf/simulated/floor/tiled/airless,
/area/submap/debrisfield/tinyshuttle/bridge)
"aI" = (
/obj/structure/cable/green{
	icon_state = "4-9"
	},
/obj/structure/cable/green{
	icon_state = "4-10"
	},
/obj/structure/bed/chair/shuttle{
	dir = 8
	},
/obj/effect/floor_decal/corner/blue{
	dir = 1
	},
/turf/simulated/floor/tiled/airless,
/area/submap/debrisfield/tinyshuttle/bridge)
"aJ" = (
/obj/machinery/atmospherics/unary/vent_pump{
	dir = 4
	},
/obj/structure/cable/green{
	icon_state = "4-8"
	},
/turf/simulated/floor/tiled/airless,
/area/submap/debrisfield/tinyshuttle/bridge)
"aK" = (
/obj/structure/cable/green{
	icon_state = "2-4"
	},
/obj/machinery/atmospherics/pipe/simple/hidden{
	dir = 8
	},
/obj/structure/cable/green{
	icon_state = "4-8"
	},
/obj/machinery/atmospherics/pipe/simple/hidden/scrubbers{
	dir = 5
	},
/obj/effect/floor_decal/corner/blue{
	dir = 6
	},
/turf/simulated/floor/tiled/airless,
/area/submap/debrisfield/tinyshuttle/bridge)
"aL" = (
/obj/structure/bed/chair{
	dir = 1
	},
/obj/effect/floor_decal/corner/brown{
	dir = 1
	},
/turf/simulated/floor/tiled,
/area/submap/debrisfield/tinyshuttle/crew)
"aM" = (
/obj/item/trash/coffee,
/turf/simulated/floor/tiled,
/area/submap/debrisfield/tinyshuttle/crew)
"aN" = (
/obj/structure/prop{
	desc = "A man-sized pod for entering suspended animation. This one is room temperature.";
	dir = 8;
	icon = 'icons/obj/Cryogenic2_vr.dmi';
	icon_state = "cryopod_0";
	name = "cryogenic freezer"
	},
/obj/effect/floor_decal/corner/brown/full{
	dir = 1
	},
/turf/simulated/floor/tiled,
/area/submap/debrisfield/tinyshuttle/crew)
"aO" = (
/obj/structure/cable/green{
	icon_state = "4-8"
	},
/obj/machinery/atmospherics/pipe/simple/hidden{
	dir = 8
	},
/obj/machinery/door/airlock/hatch{
	req_one_access = list()
	},
/obj/machinery/door/firedoor/glass,
/obj/machinery/atmospherics/pipe/simple/hidden/scrubbers{
	dir = 8
	},
/turf/simulated/floor/tiled/airless,
/area/submap/debrisfield/tinyshuttle/crew)
"aP" = (
/obj/structure/cable/green{
	icon_state = "6-8"
	},
/obj/machinery/atmospherics/pipe/simple/hidden{
	dir = 10
	},
/obj/machinery/atmospherics/pipe/simple/hidden/scrubbers{
	dir = 10
	},
/obj/effect/floor_decal/corner/brown{
	dir = 9
	},
/turf/simulated/floor/tiled,
/area/submap/debrisfield/tinyshuttle/crew)
"aQ" = (
/obj/structure/cable{
	icon_state = "1-4"
	},
/obj/machinery/atmospherics/unary/vent_pump/on{
	dir = 4
	},
/turf/simulated/floor/tiled,
/area/submap/debrisfield/tinyshuttle/crew)
"aR" = (
/obj/structure/cable{
	icon_state = "4-8"
	},
/obj/machinery/atmospherics/pipe/simple/hidden{
	dir = 10
	},
/turf/simulated/floor/tiled,
/area/submap/debrisfield/tinyshuttle/crew)
"aS" = (
/obj/structure/cable{
	icon_state = "4-8"
	},
/obj/machinery/atmospherics/unary/vent_scrubber/on,
/turf/simulated/floor/tiled,
/area/submap/debrisfield/tinyshuttle/crew)
"aT" = (
/obj/structure/cable{
	icon_state = "4-8"
	},
/obj/structure/cable/green{
	icon_state = "1-2"
	},
/obj/effect/decal/cleanable/dirt,
/turf/simulated/floor/tiled,
/area/submap/debrisfield/tinyshuttle/crew)
"aU" = (
/obj/machinery/atmospherics/pipe/simple/hidden/fuel{
	dir = 6
	},
/turf/simulated/wall/thull,
/area/submap/debrisfield/tinyshuttle/engine)
"aV" = (
/obj/machinery/porta_turret/stationary/CIWS{
	dir = 10;
	icon_state = "destroyed_target_prism_industrial";
	stat = 1
	},
/obj/structure/lattice,
/obj/structure/cable/green,
/turf/simulated/shuttle/plating/airless/carry,
/area/submap/debrisfield/tinyshuttle/bridge)
"aW" = (
/obj/machinery/computer/ship/sensors{
	dir = 4
	},
/obj/structure/cable/green{
	icon_state = "2-5"
	},
/obj/effect/floor_decal/corner/blue/full,
/turf/simulated/floor/tiled/airless,
/area/submap/debrisfield/tinyshuttle/bridge)
"aX" = (
/obj/structure/table/steel_reinforced,
/obj/machinery/button/remote/blast_door{
	id = "tinycarrier_bridge";
	name = "Bridge Blast Doors";
	pixel_x = -6;
	pixel_y = 4
	},
/obj/machinery/button/remote/blast_door{
	id = "tinycarrier_hangar";
	name = "Hangar Blast Doors";
	pixel_x = 6;
	pixel_y = 4
	},
/obj/machinery/button/remote/blast_door{
	id = "tinycarrier_sensors";
	name = "Sensor Shroud";
	pixel_y = -24
	},
/obj/effect/floor_decal/corner/blue{
	dir = 10
	},
/turf/simulated/floor/tiled/airless,
/area/submap/debrisfield/tinyshuttle/bridge)
"aY" = (
/obj/machinery/turretid/lethal{
	pixel_y = 4;
	req_access = list()
	},
/obj/structure/table/steel_reinforced,
/obj/effect/floor_decal/corner/blue{
	dir = 10
	},
/turf/simulated/floor/tiled/airless,
/area/submap/debrisfield/tinyshuttle/bridge)
"aZ" = (
/obj/machinery/power/apc{
	dir = 4;
	name = "east bump";
	pixel_x = 28
	},
/obj/structure/cable/green,
/obj/effect/decal/cleanable/dirt,
/obj/machinery/light_switch{
	dir = 1;
	pixel_x = 22;
	pixel_y = -24
	},
/obj/effect/floor_decal/corner/blue/full{
	dir = 4
	},
/turf/simulated/floor/tiled/airless,
/area/submap/debrisfield/tinyshuttle/bridge)
"ba" = (
/obj/structure/cable{
	icon_state = "2-8"
	},
/obj/machinery/atmospherics/pipe/simple/hidden{
	dir = 6
	},
/turf/simulated/floor/tiled,
/area/submap/debrisfield/tinyshuttle/crew)
"bb" = (
/obj/machinery/atmospherics/unary/vent_pump/on{
	dir = 8
	},
/turf/simulated/floor/tiled,
/area/submap/debrisfield/tinyshuttle/crew)
"bc" = (
/obj/machinery/sleeper{
	controls_inside = 1;
	dir = 8
	},
/obj/machinery/light{
	dir = 4
	},
/obj/effect/floor_decal/corner/brown{
	dir = 6
	},
/turf/simulated/floor/tiled,
/area/submap/debrisfield/tinyshuttle/crew)
"bd" = (
/obj/machinery/atmospherics/pipe/simple/hidden{
	dir = 5
	},
/obj/structure/closet/secure_closet/guncabinet/sidearm{
	anchored = 1;
	starts_with = list()
	},
/obj/item/gun/projectile/p92x/large,
/obj/item/gun/projectile/p92x/large,
/obj/machinery/atmospherics/pipe/simple/hidden/scrubbers{
	dir = 5
	},
/obj/effect/floor_decal/corner/brown/full,
/obj/item/ammo_magazine/m9mm/large,
/obj/item/ammo_magazine/m9mm/large,
/obj/item/ammo_magazine/m9mm/large,
/obj/item/ammo_magazine/m9mm/large,
/turf/simulated/floor/tiled,
/area/submap/debrisfield/tinyshuttle/crew)
"be" = (
/obj/structure/cable/green{
	icon_state = "4-9"
	},
/obj/machinery/atmospherics/pipe/simple/hidden{
	dir = 8
	},
/obj/machinery/atmospherics/pipe/simple/hidden/scrubbers{
	dir = 8
	},
/obj/effect/floor_decal/corner/brown{
	dir = 10
	},
/turf/simulated/floor/tiled,
/area/submap/debrisfield/tinyshuttle/crew)
"bf" = (
/obj/structure/cable/green{
	icon_state = "4-8"
	},
/obj/structure/cable/green{
	icon_state = "2-4"
	},
/obj/machinery/atmospherics/pipe/manifold4w/hidden,
/obj/machinery/atmospherics/pipe/manifold/hidden/scrubbers{
	dir = 1
	},
/obj/effect/floor_decal/corner/brown{
	dir = 10
	},
/turf/simulated/floor/tiled,
/area/submap/debrisfield/tinyshuttle/crew)
"bg" = (
/obj/structure/cable/green{
	icon_state = "4-8"
	},
/obj/machinery/atmospherics/pipe/simple/hidden{
	dir = 8
	},
/obj/machinery/atmospherics/pipe/manifold/hidden/scrubbers,
/obj/effect/floor_decal/corner/brown{
	dir = 10
	},
/obj/machinery/light,
/turf/simulated/floor/tiled,
/area/submap/debrisfield/tinyshuttle/crew)
"bh" = (
/obj/machinery/atmospherics/pipe/manifold/hidden/fuel{
	dir = 8
	},
/turf/simulated/wall/thull,
/area/submap/debrisfield/tinyshuttle/engine)
"bi" = (
/turf/simulated/wall/thull,
/area/submap/debrisfield/tinyshuttle/hangar)
"bj" = (
/obj/structure/cable/green{
	icon_state = "1-2"
	},
/obj/machinery/atmospherics/pipe/simple/hidden,
/obj/machinery/door/airlock/hatch{
	req_one_access = list()
	},
/obj/machinery/door/firedoor/glass,
/obj/machinery/atmospherics/pipe/simple/hidden/scrubbers{
	dir = 1
	},
/turf/simulated/floor/tiled/techmaint/airless,
/area/submap/debrisfield/tinyshuttle/hangar)
"bk" = (
/turf/simulated/wall/thull,
/area/submap/debrisfield/tinyshuttle/engine)
"bl" = (
/obj/structure/cable/green{
	icon_state = "6-8"
	},
/obj/structure/cable/green{
	icon_state = "1-6"
	},
/obj/machinery/atmospherics/pipe/simple/hidden{
	dir = 8
	},
/obj/machinery/atmospherics/pipe/simple/hidden/scrubbers{
	dir = 8
	},
/obj/effect/floor_decal/corner/brown{
	dir = 10
	},
/obj/machinery/alarm/alarms_hidden{
	dir = 1;
	pixel_y = -24
	},
/turf/simulated/floor/tiled,
/area/submap/debrisfield/tinyshuttle/crew)
"bm" = (
/obj/structure/cable{
	icon_state = "1-2"
	},
/obj/machinery/atmospherics/pipe/manifold/hidden{
	dir = 4
	},
/obj/machinery/atmospherics/pipe/simple/hidden/scrubbers{
	dir = 10
	},
/obj/effect/floor_decal/corner/brown{
	dir = 10
	},
/turf/simulated/floor/tiled,
/area/submap/debrisfield/tinyshuttle/crew)
"bn" = (
/obj/effect/floor_decal/industrial/warning/cee{
	dir = 8
	},
/obj/machinery/shipsensors{
	dir = 8;
	use_power = 0
	},
/turf/simulated/floor/greengrid/airless,
/area/submap/debrisfield/tinyshuttle/bridge)
"bo" = (
/obj/structure/cable{
	icon_state = "1-2"
	},
/obj/structure/cable/green{
	icon_state = "9-10"
	},
/obj/machinery/atmospherics/pipe/simple/hidden,
/obj/machinery/door/airlock/hatch{
	req_one_access = list()
	},
/obj/machinery/door/firedoor/glass,
/obj/machinery/atmospherics/pipe/simple/hidden/scrubbers,
/turf/simulated/floor/tiled/airless,
/area/submap/debrisfield/tinyshuttle/engine)
"bp" = (
/obj/effect/floor_decal/industrial/warning{
	dir = 4
	},
/obj/machinery/door/blast/regular{
	id = "tinycarrier_sensors"
	},
/turf/simulated/floor/airless,
/area/submap/debrisfield/tinyshuttle/bridge)
"bq" = (
/obj/structure/cable/green{
	icon_state = "1-2"
	},
/obj/machinery/atmospherics/pipe/simple/hidden,
/obj/machinery/atmospherics/pipe/simple/hidden/scrubbers{
	dir = 9
	},
/obj/item/clothing/shoes/magboots,
/turf/simulated/floor/tiled/techmaint/airless,
/area/submap/debrisfield/tinyshuttle/hangar)
"br" = (
/obj/machinery/mecha_part_fabricator{
	req_access = list()
	},
/obj/machinery/light{
	dir = 1
	},
/turf/simulated/floor/tiled/techmaint/airless,
/area/submap/debrisfield/tinyshuttle/hangar)
"bs" = (
/obj/structure/extinguisher_cabinet{
	dir = 1;
	pixel_y = 32
	},
/obj/structure/table/steel,
/obj/machinery/atmospherics/unary/vent_scrubber{
	dir = 4
	},
/obj/item/tool/crowbar,
/obj/item/tool/wrench,
/obj/item/tool/screwdriver{
	pixel_y = 8
	},
/turf/simulated/floor/tiled/techmaint/airless,
/area/submap/debrisfield/tinyshuttle/hangar)
"bt" = (
/obj/structure/cable/green{
	icon_state = "5-6"
	},
/obj/structure/extinguisher_cabinet{
	dir = 4;
	pixel_x = -30
	},
/obj/machinery/atmospherics/portables_connector{
	dir = 4
	},
/obj/machinery/portable_atmospherics/canister/air,
/obj/effect/floor_decal/corner/orange/full{
	dir = 8
	},
/turf/simulated/floor/tiled/steel,
/area/submap/debrisfield/tinyshuttle/engine)
"bu" = (
/obj/machinery/power/smes/buildable/outpost_substation{
	charge = 3e+006;
	input_attempt = 1;
	input_level = 200000
	},
/obj/structure/cable/green{
	icon_state = "0-2"
	},
/turf/simulated/floor/tiled/steel,
/area/submap/debrisfield/tinyshuttle/engine)
"bv" = (
/obj/machinery/atmospherics/pipe/simple/hidden/fuel,
/turf/simulated/wall/thull,
/area/submap/debrisfield/tinyshuttle/engine)
"bw" = (
/obj/structure/cable{
	icon_state = "1-4"
	},
/obj/machinery/atmospherics/pipe/manifold/hidden{
	dir = 4
	},
/obj/machinery/atmospherics/pipe/manifold/hidden/scrubbers{
	dir = 8
	},
/obj/effect/floor_decal/corner/orange{
	dir = 5
	},
/turf/simulated/floor/tiled/steel,
/area/submap/debrisfield/tinyshuttle/engine)
"bx" = (
/obj/structure/grille,
/obj/structure/window/titanium/full,
/obj/structure/window/titanium{
	dir = 8
	},
/obj/machinery/door/firedoor/glass,
/obj/machinery/door/blast/regular/open{
	id = "tinycarrier_bridge"
	},
/obj/structure/window/titanium{
	dir = 1
	},
/turf/simulated/floor/plating,
/area/submap/debrisfield/tinyshuttle/bridge)
"by" = (
/obj/machinery/atmospherics/unary/vent_pump{
	dir = 4
	},
/obj/effect/floor_decal/industrial/warning/dust,
/turf/simulated/floor/tiled/techmaint/airless,
/area/submap/debrisfield/tinyshuttle/hangar)
"bz" = (
/obj/structure/handrail{
	dir = 8
	},
/obj/structure/cable/green{
	icon_state = "1-2"
	},
/obj/machinery/atmospherics/pipe/simple/hidden{
	dir = 9
	},
/obj/machinery/light_switch{
	dir = 8;
	pixel_x = 26;
	pixel_y = 8
	},
/obj/effect/floor_decal/industrial/warning/dust,
/turf/simulated/floor/tiled/techmaint/airless,
/area/submap/debrisfield/tinyshuttle/hangar)
"bA" = (
/obj/structure/handrail{
	dir = 4
	},
/obj/effect/floor_decal/industrial/warning/dust,
/turf/simulated/floor/tiled/techmaint/airless,
/area/submap/debrisfield/tinyshuttle/hangar)
"bB" = (
/obj/structure/table/rack/steel,
/obj/item/storage/toolbox/mechanical{
	starts_with = list(/obj/item/tool/screwdriver,/obj/item/tool/wrench,/obj/item/tool/crowbar,/obj/item/analyzer,/obj/item/tool/wirecutters)
	},
/obj/item/t_scanner,
/obj/effect/floor_decal/corner/orange{
	dir = 9
	},
/turf/simulated/floor/tiled/steel,
/area/submap/debrisfield/tinyshuttle/engine)
"bC" = (
/obj/machinery/power/terminal{
	dir = 4
	},
/obj/machinery/power/port_gen/pacman{
	anchored = 1
	},
/obj/structure/cable{
	icon_state = "0-8"
	},
/obj/machinery/atmospherics/pipe/simple/hidden/scrubbers{
	dir = 10
	},
/obj/effect/floor_decal/corner/orange/full{
	dir = 1
	},
/obj/machinery/light{
	dir = 1
	},
/turf/simulated/floor/tiled/steel,
/area/submap/debrisfield/tinyshuttle/engine)
"bD" = (
/obj/structure/cable/green{
	icon_state = "4-9"
	},
/obj/machinery/atmospherics/pipe/simple/hidden,
/obj/machinery/atmospherics/pipe/simple/hidden/scrubbers{
	dir = 5
	},
/turf/simulated/floor/tiled/steel_ridged,
/area/submap/debrisfield/tinyshuttle/engine)
"bE" = (
/obj/machinery/atmospherics/pipe/simple/hidden/fuel,
/obj/machinery/atmospherics/pipe/simple/hidden/universal{
	dir = 8
	},
/turf/simulated/wall/thull,
/area/submap/debrisfield/tinyshuttle/engine)
"bF" = (
/obj/structure/cable/green{
	icon_state = "1-2"
	},
/obj/structure/grille,
/obj/structure/window/titanium/full,
/obj/structure/window/titanium,
/obj/machinery/door/blast/regular/open{
	dir = 4;
	id = "tinycarrier_bridge"
	},
/turf/simulated/floor/plating,
/area/submap/debrisfield/tinyshuttle/bridge)
"bG" = (
/obj/item/clothing/shoes/magboots,
/turf/simulated/floor/reinforced/airless,
/area/submap/debrisfield/tinyshuttle/hangar)
"bH" = (
/turf/simulated/floor/reinforced/airless,
/area/submap/debrisfield/tinyshuttle/hangar)
"bI" = (
/obj/machinery/power/apc{
	dir = 4;
	name = "east bump";
	pixel_x = 28
	},
/obj/structure/cable/green,
/turf/simulated/floor/reinforced/airless,
/area/submap/debrisfield/tinyshuttle/hangar)
"bJ" = (
/obj/structure/cable/green{
	icon_state = "4-8"
	},
/obj/effect/decal/cleanable/dirt,
/obj/machinery/atmospherics/pipe/simple/hidden/scrubbers{
	dir = 5
	},
/obj/machinery/atmospherics/unary/vent_scrubber/on{
	dir = 8
	},
/obj/effect/floor_decal/corner/orange{
	dir = 4
	},
/turf/simulated/floor/tiled/steel_ridged,
/area/submap/debrisfield/tinyshuttle/engine)
"bK" = (
/obj/machinery/atmospherics/portables_connector/fuel{
	dir = 4
	},
/obj/effect/floor_decal/corner/orange{
	dir = 9
	},
/obj/effect/decal/cleanable/liquid_fuel,
/turf/simulated/floor/tiled/steel_dirty,
/area/submap/debrisfield/tinyshuttle/engine)
"bL" = (
/obj/machinery/atmospherics/unary/vent_pump/on{
	dir = 8
	},
/turf/simulated/floor/tiled/steel_ridged,
/area/submap/debrisfield/tinyshuttle/engine)
"bM" = (
/obj/machinery/power/apc{
	dir = 4;
	name = "east bump";
	pixel_x = 28
	},
/obj/structure/cable/green{
	icon_state = "1-8"
	},
/obj/structure/cable/green,
/obj/machinery/atmospherics/pipe/simple/hidden/scrubbers{
	dir = 8
	},
/obj/effect/floor_decal/corner/orange/full{
	dir = 1
	},
/turf/simulated/floor/tiled/steel,
/area/submap/debrisfield/tinyshuttle/engine)
"bN" = (
/obj/machinery/atmospherics/pipe/simple/hidden/fuel{
	dir = 10
	},
/obj/machinery/atmospherics/pipe/simple/hidden{
	dir = 5
	},
/obj/effect/decal/cleanable/liquid_fuel,
/obj/item/multitool,
/turf/simulated/floor/tiled/steel_ridged,
/area/submap/debrisfield/tinyshuttle/engine)
"bO" = (
/obj/machinery/alarm/alarms_hidden{
	dir = 8;
	pixel_x = 24;
	req_one_access = list()
	},
/turf/simulated/floor/reinforced/airless,
/area/submap/debrisfield/tinyshuttle/hangar)
"bP" = (
/obj/structure/fans/hardlight,
/obj/machinery/door/blast/regular{
	id = "tinycarrier_hangar"
	},
/turf/simulated/floor/reinforced/airless,
/area/submap/debrisfield/tinyshuttle/hangar)
"bQ" = (
/obj/structure/handrail{
	dir = 8
	},
/obj/effect/floor_decal/corner/orange{
	dir = 6
	},
/turf/simulated/floor/tiled/steel,
/area/submap/debrisfield/tinyshuttle/engine)
"bR" = (
/obj/machinery/atmospherics/portables_connector/fuel{
	dir = 4
	},
/obj/machinery/portable_atmospherics/canister/empty/phoron{
	destroyed = 1;
	health = 0;
	icon_state = "orangeps-1"
	},
/obj/effect/decal/cleanable/liquid_fuel,
/obj/effect/floor_decal/corner/orange/full,
/turf/simulated/floor/tiled/steel_dirty,
/area/submap/debrisfield/tinyshuttle/engine)
"bS" = (
/obj/machinery/atmospherics/pipe/manifold/hidden/fuel,
/obj/machinery/firealarm/alarms_hidden{
	dir = 1;
	pixel_y = -24
	},
/obj/effect/decal/cleanable/liquid_fuel,
/obj/effect/floor_decal/corner/orange{
	dir = 10
	},
/turf/simulated/floor/tiled/steel_dirty,
/area/submap/debrisfield/tinyshuttle/engine)
"bT" = (
/obj/machinery/atmospherics/pipe/manifold4w/hidden/fuel,
/turf/simulated/wall/thull,
/area/submap/debrisfield/tinyshuttle/engine)
"bU" = (
/obj/structure/lattice,
/obj/machinery/atmospherics/pipe/vent{
	dir = 8
	},
/turf/simulated/shuttle/plating/airless/carry,
/area/submap/debrisfield/tinyshuttle/engine)
"bV" = (
/obj/machinery/firealarm/alarms_hidden{
	dir = 8;
	pixel_x = 24
	},
/turf/simulated/floor/reinforced/airless,
/area/submap/debrisfield/tinyshuttle/hangar)
"bW" = (
/obj/mecha/combat/fighter/baron/busted{
	dir = 8;
	dir_in = 8
	},
/turf/simulated/floor/reinforced/airless,
/area/submap/debrisfield/tinyshuttle/hangar)
"bX" = (
/obj/machinery/mech_recharger,
/turf/simulated/floor/reinforced/airless,
/area/submap/debrisfield/tinyshuttle/hangar)
"bY" = (
/obj/machinery/atmospherics/pipe/simple/hidden/fuel{
	dir = 5
	},
/turf/simulated/wall/thull,
/area/submap/debrisfield/tinyshuttle/engine)
"bZ" = (
/obj/machinery/mech_recharger,
/obj/machinery/light,
/turf/simulated/floor/reinforced/airless,
/area/submap/debrisfield/tinyshuttle/hangar)
"ca" = (
/obj/effect/decal/cleanable/blood/gibs/robot,
/turf/simulated/floor/reinforced/airless,
/area/submap/debrisfield/tinyshuttle/hangar)
"cb" = (
/turf/simulated/shuttle/plating/airless/carry,
/area/submap/debrisfield/tinyshuttle/hangar)
"cc" = (
/obj/structure/lattice,
/turf/simulated/shuttle/plating/airless/carry,
/area/submap/debrisfield/tinyshuttle/hangar)
"cd" = (
/obj/structure/loot_pile/surface/drone{
	density = 1;
	dir = 8;
	icon = 'icons/mob/animal_vr64x64.dmi';
	icon_state = "drone";
	pixel_x = -16;
	pixel_y = -16
	},
/turf/simulated/floor/reinforced/airless,
/area/submap/debrisfield/tinyshuttle/hangar)
"ce" = (
/obj/machinery/atmospherics/pipe/simple/hidden/fuel{
	dir = 8
	},
/obj/machinery/meter,
/obj/machinery/light_switch{
	dir = 1;
	on = 0;
	pixel_x = -10;
	pixel_y = -24
	},
/obj/effect/floor_decal/corner/orange/full{
	dir = 4
	},
/obj/structure/fuel_port/empty_tank{
	pixel_x = 26
	},
/turf/simulated/floor/tiled/steel_dirty,
/area/submap/debrisfield/tinyshuttle/engine)
"cf" = (
/obj/item/material/shard/titaniumglass,
/turf/simulated/shuttle/plating/airless/carry,
/area/submap/debrisfield/tinyshuttle/hangar)
"cg" = (
/obj/structure/girder,
/turf/simulated/floor/airless,
/area/submap/debrisfield/tinyshuttle/hangar)
"ch" = (
/obj/machinery/atmospherics/binary/pump/fuel{
	dir = 4
	},
/obj/machinery/alarm/alarms_hidden{
	dir = 1;
	pixel_y = -24
	},
/obj/item/weldingtool/electric,
/obj/effect/floor_decal/corner/orange{
	dir = 10
	},
/turf/simulated/floor/tiled/steel_dirty,
/area/submap/debrisfield/tinyshuttle/engine)
"ci" = (
/obj/structure/lattice,
/mob/living/simple_mob/mechanical/combat_drone/lesser,
/turf/simulated/shuttle/plating/airless/carry,
/area/submap/debrisfield/tinyshuttle/hangar)
"cj" = (
/obj/effect/floor_decal/corner/brown{
	dir = 10
	},
/turf/simulated/floor/tiled,
/area/submap/debrisfield/tinyshuttle/crew)
"ck" = (
/obj/structure/prop{
	desc = "A man-sized pod for entering suspended animation. This one is room temperature.";
	dir = 8;
	icon = 'icons/obj/Cryogenic2_vr.dmi';
	icon_state = "cryopod_0";
	name = "cryogenic freezer"
	},
/obj/effect/floor_decal/corner/brown/full{
	dir = 4
	},
/turf/simulated/floor/tiled,
/area/submap/debrisfield/tinyshuttle/crew)
"cl" = (
/obj/effect/decal/mecha_wreckage/baron,
/turf/simulated/shuttle/plating/airless/carry,
/area/submap/debrisfield/tinyshuttle/hangar)
"cm" = (
/obj/structure/lattice,
/obj/item/material/shard/titaniumglass,
/turf/simulated/shuttle/plating/airless/carry,
/area/submap/debrisfield/tinyshuttle/hangar)

(1,1,1) = {"
aa
aa
ao
bx
au
au
ao
aa
aa
aa
aa
aa
aa
aa
aa
"}
(2,1,1) = {"
ab
ac
ap
av
aH
aW
bF
ac
aV
aa
aa
aa
aa
aa
aa
"}
(3,1,1) = {"
aa
aa
ao
aw
aI
aX
ao
aa
aa
aa
aa
aa
aa
aa
aa
"}
(4,1,1) = {"
aa
aa
aq
ax
aJ
aY
ao
bp
ao
aa
aa
aa
aa
aa
aa
"}
(5,1,1) = {"
aa
ag
aq
ay
aK
aZ
ao
bn
ao
bi
bP
bP
bi
bi
aa
"}
(6,1,1) = {"
ad
ad
ad
ad
aO
ad
bi
bi
bi
bG
bH
bH
bH
bi
bi
"}
(7,1,1) = {"
ad
aj
as
aC
aP
bd
bi
br
bA
bW
bH
bX
bH
bZ
bi
"}
(8,1,1) = {"
ae
ak
at
aD
aQ
be
bi
bs
by
bH
bH
bH
bH
ca
cm
"}
(9,1,1) = {"
ad
al
ad
aE
aR
bf
bj
bq
bz
bI
bO
bV
bH
cc
cl
"}
(10,1,1) = {"
af
am
az
aF
aS
bg
bk
bk
bk
bk
bk
bk
cc
cb
cb
"}
(11,1,1) = {"
ai
an
ad
aG
aT
bl
bk
bt
bB
bK
bR
bk
cc
cf
cb
"}
(12,1,1) = {"
ad
ar
aA
aL
ba
bm
bo
bw
bD
bN
bS
bk
cc
ci
cf
"}
(13,1,1) = {"
ad
ad
aB
aM
bb
cj
bk
bC
bJ
bL
ch
bk
bH
cc
cb
"}
(14,1,1) = {"
aa
ad
ad
aN
bc
ck
bk
bu
bM
bQ
ce
bi
cd
bH
cc
"}
(15,1,1) = {"
aa
aa
ad
ad
aU
bh
bh
bv
bE
bv
bT
bh
bY
bi
cg
"}
(16,1,1) = {"
aa
aa
aa
ad
ah
ah
ah
bk
bU
bk
ah
ah
ah
bi
aa
"}
