//MAP CONVERTED BY dmm2tgm.py THIS HEADER COMMENT PREVENTS RECONVERSION, DO NOT REMOVE
"a" = (
/turf/template_noop,
/area/template_noop)
"b" = (
/obj/random/turf/lava,
/turf/simulated/floor/outdoors/rocks/caves,
/area/submap/geyser_2)
"c" = (
/turf/simulated/floor/outdoors/rocks/caves,
/area/submap/geyser_2)
"d" = (
/obj/structure/fence/corner{
	icon_state = "corner";
	dir = 9
	},
/turf/simulated/floor/outdoors/rocks/caves,
/area/submap/geyser_2)
"e" = (
/obj/structure/fence{
	icon_state = "straight";
	dir = 8
	},
/turf/simulated/floor/outdoors/rocks/caves,
/area/submap/geyser_2)
"f" = (
/obj/structure/fence/corner{
	icon_state = "corner";
	dir = 5
	},
/turf/simulated/floor/outdoors/rocks/caves,
/area/submap/geyser_2)
"g" = (
/obj/structure/fence/cut/large,
/turf/simulated/floor/outdoors/rocks/caves,
/area/submap/geyser_2)
"h" = (
/mob/living/simple_mob/mechanical/viscerator,
/turf/simulated/floor/outdoors/rocks/caves,
/area/submap/geyser_2)
"i" = (
/obj/structure/fence,
/turf/simulated/floor/outdoors/rocks/caves,
/area/submap/geyser_2)
"j" = (
/obj/structure/fence/corner{
	icon_state = "corner";
	dir = 10
	},
/turf/simulated/floor/outdoors/rocks/caves,
/area/submap/geyser_2)
"k" = (
/obj/structure/fence/door/locked,
/turf/simulated/floor/outdoors/rocks/caves,
/area/submap/geyser_2)
"l" = (
/obj/structure/fence/corner{
	icon_state = "corner";
	dir = 6
	},
/turf/simulated/floor/outdoors/rocks/caves,
/area/submap/geyser_2)
"m" = (
/obj/effect/map_effect/interval/effect_emitter/steam,
/obj/effect/map_effect/interval/effect_emitter/smoke/mist{
	interval_upper_bound = 600
	},
/obj/effect/map_effect/interval/effect_emitter/smoke/bad{
	interval_lower_bound = 100;
	interval_upper_bound = 3000
	},
/obj/effect/map_effect/interval/screen_shaker{
	interval_upper_bound = 600
	},
/obj/random/humanoidremains,
/obj/random/medical/lite,
/turf/simulated/floor/water/deep{
	outdoors = 0
	},
/area/submap/geyser_2)

(1,1,1) = {"
a
b
b
c
b
b
a
"}
(2,1,1) = {"
b
b
b
h
b
b
b
"}
(3,1,1) = {"
b
b
d
g
j
b
b
"}
(4,1,1) = {"
c
h
e
m
k
h
c
"}
(5,1,1) = {"
b
b
f
i
l
b
b
"}
(6,1,1) = {"
b
b
b
h
b
b
b
"}
(7,1,1) = {"
a
b
b
c
b
b
a
"}
