//MAP CONVERTED BY dmm2tgm.py THIS HEADER COMMENT PREVENTS RECONVERSION, DO NOT REMOVE
"a" = (
/turf/template_noop,
/area/template_noop)
"b" = (
/turf/simulated/mineral/cave,
/area/submap/cave/swordcave)
"c" = (
/turf/simulated/mineral/floor/ignore_mapgen/cave,
/area/submap/cave/swordcave)
"d" = (
/obj/machinery/crystal,
/turf/simulated/mineral/floor/ignore_mapgen/cave,
/area/submap/cave/swordcave)
"e" = (
/turf/simulated/floor/water,
/area/submap/cave/swordcave)
"f" = (
/turf/simulated/floor/water/deep,
/area/submap/cave/swordcave)
"g" = (
/obj/structure/ghost_pod/manual/cursedblade,
/turf/simulated/mineral/floor/ignore_mapgen/cave,
/area/submap/cave/swordcave)
"h" = (
/mob/living/simple_mob/faithless/cult,
/turf/simulated/mineral/floor/ignore_mapgen/cave,
/area/submap/cave/swordcave)
"i" = (
/obj/item/device/gps/explorer/on,
/turf/simulated/mineral/floor/ignore_mapgen/cave,
/area/submap/cave/swordcave)
"j" = (
/obj/structure/loot_pile/surface/bones,
/turf/simulated/mineral/floor/ignore_mapgen/cave,
/area/submap/cave/swordcave)
"k" = (
/mob/living/simple_mob/animal/space/bats,
/turf/simulated/mineral/floor/ignore_mapgen/cave,
/area/submap/cave/swordcave)
"l" = (
/mob/living/simple_mob/animal/space/bats/cult,
/turf/simulated/mineral/floor/ignore_mapgen/cave,
/area/submap/cave/swordcave)

(1,1,1) = {"
a
a
a
a
a
a
a
a
a
a
a
a
a
a
a
a
a
a
a
a
a
a
a
a
a
a
a
a
a
a
a
a
a
a
a
a
a
a
a
a
a
"}
(2,1,1) = {"
a
a
a
a
a
a
a
a
a
a
a
a
b
b
b
b
b
b
b
b
b
b
b
b
a
a
a
a
a
a
a
a
a
a
a
a
a
a
a
a
a
"}
(3,1,1) = {"
a
a
a
a
b
b
b
b
b
b
b
b
b
b
b
b
b
b
b
b
b
b
b
b
b
b
b
b
b
a
a
a
a
a
a
a
a
a
a
a
a
"}
(4,1,1) = {"
a
a
a
b
b
b
b
b
b
b
b
b
b
b
b
c
c
c
b
b
b
b
b
b
b
b
b
b
b
b
a
a
a
a
a
a
a
a
a
a
a
"}
(5,1,1) = {"
a
a
b
b
b
b
b
b
b
b
b
b
c
c
c
c
c
c
c
c
c
c
b
b
b
b
b
b
b
b
b
a
a
a
a
a
a
a
a
a
a
"}
(6,1,1) = {"
a
b
b
b
b
c
c
c
c
c
c
c
c
c
d
c
c
c
c
c
c
c
c
b
b
b
b
b
b
b
b
b
b
a
a
a
a
a
a
a
a
"}
(7,1,1) = {"
a
b
b
b
c
c
d
c
c
c
c
c
c
c
c
c
c
c
c
c
c
c
c
c
b
b
b
b
b
b
b
b
b
b
a
a
a
a
a
a
a
"}
(8,1,1) = {"
a
b
b
b
c
c
c
c
c
c
c
c
c
c
c
l
c
c
c
c
c
c
c
c
c
c
c
c
b
b
b
b
b
b
b
b
b
a
a
a
a
"}
(9,1,1) = {"
b
b
b
b
c
c
c
c
c
c
c
d
c
c
c
c
c
c
d
c
c
c
c
c
c
c
c
c
b
b
b
b
b
b
b
b
b
a
a
a
a
"}
(10,1,1) = {"
b
b
b
c
c
c
c
c
c
e
e
e
e
c
c
c
c
c
c
c
c
c
c
c
c
c
c
c
c
b
b
b
b
b
b
b
b
b
a
a
a
"}
(11,1,1) = {"
b
b
c
c
c
c
c
e
e
e
e
e
e
e
c
c
c
c
c
c
c
c
c
c
c
c
c
c
c
c
c
c
c
b
b
b
b
b
a
a
a
"}
(12,1,1) = {"
b
b
c
c
c
c
e
e
e
f
f
f
f
e
e
c
c
c
c
c
c
c
l
c
c
c
c
c
c
c
c
c
c
c
b
b
b
b
b
a
a
"}
(13,1,1) = {"
b
b
c
c
c
e
e
f
f
f
f
f
f
f
e
e
c
c
c
c
c
c
c
c
c
c
d
c
c
c
l
c
c
c
c
b
b
b
b
a
a
"}
(14,1,1) = {"
b
b
c
c
e
e
e
e
e
e
e
e
f
f
f
e
e
c
c
c
c
c
c
c
c
c
c
c
c
c
c
c
c
c
c
c
b
b
b
a
a
"}
(15,1,1) = {"
b
b
c
c
e
e
f
e
e
e
e
e
e
f
f
f
e
e
c
c
c
l
c
c
c
c
c
c
c
c
c
c
c
d
c
c
b
b
b
a
a
"}
(16,1,1) = {"
b
b
c
c
e
e
f
e
c
c
e
c
e
e
f
f
f
e
e
c
c
c
c
c
c
c
c
c
c
c
c
c
c
c
c
c
b
b
b
a
a
"}
(17,1,1) = {"
b
c
c
c
e
e
f
e
c
c
c
c
e
e
e
f
f
f
e
e
c
c
c
c
c
c
c
c
c
c
c
c
c
c
c
c
b
b
b
a
a
"}
(18,1,1) = {"
b
c
c
c
e
e
f
e
c
c
c
i
c
e
e
f
f
f
f
e
e
c
c
c
c
c
c
c
c
c
c
c
c
c
c
c
b
b
b
a
a
"}
(19,1,1) = {"
b
c
c
c
e
e
f
e
e
c
g
j
c
c
e
e
f
e
e
e
c
c
c
c
c
c
c
l
c
c
d
c
c
c
c
c
b
b
b
a
a
"}
(20,1,1) = {"
b
d
c
c
e
e
f
e
e
c
c
c
c
c
e
e
f
e
e
c
c
c
c
c
c
d
c
c
c
c
c
c
c
c
c
c
c
b
b
a
a
"}
(21,1,1) = {"
b
c
c
c
e
e
f
f
e
e
c
d
c
c
e
e
f
e
e
c
c
c
c
c
c
c
c
c
c
c
c
c
c
c
l
c
c
c
b
a
a
"}
(22,1,1) = {"
b
c
c
c
e
e
f
e
e
c
c
c
c
c
e
e
f
e
e
c
c
c
c
c
c
c
c
c
c
c
c
c
c
c
c
c
c
c
c
a
a
"}
(23,1,1) = {"
b
c
c
c
e
e
f
e
e
c
c
c
c
c
e
e
f
e
e
d
c
c
c
l
c
c
c
c
c
c
c
c
c
c
c
c
c
c
c
c
a
"}
(24,1,1) = {"
b
c
c
c
e
e
f
e
e
c
h
c
c
e
e
f
f
e
e
c
c
c
c
c
c
c
c
c
c
c
c
c
c
c
c
c
c
c
c
c
c
"}
(25,1,1) = {"
b
b
c
c
e
e
f
e
e
c
c
c
e
e
f
f
f
f
e
e
c
c
c
c
c
c
c
c
c
c
c
c
c
c
c
c
c
c
c
c
c
"}
(26,1,1) = {"
b
b
c
c
e
e
f
e
e
e
c
c
e
e
f
f
f
f
e
e
c
c
c
c
c
c
c
c
c
d
c
c
c
c
c
c
c
c
c
d
c
"}
(27,1,1) = {"
b
b
c
c
c
e
e
e
f
e
e
e
e
f
f
f
f
f
e
e
e
c
c
c
c
c
c
c
c
c
c
c
c
c
l
c
c
c
c
c
c
"}
(28,1,1) = {"
b
b
c
c
c
c
e
e
f
f
e
e
f
f
f
f
e
e
e
c
c
c
l
c
c
c
c
d
c
c
c
c
c
c
c
c
c
c
c
c
c
"}
(29,1,1) = {"
b
b
c
c
c
c
e
e
f
f
f
f
e
e
e
e
e
e
c
c
c
c
c
c
c
c
c
c
c
c
c
c
c
c
b
b
c
c
c
c
c
"}
(30,1,1) = {"
b
b
c
c
c
c
c
e
e
f
f
e
e
e
e
e
c
c
k
c
c
c
c
c
c
c
c
c
c
c
c
c
c
b
b
b
b
c
c
c
a
"}
(31,1,1) = {"
b
b
c
c
c
c
c
c
e
e
e
e
c
c
c
c
c
c
c
c
c
c
c
c
c
c
c
c
c
c
c
c
b
b
b
b
b
b
c
a
a
"}
(32,1,1) = {"
b
b
b
c
c
c
c
c
c
e
e
c
c
c
c
c
c
c
c
c
d
c
c
c
c
c
c
c
c
c
c
b
b
b
b
b
b
a
a
a
a
"}
(33,1,1) = {"
b
b
b
d
c
c
c
c
c
c
c
c
c
c
c
c
c
c
c
c
c
c
c
l
c
c
c
c
c
b
b
b
b
b
b
b
a
a
a
a
a
"}
(34,1,1) = {"
b
b
b
b
c
c
c
c
c
c
c
d
c
c
c
c
d
c
c
c
l
c
c
c
c
c
b
b
b
b
b
b
b
b
b
a
a
a
a
a
a
"}
(35,1,1) = {"
b
b
b
b
b
c
c
c
c
c
c
c
c
c
c
c
c
c
c
c
c
c
c
c
c
b
b
b
b
b
b
b
b
a
a
a
a
a
a
a
a
"}
(36,1,1) = {"
a
b
b
b
b
b
b
b
b
b
b
b
c
c
c
c
c
c
c
c
c
c
c
c
b
b
b
b
b
b
b
b
a
a
a
a
a
a
a
a
a
"}
(37,1,1) = {"
a
a
b
b
b
b
b
b
b
b
b
b
b
b
b
b
b
b
b
b
b
b
b
b
b
b
b
b
b
a
a
a
a
a
a
a
a
a
a
a
a
"}
(38,1,1) = {"
a
a
a
b
b
b
b
b
b
b
b
b
b
b
b
b
b
b
b
b
b
b
b
b
b
b
b
a
a
a
a
a
a
a
a
a
a
a
a
a
a
"}
(39,1,1) = {"
a
a
a
a
b
b
b
b
a
a
a
a
a
b
b
b
b
b
b
a
a
a
a
a
a
a
a
a
a
a
a
a
a
a
a
a
a
a
a
a
a
"}
(40,1,1) = {"
a
a
a
a
a
a
a
a
a
a
a
a
a
a
a
a
a
a
a
a
a
a
a
a
a
a
a
a
a
a
a
a
a
a
a
a
a
a
a
a
a
"}
(41,1,1) = {"
a
a
a
a
a
a
a
a
a
a
a
a
a
a
a
a
a
a
a
a
a
a
a
a
a
a
a
a
a
a
a
a
a
a
a
a
a
a
a
a
a
"}
