//MAP CONVERTED BY dmm2tgm.py THIS HEADER COMMENT PREVENTS RECONVERSION, DO NOT REMOVE
"a" = (
/turf/simulated/wall/concrete,
/area/template_noop)
"d" = (
/obj/effect/floor_decal/chapel{
	dir = 8
	},
/turf/simulated/floor/tiled/dark,
/area/template_noop)
"f" = (
/obj/structure/table/sifwoodentable,
/obj/item/godfig{
	desc = "A holy figure of some kind of energy formation.";
	icon_state = "singularity"
	},
/obj/random/maintenance/clean,
/obj/random/maintenance/clean,
/obj/random/maintenance/clean,
/turf/simulated/floor/tiled/dark,
/area/template_noop)
"g" = (
/obj/effect/decal/cleanable/dirt,
/turf/simulated/floor/tiled/dark,
/area/template_noop)
"m" = (
/turf/template_noop,
/area/template_noop)
"n" = (
/obj/item/storage/backpack/cultpack,
/obj/item/clothing/suit/storage/hooded/chaplain_hoodie,
/obj/effect/decal/cleanable/dirt,
/obj/random/maintenance/clean,
/obj/structure/sign/poster/custom{
	dir = 1;
	pixel_y = 32;
	poster_decl = /decl/poster/vore_100
	},
/turf/simulated/floor/tiled/dark,
/area/template_noop)
"q" = (
/obj/effect/decal/cleanable/generic,
/turf/simulated/floor/tiled/dark,
/area/template_noop)
"r" = (
/obj/effect/spawner/graffiti{
	color = "#DA0000";
	color_secondary = "#810C0C";
	graffiti_type = "rune4"
	},
/turf/simulated/floor/tiled/dark,
/area/template_noop)
"t" = (
/obj/structure/flora/pottedplant/dead,
/turf/simulated/floor/tiled/dark,
/area/template_noop)
"u" = (
/obj/effect/spawner/graffiti{
	color = "#DA0000";
	color_secondary = "#810C0C";
	graffiti_type = "rune6"
	},
/turf/simulated/floor/tiled/dark,
/area/template_noop)
"x" = (
/obj/structure/table/sifwoodentable,
/obj/item/flame/candle/black,
/obj/effect/floor_decal/chapel{
	dir = 4
	},
/turf/simulated/floor/tiled/dark,
/area/template_noop)
"z" = (
/obj/effect/spawner/graffiti{
	color = "#DA0000";
	color_secondary = "#810C0C";
	graffiti_type = "rune5"
	},
/turf/simulated/floor/tiled/dark,
/area/template_noop)
"A" = (
/obj/structure/table/bench/sifwooden/padded,
/obj/effect/floor_decal/chapel{
	dir = 8
	},
/turf/simulated/floor/tiled/dark,
/area/template_noop)
"C" = (
/obj/structure/table/bench/sifwooden/padded,
/obj/effect/floor_decal/chapel,
/turf/simulated/floor/tiled/dark,
/area/template_noop)
"D" = (
/obj/effect/spawner/graffiti{
	color = "#DA0000";
	color_secondary = "#810C0C";
	graffiti_type = "rune1"
	},
/turf/simulated/floor/tiled/dark,
/area/template_noop)
"F" = (
/obj/effect/spawner/graffiti{
	color = "#DA0000";
	color_secondary = "#810C0C";
	graffiti_type = "rune2"
	},
/turf/simulated/floor/tiled/dark,
/area/template_noop)
"H" = (
/obj/structure/table/sifwoodentable,
/obj/item/flame/candle/black,
/obj/effect/floor_decal/chapel{
	dir = 1
	},
/turf/simulated/floor/tiled/dark,
/area/template_noop)
"L" = (
/obj/structure/table/bench/sifwooden/padded,
/turf/simulated/floor/tiled/dark,
/area/template_noop)
"M" = (
/obj/effect/floor_decal/chapel{
	dir = 1
	},
/turf/simulated/floor/tiled/dark,
/area/template_noop)
"N" = (
/obj/effect/spawner/graffiti{
	color = "#DA0000";
	color_secondary = "#810C0C";
	graffiti_type = "rune3"
	},
/turf/simulated/floor/tiled/dark,
/area/template_noop)
"O" = (
/obj/effect/decal/cleanable/ash,
/turf/simulated/floor/tiled/dark,
/area/template_noop)
"P" = (
/turf/simulated/wall/concrete{
	can_open = 1
	},
/area/template_noop)
"S" = (
/obj/effect/floor_decal/chapel,
/turf/simulated/floor/tiled/dark,
/area/template_noop)
"T" = (
/obj/effect/floor_decal/chapel{
	dir = 4
	},
/turf/simulated/floor/tiled/dark,
/area/template_noop)
"V" = (
/obj/item/stool/padded,
/obj/effect/decal/cleanable/cobweb2,
/turf/simulated/floor/tiled/dark,
/area/template_noop)
"W" = (
/turf/simulated/floor/tiled/dark,
/area/template_noop)
"X" = (
/obj/structure/table/sifwoodentable,
/obj/item/storage/fancy/blackcandle_box{
	pixel_x = -3;
	pixel_y = 4
	},
/obj/item/flame/lighter/random{
	pixel_x = -6
	},
/obj/item/storage/bible/booze{
	icon_state = "tome";
	name = "tome";
	pixel_x = 2
	},
/turf/simulated/floor/tiled/dark,
/area/template_noop)
"Y" = (
/obj/structure/table/bench/sifwooden/padded,
/obj/random/maintenance/clean,
/turf/simulated/floor/tiled/dark,
/area/template_noop)
"Z" = (
/obj/effect/floor_decal/chapel{
	dir = 8
	},
/obj/random/maintenance/clean,
/turf/simulated/floor/tiled/dark,
/area/template_noop)

(1,1,1) = {"
a
a
a
a
a
a
a
a
a
"}
(2,1,1) = {"
a
D
M
d
N
M
Z
z
a
"}
(3,1,1) = {"
a
W
x
S
L
T
C
W
a
"}
(4,1,1) = {"
a
n
X
q
L
W
L
g
P
"}
(5,1,1) = {"
a
g
H
d
L
M
A
O
a
"}
(6,1,1) = {"
a
F
T
S
r
T
S
u
a
"}
(7,1,1) = {"
a
V
f
t
L
Y
t
a
a
"}
(8,1,1) = {"
a
a
a
a
a
a
a
a
m
"}
