"a" = (/turf/unsimulated/wall/planetary/virgo3b{desc = "You can't go there!"; icon = 'icons/turf/flooring/plating_vr.dmi'; icon_state = ""; name = "impassible landscape"},/area/tether/surfacebase/outside/wilderness)
"b" = (/obj/effect/step_trigger/teleporter/wild/to_wild_5,/turf/simulated/floor/outdoors/grass/sif/virgo3b{icon_state = "grass_sif_dark"; name = "passage"; tree_chance = 0},/area/tether/surfacebase/outside/wilderness)
"c" = (/turf/simulated/floor/outdoors/grass/sif/virgo3b{icon_state = "grass_sif_dark"; name = "light growth"; tree_chance = 0},/area/tether/surfacebase/outside/wilderness)
"d" = (/turf/simulated/floor/outdoors/grass/sif/virgo3b{icon_state = "grass_sif_dark"; name = "dense growth"; tree_chance = 4},/area/tether/surfacebase/outside/wilderness)
"e" = (/obj/structure/mob_spawner/scanner/wild_animals,/turf/simulated/floor/outdoors/grass/sif/virgo3b{icon_state = "grass_sif_dark"; name = "dense growth"; tree_chance = 0},/area/tether/surfacebase/outside/wilderness)
"f" = (/turf/simulated/floor/outdoors/dirt/virgo3b,/area/tether/surfacebase/crash)
"g" = (/turf/simulated/shuttle/floor/black/virgo3b,/area/tether/surfacebase/crash)
"h" = (/turf/simulated/shuttle/wall/dark/hard_corner/virgo3b,/area/tether/surfacebase/crash)
"i" = (/obj/item/material/shard,/turf/simulated/shuttle/floor/black/virgo3b,/area/tether/surfacebase/crash)
"j" = (/obj/structure/closet/crate/secure/weapon,/obj/random/weapon,/turf/simulated/shuttle/floor/black/virgo3b,/area/tether/surfacebase/crash)
"k" = (/obj/effect/step_trigger/teleporter/wild/to_wild_3,/turf/simulated/floor/outdoors/grass/sif/virgo3b{icon_state = "grass_sif_dark"; name = "passage"; tree_chance = 0},/area/tether/surfacebase/outside/wilderness)
"l" = (/obj/effect/step_trigger/teleporter/wild/to_wild_1,/turf/simulated/floor/outdoors/grass/sif/virgo3b{icon_state = "grass_sif_dark"; name = "passage"; tree_chance = 0},/area/tether/surfacebase/outside/wilderness)
"m" = (/obj/structure/closet/crate/secure/loot,/turf/simulated/shuttle/floor/black/virgo3b,/area/tether/surfacebase/crash)

(1,1,1) = {"
aaaaaaaaaaaaaaaaaaaaaaaaaaaaaaaaaaaaaaaaaaaaaaaaaaaaaaabbbbbbbbbaaaaaaaaaaaaaaaaaaaaaaaaaaaaaaaaaaaaaaaaaaaaaaaaaaaaaaaa
acccccccccccccccccccccccccccccccccccccccccccccccccccccccccccccccccccccccccccccccccccccccccccccccccccccccccccccccccccccca
acccccccccccccccccccccccccccccccccccccccccccccccccccccccccccccccccccccccccccccccccccccccccccccccccccccccccccccccccccccca
accddddddddddddddddddddddddddddddddddddddddddddddddddddddddddddddddddddddddddddddddddddddddddddddddddddddddddddddddddcca
accddddddddddddddddddddddddddddddddddddddddeddddddddddddddddddddddddddddddeddddddddddedddddddddddddeddddddddddddddeddcca
accddddddddddddddddddddddddddddddddddddddddddddddddddddddddddddddddddddddddddddddddddddddddddddddddddddddddddddddddddcca
accdddddedddddddddddddddeddddddddddddddddddddddddddddddddddddddddddddddddddddddddddddddddddddddddddddddddddddddddddddcca
accddddddddddddddddddddddddddddddddddddddddddddddddddddddddddddddddddddddddddddddddddddddddddddddddddddddddddddddddddcca
accddddddddddddddddddddddddddddddddddddddddddddddddddddddddddddddddddddddddddddddddddddddddddddddddddddddddddddddddddcca
accddddddddddddddddddddddddddddddddddddddddddddddddddddddddddddddddddddddddddddddddddddddddddddddddddddddddddddddddddcca
accdddddddddddddddddddddddddddddddddddddddddddddddedddddddddddddddddeddddddddddddddddddddddddddddddddddddddddddddddddcca
accddddddddddddddddddddddddddddddddddddddddddddddddddddddddddddddddddddddddddddddddddddddddedddddddddddddddedddddddddcca
accddddddddddddddddddddddddddddddddedddddddddddddddddddddddddddddddddddddddddddddddddddddddddddddddddddddddddddddddddcca
accdddddddddddddeddddddddddddddddddddddddddddddddddddddddddedddddddddddddddddddddddddddddddddddddddddddddddddddddddddcca
accddddddddddddddddddddddddddddddddddddddddddddddddddddddddddddddddddddddddddddddddddddddddddddddddddddddddddddddddddcca
accddddddddddddddddddddddddddddddddddddddddddddddddddddddddddddddddddddddddddddddddddddddddddddddddddddddddddddddddddcca
accddddddddddddddddddddddddddddddddddddddddddddddddddddddddddddddddddddddddddddddddddddddddddddddddddddddddddddddddddcca
accddddddddddddddddddddddddddddddddddddddddddddddddddddddddddddddddddddddddddddddddddddddddddddddddddddddddddddddddddcca
accddddddddddddddddddddddddddddddddddddddddddddddddddddddddddddddddddddddddddddddddddddddddddddddddddddddddddddddddddcca
accddddddddddddddddddddddddddddddddddddddddddddedddddddddddddddddddddddeddddddddddddedddddddddddddddedddddddddddddeddcca
accdddddeddddddddddddddddedddddddddddddddddddddddddddddddddddddddddddddddddddddddddddddddddddddddddddddddddddddddddddcca
accddddddddddddddddddddddddddddddddddddddddddddddddddddddddddddddddddddddddddddddddddddddddddddddddddddddddddddddddddcca
accddddddddddddddddddddddddddddddddddddddddddddddddddddddddddddddddddddddddddddddddddddddddddddddddddddddddddddddddddcca
accddddddddddddddddddddddddddddddddddddddddddddddddddddddddddddddddddddddddddddddddddddddddddddddddddddddddddddddddddcca
accddddddddddddddddddddddddddddddddddddddddddddddddddddddddddddddddddddddddddddddddddddddddddddddddddddddddddddddddddcca
accddddddddddddddddddddddddddddddddddddddddddddddddddddddddddddddddddddddddddddddddddddddddddddddddddddddddddddddddddcca
accdddddddddddddddddddddddddddddddddddddddddddddddddddddddddeddddddddddddddddddddddddddddddddddddddddddddddddddddddddcca
accddddddddddddddddddddddddddddddddddddddddddddddddddddddddddddddddddddddddddddddddddddddddddddddddddddddddddddddddddcca
accddddddddddedddddddddddddddddddddeddddddddddddddddddddddddddddddddddddddddddddddddddedddddddddddddddddddeddddddddddcca
accddddddddddddddddddddddddddddddddddddddddddddddddddddddddddddddddddddddddddddddddddddddddddddddddddddddddddddddddddcca
accddddddddddddddddddddddddddddddddddddddddddddddddddddddddddddddddddddddddddddddddddddddddddddddddddddddddddddddddddcca
accddddddddddddddddddddddddddddddddddddddddddddddddddddddddddddddddddddddddddddddddddddddddddddddddddddddddddddddddddcca
accddddddddddddddddddddddddddddddddddddddddddddddddddddddddddddddddddddddddddddddddddddddddddddddddddddddddddddddddddcca
accddddddddddddddddddddddddddddddddddddddddddddddedddddddddddddddddddddddddddddddddddddddddddddddddddddddddddddddddddcca
accdddddddddddddddddddddddddddddddddddddddddddddddddddddddddddddddddddddeddddddddddddddddddddddddddddddddddddddddddddcca
accddddddddddddddddddddddddddddddddddddddddddddddddddddddddddddddddddddddddddddddddddddddddddddddddddddddddddddddddddcca
accdddddddddddddddddddddeddddddddddddddddddddddddddddddddddddddddddddddddddddddddddddddddddddddddddddddddddddddddddddcca
accdddddddddddddddddddddddddddddddddddddddddddddddddddddddddddddddddddddddddddddddddddddddddddddeddddddddddddddddedddcca
accddddddddddddddddddddddddddddddddddddddddddddddddddddddddddddddddddddddddddddddddddddddddddddddddddddddddddddddddddcca
accddddddddddddddddddddddddddddddddddddddddddddddddddddddddddddddddddddddddddddddddddddddddddddddddddddddddddddddddddcca
accdddddddddddddddddddddddddddddddddddddddddddddddddddddddddddddddddeddddddddddddddddddddddddddddddddddddddddddddddddcca
accddddddddddddddddddddddddddddddddddddddddddddddddedddddddddddddddddddddddddddddddddddddddddddddddddddddddddddddddddcca
accddddddddddddddddddddddddddddddddddddddddddddddddddddddddddddddddddddddddddddddddddddddddddddddddddddddddddddddddddcca
accddddddddddddddddddddddddddddddddddddddddddddddddddddddddddddddddddddddddddddddddddddddddddddddddddddddddddddddddddcca
accddddddddddedddddddddddddddddddddedddddddddddddddddddddddddddddddddddddddddddddddddddddddddddddddddddddddddddddddddcca
accdddddddddddddddddddddddddddddddddddddddddddddddddddddddddddddddddddddddddddddddddddddddddddddddddddddddddddddddeddcca
accddddddddddddddddddddddddddddddddddddddddddddddddddddddddddddddddddddddddddddddddddddddddddddddddddddddddddddddddddcca
accddeddddddddddddddddddddddddddddddddddddddddddddddddddddddddddddddddddfffddddddddddddddddddddddddddddddddddddddddddcca
accdddddddddddddddddddddddddddddddddddddddddddddddddddddddddddddddddfffffffffffdddddcddddddddddddddddddddddddddddddddcca
accdddddddddddddddddddddddddddddddddddddddddddddddddddddddddcdddddffffffffffffffffffdddddddddddddddddddddddddddddddddcca
accdddddddddddddddddddddddddddddddddddddddddddddddddddddddddddddfffffffffffffffffffffddddddddddddddddddddddddddddddddcca
accdddddddedddddddddddddddddddddddddddddddddddddddddddddddddddddfffffffffffffffffffffffddddddddddddddddddddddddddddddcca
accddddddddddddddddddddddddddddddddddddddddddddddddddddddddddddfffffffghggghhhhfffffffffddddddddddddddddddeddddddddddcca
accdddddddddddddddddddddeddddddddddddddddddedddddddddddddddddddfffhhgighgghhjjhhhffffffffddddddddddddddddddddddddddddcca
accddddddddddddddddddddddddddddddddddddddddddddddddddddddddddddfffhggggggggiggghgfffffffffdddddddddddddddddddddddddddcca
accddddddddddddddddddddddddddddddddddddddddddddddddddddddddddddfffffffggggigggghgfffffffffdddddddddddddddddddddddddddcca
kccddddddddddddddddddddddddddddddddddddddddddddddddedddddddddddffffffffffggiggghgfffffffffdddddddddddddddddddddddddddccl
kccddddddddddddddddddddddddddddddddddddddddddddddddddddddddddddfffffffffffgiggghgffffffffddddddddddddddddddddddddddddccl
kccdddddddddddddddddddddddddddddddddddddddddddddddddddddddddddddffhhgghhgghhmmhhhfffffffdddddddddddddddddddddddddddddccl
kccddddddddddddddddddddddddddddddddddddddddddddddddddddddddddddddfhhfffgggghhhhffffffffddddddddddddddddddddddddddddddccl
kccddddddddddeddddddddddddddddddddeddddddddddddddddddddddddddddddfffffffffffffffffffffddddddddddddddddeddddddddddddddccl
kccdddddddddddddddddddddddddddddddddddddddddddddddddddddddddddddddfffffffffffffffffffddddddddddddddddddddddddddddddddccl
kccdddddddddddddddddddddddddddddddddddddddddddddddddddddddddddddddffffffffffffffffffdddddddddddddddddddddddddddddddddccl
kccdddddddddddddddddddddddddddddddddddddddddddddddddddddddddddddddddffffffffffffffdddddddddddddddddddddddddddddddddddccl
kccdddddddddddddddddddddddddddddddddddddddddddddddddddddddddddddddddddffddffffffdddddddddddddddddddddddddddddddddddddccl
accddddddddddddddddddddddddddddddddddddddddddddddddddddddddddddddddddddddddfffdddddddddddddddddddddddddddddddddddddddcca
accddddddddddddddddddddddddddddddddddddddddddddddddddddddddddddddddddddddddddddedddddddddddddddddddddddddddddddddddddcca
accddddddddddddddddddddddddddddddddddddddddddddddddddddddddedddddddddddddddddddddddddddddddddddddddddddddddddddddddddcca
accddddddddddddddddddddddddddddddddddddddddddddddddddddddddddddddddddddddddddddddddddddddddddddddddddddddddddddddddddcca
accdddddddeddddddddddddddeddddddddddddddddddeddddddddddddddddddddddddddddddddddddddddddddddddddddddddddddddddddddddddcca
accddddddddddddddddddddddddddddddddddddddddddddddddddddddddddddddddddddddddddddddddddddddddddddddddddddddddedddddddddcca
accddddddddddddddddddddddddddddddddddddddddddddddddddddddddddddddddddddddddddddddddddddddddddddddddddddddddddddddddddcca
accddddddddddddddddddddddddddddddddddddddddddddddddddddddddddddddddddddddddddddddddddddddddddddddddddddddddddddddddddcca
accddddddddddddddddddddddddddddddddddddddddddddddddddddddddddddddddddddddddddddddddddddddddddedddddddddddddddddddddddcca
accddddddddddddddddddddddddddddddddddddddddddddddddddddddddddddddddddddddddddddddddddddddddddddddddddddddddddddddddddcca
accdeddddddddddddddddddddddddddddddddddddddddddddddddddddddddddddddddddddddddddddddddddddddddddddddddddddddddddddddddcca
accddddddddddddddddddddddddddddddddddddddddddddddddddddddddddddddddddddddddddddddddddddddddddddddddddddddddddddddddddcca
accddddddddddddddddddddddddddddddddddddddddddddddddddddddddddddddddddddddddddddddddddddddddddddddddddddddddddddddddedcca
accddddddddddddddddddddddddddddddedddddddddddddddddddddddddddddddddddddddddddddddddddddddddddddddddddddddddddddddddddcca
accddddddddddedddddddddddddddddddddddddddddddedddddddddddddddddddddddddddddddddddddddddddddddddddddddddddddddddddddddcca
accdddddddddddddddddddddddddddddddddddddddddddddddddddddddddddddddddddddddddeddddddddddddddddddddddddddddddddddddddddcca
accdddddddddddddddddddddddddddddddddddddddddddddddddddddddddddddddddddddddddddddddddddddddddddddddddeddddddddddddddddcca
accddddddddddddddddddddddddddddddddddddddddddddddddddddddddddddddddddddddddddddddddddddddddddddddddddddddddddddddddddcca
accddddddddddddddddddddddddddddddddddddddddddddddddddddddddddddddddddddddddddddddddddddddddddddddddddddddddddddddddddcca
accdddddddddddddddddddddeddddddddddddddddddddddddddddddddddddddddddddddddddddddddddddddddddddddddddddddddddddddddddddcca
accdddddddddddddddddddddddddddeddddddddddddddddddddddddddddddddddddddddddddddddddddddddddddddddddddddddddddddddddddddcca
accddddddddddddddddddddddddddddddddddddddddddddddddddddddddddedddddddddddddddddddddddddddddddddddddddddddddddddddddddcca
accddddddddddddddddddddddddddddddddddddddddddddddddddddddddddddddddddddddddddddddddddddddddddddddddddddddddddddddddddcca
accddddddddddddddddddddddddddddddddddddddddddddddddddddddddddddddddddddddddddddddddddddedddddddddddddddddddddddddddddcca
accddddddddddddddddddddddddddddddddddddddddddddddddddddddddddddddddddddddddddddddddddddddddddddddddddddddddddddddedddcca
accddddddddddddddddddddddddddddddddddddddddddddddddddddddddddddddddddddddddddddddddddddddddddddddddddddddddddddddddddcca
accddddddddddddddddddddddddddddddddddddddddddddddddddddddddddddddddddddddddddddddddddddddddddddddddddddddddddddddddddcca
accddddddddddddddddddddddddddddddddddddddddddddddddddddddddddddddddddddddddddddddddddddddddddddddddddddddddddddddddddcca
accdddddddddddeddddddddddddddddddddddddddddddddddddddddddddddddddddddddddddddddddddddddddddddddddddddddddddddddddddddcca
accdddddddddddddddddddddddddddddddeddddddddddddddedddddddddddddddddddddddddddddddddddddddddddddddddddddddddddddddddddcca
accddddddddddddddddddddddddddddddddddddddddddddddddddddddddddddddddddddddddddddddddddddddddddddddddddddddddddddddddddcca
accdddddddddddddddddddddddddddddddddddddddddddddddddddddddddddddddddddddddddeddddddddddddddddddddddddddddddddddddddddcca
accdddddedddddddddddddddddddeddddddddddddddddddddddddddddddddddddddddddddddddddddddddddddddddddddddddddddddddddddddddcca
accdddddddddddddddddddddddddddddddddddddddddddddddddddddddddddddddddddddddddddddddddddddddddddddddddeddddddddddddddddcca
accddddddddddddddddddddddddddddddddddddddddddddddddddddddddddddddddddddddddddddddddddddddddddddddddddddddddddddddddddcca
accdddddddddddddddddddddddddddddddddddddddddddddddddddddddddddddddddddddddddddddddddddddddddedddddddddddddddddddeddddcca
accddddddddddddddddddddddddddddddddddddddddddddddddddddddddddddddddddddddddddddddddddddddddddddddddddddddddddddddddddcca
accddddddddddddddddddddddddddddddddddddddddddddddddddddddddddddddddddddddddddddddddddddddddddddddddddddddddddddddddddcca
accddddddddddddddddddddddddddddddddddddddddddddddddddddddddddddddddddddddddddddddddddddddddddddddddddddddddddddddddddcca
accddddddddddddddddddddddddddddddddddddedddddddddddddddddddddddddddddddddddddddddddddddddddddddddddddddddddddddddddddcca
accddddddddddddddedddddddddddddddddddddddddddddddddddddddddddddddddddddddddddddddddddddddddddddddddddddddddddddddddddcca
accddddddddddddddddddddddddddddddddddddddddddddddddddddddddeddddddddddddddddddddddeddddddddddddddddddddedddddddddddddcca
accddddddddddddddddddddddddddddddddddddddddddddddddddddddddddddddddddddddddddddddddddddddddddddddddddddddddddddddddddcca
accddddddddddddddddddddddddddddddddddddddddddddddddddddddddddddddddddddddddddddddddddddddddddddddddddddddddddddddddddcca
accddddddddddddddddddddddddddddddddddddddddddddddedddddddddddddddddddedddddddddddddddddddddddddddddddddddddddddddddddcca
accddddddddddddddddddddddddddddddddddddddddddddddddddddddddddddddddddddddddddddddddddddddddddddddddddddddddddddddddddcca
accddddddddddddddddddddddddddddddddddddddddddddddddddddddddddddddddddddddddddddddddddddddddddddddddddddddddddddddddddcca
accddddddddddddddddddddddddddddddddddddddddddddddddddddddddddddddddddddddddddddddddddddddddddddddddddddddddddddddddddcca
accddddddddddddddddddddddddddddddddddddddddddddddddddddddddddddddddddddddddddddddddddddddddddddddddddddddddddddddddddcca
accddddddeddddddddddddddddddedddddddddddddddddddddddddddddddddddddddddddddddddddddddddddddddedddddddddddddddddddeddddcca
accddddddddddddddddddddddddddddddddddddddddddddddddddddddddddddddddddddddddddddddedddddddddddddddddddddddddddddddddddcca
accddddddddddddddddddddddddddddddddddddddedddddddddddddddddddddddddddddddddddddddddddddddddddddddddddddddddddddddddddcca
acccccccccccccccccccccccccccccccccccccccccccccccccccccccccccccccccccccccccccccccccccccccccccccccccccccccccccccccccccccca
acccccccccccccccccccccccccccccccccccccccccccccccccccccccccccccccccccccccccccccccccccccccccccccccccccccccccccccccccccccca
aaaaaaaaaaaaaaaaaaaaaaaaaaaaaaaaaaaaaaaaaaaaaaaaaaaaaaabbbbbbbbbaaaaaaaaaaaaaaaaaaaaaaaaaaaaaaaaaaaaaaaaaaaaaaaaaaaaaaaa
"}
