//MAP CONVERTED BY dmm2tgm.py THIS HEADER COMMENT PREVENTS RECONVERSION, DO NOT REMOVE
"a" = (
/turf/simulated/wall/concrete,
/area/template_noop)
"e" = (
/obj/structure/window/reinforced{
	dir = 1
	},
/obj/structure/window/reinforced{
	dir = 4
	},
/obj/structure/table/steel_reinforced,
/obj/machinery/recharger{
	pixel_y = 4
	},
/obj/item/weapon/gun/energy/laser/practice{
	pixel_y = -4
	},
/turf/simulated/floor/tiled/techmaint,
/area/template_noop)
"f" = (
/obj/structure/window/reinforced{
	dir = 1
	},
/obj/structure/window/reinforced{
	dir = 4
	},
/obj/structure/table/steel_reinforced,
/obj/item/frame,
/turf/simulated/floor/tiled/techmaint,
/area/template_noop)
"j" = (
/obj/effect/floor_decal/industrial/hatch/yellow,
/turf/simulated/floor/tiled/steel_dirty,
/area/template_noop)
"k" = (
/obj/effect/floor_decal/industrial/loading{
	dir = 1
	},
/obj/machinery/door/window/northleft,
/turf/simulated/floor/tiled/techmaint,
/area/template_noop)
"l" = (
/turf/simulated/floor/tiled/techmaint,
/area/template_noop)
"m" = (
/obj/item/tape/police,
/obj/structure/cable{
	d1 = 4;
	d2 = 8;
	icon_state = "4-8"
	},
/turf/simulated/floor/plating,
/area/template_noop)
"n" = (
/obj/effect/floor_decal/industrial/hatch/yellow,
/obj/structure/target_stake,
/turf/simulated/floor/tiled/steel_dirty,
/area/template_noop)
"o" = (
/obj/item/frame/light{
	dir = 8
	},
/turf/simulated/floor/tiled/steel_dirty,
/area/template_noop)
"p" = (
/obj/structure/cable{
	d1 = 1;
	d2 = 2;
	icon_state = "1-2"
	},
/turf/simulated/floor/tiled/techmaint,
/area/template_noop)
"s" = (
/obj/machinery/door/airlock{
	name = "Construction Area"
	},
/obj/item/tape/police,
/turf/simulated/floor/tiled/steel_grid,
/area/template_noop)
"t" = (
/obj/machinery/magnetic_controller{
	autolink = 1;
	density = 0;
	pixel_y = -30
	},
/obj/structure/cable,
/obj/machinery/power/apc{
	dir = 4;
	name = "east bump";
	operating = 0;
	pixel_x = 24
	},
/obj/effect/floor_decal/steeldecal/steel_decals_central7{
	dir = 4
	},
/obj/machinery/light_switch{
	dir = 8;
	pixel_x = 24;
	pixel_y = -12
	},
/turf/simulated/floor/tiled/techmaint,
/area/template_noop)
"v" = (
/obj/effect/floor_decal/industrial/warning{
	dir = 1
	},
/obj/structure/sign/poster/custom{
	pixel_y = -32;
	poster_decl = /decl/poster/vore_37
	},
/turf/simulated/floor/tiled/techmaint,
/area/template_noop)
"w" = (
/obj/machinery/magnetic_module,
/obj/effect/catwalk_plated,
/turf/simulated/floor/plating,
/area/template_noop)
"x" = (
/obj/random/crate,
/obj/item/target/syndicate,
/obj/item/target/syndicate,
/obj/item/ammo_magazine/ammo_box/b12g/practice,
/obj/item/ammo_magazine/m45/practice,
/obj/item/ammo_magazine/m45/practice,
/obj/item/ammo_magazine/s45/practice,
/obj/item/ammo_magazine/s45/practice,
/obj/item/ammo_magazine/m9mmt/practice,
/turf/simulated/floor/plating,
/area/template_noop)
"y" = (
/turf/template_noop,
/area/template_noop)
"B" = (
/obj/structure/cable{
	d1 = 2;
	d2 = 4;
	icon_state = "2-4"
	},
/turf/simulated/floor/tiled/techmaint,
/area/template_noop)
"F" = (
/obj/effect/floor_decal/industrial/warning{
	dir = 1
	},
/turf/simulated/floor/tiled/techmaint,
/area/template_noop)
"G" = (
/obj/machinery/light/poi{
	dir = 4
	},
/turf/simulated/floor/tiled/techmaint,
/area/template_noop)
"I" = (
/obj/effect/graffitispawner{
	color = "#DA0000";
	color_secondary = "#810C0C";
	graffiti_type = "matt"
	},
/turf/simulated/floor/tiled/steel_dirty,
/area/template_noop)
"L" = (
/obj/random/crate,
/obj/item/clothing/ears/earmuffs,
/obj/item/clothing/glasses/sunglasses/big,
/obj/item/clothing/ears/earmuffs{
	pixel_x = -3;
	pixel_y = -2
	},
/obj/random/maintenance/security,
/obj/random/maintenance/security,
/obj/random/maintenance/security,
/turf/simulated/floor/plating,
/area/template_noop)
"M" = (
/obj/machinery/door/window/northleft,
/obj/structure/cable{
	d1 = 1;
	d2 = 2;
	icon_state = "1-2"
	},
/turf/simulated/floor/tiled/techmaint,
/area/template_noop)
"N" = (
/turf/simulated/floor/tiled/steel_dirty,
/area/template_noop)
"O" = (
/obj/effect/floor_decal/industrial/warning{
	dir = 4
	},
/turf/simulated/floor/tiled/steel_dirty,
/area/template_noop)
"Q" = (
/obj/effect/floor_decal/industrial/warning{
	dir = 1
	},
/obj/item/poster/nanotrasen,
/turf/simulated/floor/tiled/techmaint,
/area/template_noop)
"T" = (
/obj/structure/target_stake,
/turf/simulated/floor/tiled/steel_dirty,
/area/template_noop)
"U" = (
/obj/effect/floor_decal/industrial/warning,
/turf/simulated/floor/tiled/steel_dirty,
/area/template_noop)
"X" = (
/obj/structure/frame{
	anchored = 1
	},
/obj/structure/window/reinforced{
	dir = 1
	},
/obj/structure/window/reinforced{
	dir = 4
	},
/turf/simulated/floor/tiled/techmaint,
/area/template_noop)
"Y" = (
/obj/effect/floor_decal/industrial/warning{
	dir = 1
	},
/obj/machinery/light_construct,
/turf/simulated/floor/tiled/techmaint,
/area/template_noop)
"Z" = (
/obj/effect/floor_decal/industrial/warning{
	dir = 6
	},
/turf/simulated/floor/tiled/steel_dirty,
/area/template_noop)

(1,1,1) = {"
a
a
a
a
a
a
a
a
a
a
"}
(2,1,1) = {"
a
N
N
o
N
N
U
X
Q
a
"}
(3,1,1) = {"
a
n
N
N
N
I
U
k
Y
a
"}
(4,1,1) = {"
a
N
w
N
N
N
U
e
F
a
"}
(5,1,1) = {"
a
j
N
T
N
N
U
k
F
s
"}
(6,1,1) = {"
a
O
O
O
O
O
Z
f
v
a
"}
(7,1,1) = {"
a
l
l
G
l
B
p
M
t
a
"}
(8,1,1) = {"
a
L
x
a
a
m
a
a
a
a
"}
(9,1,1) = {"
a
a
a
a
y
y
y
y
y
y
"}
