//MAP CONVERTED BY dmm2tgm.py THIS HEADER COMMENT PREVENTS RECONVERSION, DO NOT REMOVE
"a" = (
/turf/simulated/floor/tiled/white,
/area/survivalpod/redspace)
"c" = (
/obj/machinery/door/window/survival_pod{
	dir = 1;
	icon_state = "windoor"
	},
/obj/effect/floor_decal/spline/plain{
	dir = 1
	},
/turf/simulated/floor/tiled/white,
/area/survivalpod/redspace)
"d" = (
/obj/effect/mist,
/turf/simulated/floor/wood/alt/parquet,
/area/survivalpod/redspace)
"f" = (
/obj/structure/sign/mining/survival{
	dir = 1
	},
/turf/simulated/shuttle/wall/voidcraft/survival,
/area/survivalpod/redspace)
"k" = (
/obj/effect/mist,
/obj/machinery/light/floortube{
	dir = 1
	},
/turf/simulated/floor/wood/alt/parquet,
/area/survivalpod/redspace)
"l" = (
/obj/structure/sign/mining/survival{
	dir = 8
	},
/turf/simulated/shuttle/wall/voidcraft/survival,
/area/survivalpod/redspace)
"m" = (
/obj/structure/window/reinforced/survival_pod{
	dir = 1
	},
/obj/structure/closet/secure_closet/personal,
/turf/simulated/floor/tiled/white,
/area/survivalpod/redspace)
"q" = (
/obj/structure/fans,
/turf/simulated/shuttle/wall/voidcraft/hard_corner,
/area/survivalpod/redspace)
"r" = (
/obj/effect/mist,
/obj/structure/table/bench/wooden,
/turf/simulated/floor/wood/alt/parquet,
/area/survivalpod/redspace)
"s" = (
/obj/structure/fans/tiny,
/obj/machinery/door/airlock/voidcraft/survival_pod,
/obj/effect/floor_decal/industrial/danger/full,
/turf/simulated/shuttle/floor/voidcraft,
/area/survivalpod/redspace)
"u" = (
/obj/effect/mist,
/obj/structure/railing{
	dir = 8
	},
/obj/structure/railing,
/turf/simulated/floor/water/pool,
/area/survivalpod/redspace)
"y" = (
/obj/structure/sign/mining/survival{
	dir = 4
	},
/turf/simulated/shuttle/wall/voidcraft/survival,
/area/survivalpod/redspace)
"C" = (
/obj/structure/sign/mining/survival,
/turf/simulated/shuttle/wall/voidcraft/survival,
/area/survivalpod/redspace)
"E" = (
/obj/machinery/light/floortube,
/obj/machinery/button/remote/airlock/survival_pod/bolts{
	pixel_y = -22;
	pixel_x = 21
	},
/turf/simulated/floor/tiled/white,
/area/survivalpod/redspace)
"H" = (
/turf/simulated/shuttle/wall/voidcraft/survival,
/area/survivalpod/redspace)
"I" = (
/obj/machinery/smartfridge/survival_pod{
	pixel_y = 28
	},
/obj/item/towel/random{
	color = "#5fadba"
	},
/obj/item/towel/random{
	color = "#b0006b"
	},
/obj/item/towel/random{
	color = "#b0006b"
	},
/obj/item/towel/random{
	color = "#ae0004"
	},
/obj/item/towel/random,
/obj/item/towel/random,
/obj/item/towel/random,
/obj/item/towel/random,
/turf/simulated/floor/tiled/white,
/area/survivalpod/redspace)
"N" = (
/obj/effect/mist,
/obj/structure/railing{
	dir = 4
	},
/obj/structure/railing,
/turf/simulated/floor/water/pool,
/area/survivalpod/redspace)
"O" = (
/obj/structure/closet/secure_closet/personal,
/turf/simulated/floor/tiled/white,
/area/survivalpod/redspace)
"T" = (
/obj/structure/sign/mining,
/turf/simulated/shuttle/wall/voidcraft/survival,
/area/survivalpod/redspace)
"U" = (
/turf/simulated/shuttle/wall/voidcraft/hard_corner,
/area/survivalpod/redspace)

(1,1,1) = {"
H
l
H
l
H
l
H
"}
(2,1,1) = {"
f
N
r
r
m
O
C
"}
(3,1,1) = {"
H
r
d
d
c
a
H
"}
(4,1,1) = {"
f
r
k
d
m
E
s
"}
(5,1,1) = {"
H
r
d
d
q
a
H
"}
(6,1,1) = {"
f
u
r
r
U
I
T
"}
(7,1,1) = {"
H
y
H
y
H
y
H
"}
