//MAP CONVERTED BY dmm2tgm.py THIS HEADER COMMENT PREVENTS RECONVERSION, DO NOT REMOVE
"a" = (
/turf/simulated/shuttle/wall/voidcraft/survival,
/area/survivalpod)
"c" = (
/obj/structure/grille,
/obj/structure/window/reinforced/polarized{
	id = "hollypod";
	dir = 4
	},
/obj/structure/window/reinforced/polarized{
	id = "hollypod";
	dir = 8
	},
/obj/structure/window/reinforced/polarized{
	id = "hollypod"
	},
/obj/structure/window/reinforced/polarized{
	id = "hollypod";
	dir = 1
	},
/obj/structure/disposalpipe/segment{
	dir = 8;
	icon_state = "pipe-c"
	},
/turf/simulated/shuttle/floor/voidcraft/dark,
/area/survivalpod)
"d" = (
/obj/structure/sign/mining/survival{
	dir = 4
	},
/obj/structure/disposalpipe/segment{
	dir = 2;
	icon_state = "pipe-c"
	},
/turf/simulated/shuttle/wall/voidcraft/survival,
/area/survivalpod)
"e" = (
/obj/structure/sign/mining/survival{
	dir = 4
	},
/turf/simulated/shuttle/wall/voidcraft/survival,
/area/survivalpod)
"f" = (
/obj/machinery/button/remote/airlock/survival_pod/bolts{
	pixel_x = -22;
	pixel_y = -24
	},
/obj/effect/floor_decal/spline/plain,
/turf/simulated/floor/carpet/blue2,
/area/survivalpod)
"g" = (
/obj/structure/table/gamblingtable,
/obj/structure/closet/walllocker_double/casino/west,
/obj/item/spacecasinocash/c1000,
/obj/item/spacecasinocash/c1000,
/obj/item/spacecasinocash/c1000,
/obj/item/spacecasinocash/c1000,
/obj/item/spacecasinocash/c1000,
/obj/item/deck/cards,
/obj/item/storage/pill_bottle/dice,
/obj/item/storage/pill_bottle/dice_nerd,
/turf/simulated/floor/wood,
/area/survivalpod)
"h" = (
/obj/effect/floor_decal/spline/plain{
	dir = 1
	},
/turf/simulated/floor/wood,
/area/survivalpod)
"i" = (
/obj/machinery/disposal/wall,
/obj/structure/disposalpipe/trunk{
	dir = 2
	},
/turf/simulated/floor/carpet/blue2,
/area/survivalpod/dorms)
"j" = (
/obj/structure/bed/chair/comfy/blue,
/obj/machinery/light/small/fairylights{
	pixel_y = 32
	},
/turf/simulated/floor/wood,
/area/survivalpod)
"k" = (
/obj/structure/bed/chair/comfy/blue{
	dir = 1
	},
/obj/effect/floor_decal/spline/plain/corner,
/obj/machinery/button/windowtint{
	pixel_x = 3;
	id = "hollypod";
	pixel_y = -24
	},
/turf/simulated/floor/wood,
/area/survivalpod)
"l" = (
/turf/simulated/shuttle/wall/voidcraft,
/area/survivalpod/dorms)
"m" = (
/obj/structure/fans/tiny,
/obj/machinery/door/airlock/voidcraft/survival_pod,
/obj/effect/floor_decal/industrial/danger/full,
/turf/simulated/shuttle/floor/voidcraft,
/area/survivalpod)
"n" = (
/obj/structure/bed/double/padded{
	dir = 1
	},
/obj/item/bedsheet/bluedouble{
	dir = 1
	},
/turf/simulated/floor/carpet/blue2,
/area/survivalpod/dorms)
"o" = (
/obj/structure/table/woodentable,
/obj/machinery/microwave{
	pixel_y = 8
	},
/obj/structure/disposalpipe/segment{
	dir = 8;
	icon_state = "pipe-c"
	},
/turf/simulated/floor/wood,
/area/survivalpod)
"p" = (
/obj/structure/sign/mining/survival{
	dir = 8
	},
/turf/simulated/shuttle/wall/voidcraft/survival,
/area/survivalpod)
"q" = (
/turf/simulated/shuttle/floor/voidcraft/dark,
/area/survivalpod)
"s" = (
/obj/machinery/media/jukebox,
/obj/machinery/light{
	dir = 4;
	light_color = "#DDFFD3"
	},
/turf/simulated/floor/wood,
/area/survivalpod)
"t" = (
/obj/structure/disposalpipe/segment{
	dir = 8;
	icon_state = "pipe-c"
	},
/turf/simulated/shuttle/floor/voidcraft/dark,
/area/survivalpod)
"v" = (
/obj/structure/disposalpipe/segment{
	dir = 2;
	icon_state = "pipe-c"
	},
/obj/effect/floor_decal/industrial/danger/full,
/obj/machinery/door/airlock/voidcraft/survival_pod/vertical,
/turf/simulated/shuttle/floor/voidcraft/dark,
/area/survivalpod/dorms)
"w" = (
/obj/structure/disposalpipe/segment{
	dir = 1;
	icon_state = "pipe-c"
	},
/turf/simulated/shuttle/wall/voidcraft/hard_corner,
/area/survivalpod/dorms)
"x" = (
/obj/machinery/light{
	dir = 8
	},
/obj/structure/table/wooden_reinforced,
/obj/item/flame/candle{
	pixel_x = 6
	},
/obj/item/flame/lighter/random{
	pixel_x = -4;
	pixel_y = 4
	},
/turf/simulated/floor/carpet/blue2,
/area/survivalpod/dorms)
"y" = (
/turf/simulated/shuttle/wall/voidcraft/hard_corner,
/area/survivalpod/dorms)
"A" = (
/obj/structure/disposalpipe/segment{
	dir = 4;
	icon_state = "pipe-c"
	},
/turf/simulated/floor/wood,
/area/survivalpod)
"C" = (
/obj/structure/grille,
/obj/structure/window/reinforced/polarized{
	id = "hollypod";
	dir = 4
	},
/obj/structure/window/reinforced/polarized{
	id = "hollypod";
	dir = 8
	},
/obj/structure/window/reinforced/polarized{
	id = "hollypod"
	},
/obj/structure/window/reinforced/polarized{
	id = "hollypod";
	dir = 1
	},
/turf/simulated/shuttle/floor/voidcraft/dark,
/area/survivalpod)
"D" = (
/obj/effect/floor_decal/spline/plain{
	dir = 1
	},
/obj/structure/sink/kitchen{
	dir = 4;
	pixel_x = 12;
	pixel_y = 4
	},
/obj/structure/disposalpipe/segment{
	dir = 4;
	icon_state = "pipe-c"
	},
/turf/simulated/floor/wood,
/area/survivalpod)
"F" = (
/obj/structure/sign/mining/survival,
/turf/simulated/shuttle/wall/voidcraft/survival,
/area/survivalpod)
"H" = (
/obj/machinery/disposal/wall{
	dir = 1
	},
/obj/structure/disposalpipe/trunk{
	dir = 1
	},
/obj/effect/floor_decal/spline/plain/corner{
	dir = 8
	},
/turf/simulated/floor/wood,
/area/survivalpod)
"I" = (
/obj/structure/sign/mining/survival{
	dir = 1
	},
/turf/simulated/shuttle/wall/voidcraft/survival,
/area/survivalpod)
"J" = (
/obj/structure/disposalpipe/segment{
	dir = 1;
	icon_state = "pipe-c"
	},
/turf/simulated/shuttle/wall/voidcraft/survival,
/area/survivalpod)
"K" = (
/obj/machinery/smartfridge/survival_pod,
/obj/item/emergency_beacon,
/obj/item/storage/pill_bottle/dice_nerd,
/obj/item/storage/pill_bottle/dice,
/obj/item/deck/cards,
/obj/item/multitool,
/obj/item/storage/box/donkpockets/pizza,
/obj/item/storage/box/donkpockets/berry,
/obj/item/deck/tarot,
/obj/item/toy/plushie/kitten,
/obj/item/reagent_containers/food/snacks/packaged/spacetwinkie,
/obj/item/reagent_containers/food/snacks/packaged/spacetwinkie,
/obj/item/extinguisher/mini,
/obj/item/radio{
	icon_state = "walkietalkiebay";
	name = "emergency radio"
	},
/obj/item/reagent_containers/food/drinks/h_chocolate,
/obj/item/reagent_containers/food/drinks/h_chocolate,
/obj/item/reagent_containers/food/drinks/h_chocolate,
/obj/item/reagent_containers/food/drinks/cans/waterbottle,
/obj/item/reagent_containers/food/drinks/cans/waterbottle,
/obj/item/reagent_containers/food/drinks/cans/waterbottle,
/obj/item/reagent_containers/food/drinks/bottle/milk,
/obj/item/reagent_containers/food/drinks/bottle/cream,
/obj/item/towel{
	color = "#800080"
	},
/obj/item/towel{
	color = "#800080"
	},
/obj/item/storage/box/mixedglasses,
/obj/item/reagent_containers/food/drinks/glass2/fitnessflask/proteinshake,
/obj/item/reagent_containers/food/drinks/glass2/fitnessflask/proteinshake,
/obj/item/reagent_containers/food/drinks/glass2/fitnessflask/proteinshake,
/obj/item/storage/mre/random,
/obj/item/storage/mre/random,
/obj/item/storage/mre/random,
/obj/item/storage/mre/random,
/obj/item/storage/mre/menu10,
/obj/item/storage/mre/menu11,
/obj/item/storage/mre/menu13,
/obj/item/storage/mre/menu9,
/obj/item/storage/box/survival/comp{
	starts_with = list(/obj/item/tool/prybar/red,/obj/item/clothing/glasses/goggles,/obj/item/reagent_containers/hypospray/autoinjector,/obj/item/stack/medical/bruise_pack,/obj/item/flashlight/glowstick,/obj/item/reagent_containers/food/snacks/candy/proteinbar,/obj/item/clothing/mask/breath,/obj/item/tank/emergency/oxygen/engi)
	},
/obj/item/storage/box/survival/space,
/obj/item/flame/lighter/zippo,
/obj/item/storage/fancy/candle_box,
/obj/item/tool/screwdriver,
/obj/item/tool/wrench,
/obj/item/tool/crowbar,
/obj/item/soap/cyan_soap,
/obj/item/reagent_containers/food/drinks/bottle/rum,
/obj/item/reagent_containers/food/drinks/bottle/cola,
/obj/item/reagent_containers/food/drinks/bottle/bluecuracao,
/obj/item/storage/box/lights/tubes,
/obj/item/reagent_containers/food/drinks/bottle/space_up,
/obj/structure/disposalpipe/segment{
	dir = 4;
	icon_state = "pipe-c"
	},
/obj/item/reagent_containers/food/drinks/bottle/space_mountain_wind,
/obj/item/reagent_containers/food/drinks/bottle/specialwhiskey,
/obj/item/reagent_containers/food/drinks/bottle/tequila,
/obj/item/reagent_containers/food/drinks/bottle/melonliquor,
/obj/item/reagent_containers/food/drinks/metaglass,
/obj/item/reagent_containers/food/drinks/metaglass,
/obj/item/reagent_containers/food/drinks/metaglass,
/obj/item/reagent_containers/food/drinks/metaglass,
/obj/item/reagent_containers/food/drinks/metaglass,
/obj/item/reagent_containers/food/drinks/metaglass/metapint,
/obj/item/reagent_containers/food/drinks/metaglass/metapint,
/obj/item/reagent_containers/food/drinks/metaglass/metapint,
/obj/item/reagent_containers/food/drinks/metaglass/metapint,
/obj/item/reagent_containers/food/drinks/metaglass/metapint,
/obj/item/reagent_containers/food/drinks/bottle/sake,
/obj/item/storage/firstaid/regular,
/obj/item/storage/firstaid/fire,
/obj/item/storage/firstaid/o2,
/obj/item/storage/firstaid/toxin,
/obj/item/healthanalyzer,
/turf/simulated/shuttle/floor/voidcraft/dark,
/area/survivalpod)
"L" = (
/obj/structure/bed/chair/comfy/blue{
	dir = 8
	},
/turf/simulated/floor/wood,
/area/survivalpod)
"M" = (
/obj/machinery/light{
	dir = 4;
	light_color = "#DDFFD3"
	},
/obj/structure/disposalpipe/segment{
	dir = 8;
	icon_state = "pipe-c"
	},
/turf/simulated/shuttle/floor/voidcraft/dark,
/area/survivalpod)
"O" = (
/obj/effect/floor_decal/spline/plain/corner{
	dir = 1
	},
/obj/machinery/light/small/fairylights{
	pixel_y = 32
	},
/turf/simulated/floor/wood,
/area/survivalpod)
"R" = (
/obj/machinery/sleeper/survival_pod,
/turf/simulated/shuttle/floor/voidcraft/dark,
/area/survivalpod)
"T" = (
/obj/structure/disposalpipe/segment{
	dir = 4;
	icon_state = "pipe-c"
	},
/turf/simulated/shuttle/floor/voidcraft/dark,
/area/survivalpod)
"U" = (
/obj/structure/table/gamblingtable,
/turf/simulated/floor/wood,
/area/survivalpod)
"W" = (
/obj/structure/disposalpipe/segment{
	dir = 4;
	icon_state = "pipe-c"
	},
/turf/simulated/shuttle/wall/voidcraft/survival,
/area/survivalpod)
"X" = (
/obj/machinery/light_switch/survival_pod{
	dir = 8;
	pixel_x = 21;
	pixel_y = 30
	},
/obj/machinery/button/remote/airlock/survival_pod/bolts{
	pixel_x = 22;
	pixel_y = 22;
	dir = 4
	},
/obj/structure/privacyswitch{
	dir = 4;
	pixel_y = 36;
	pixel_x = 20
	},
/obj/structure/disposalpipe/segment{
	dir = 1;
	icon_state = "pipe-c"
	},
/turf/simulated/floor/carpet/blue2,
/area/survivalpod/dorms)
"Z" = (
/obj/structure/bed/chair/comfy/blue{
	dir = 1
	},
/obj/machinery/light,
/turf/simulated/floor/wood,
/area/survivalpod)

(1,1,1) = {"
a
p
a
a
C
a
C
a
"}
(2,1,1) = {"
I
n
x
l
j
g
Z
C
"}
(3,1,1) = {"
a
i
X
l
j
U
k
a
"}
(4,1,1) = {"
I
y
v
w
O
L
f
m
"}
(5,1,1) = {"
a
R
T
t
h
A
H
a
"}
(6,1,1) = {"
I
K
M
q
D
o
s
F
"}
(7,1,1) = {"
a
d
J
W
c
a
e
a
"}
