//MAP CONVERTED BY dmm2tgm.py THIS HEADER COMMENT PREVENTS RECONVERSION, DO NOT REMOVE
"a" = (
/turf/simulated/shuttle/wall/voidcraft/survival,
/area/survivalpod)
"c" = (
/obj/machinery/button/remote/airlock/survival_pod/bolts{
	pixel_y = -24;
	pixel_x = 23
	},
/obj/machinery/light_switch/survival_pod{
	dir = 8;
	pixel_x = 33;
	pixel_y = -23
	},
/turf/simulated/floor/carpet/bcarpet,
/area/survivalpod)
"d" = (
/obj/structure/grille,
/obj/structure/window/reinforced/polarized/survival_pod{
	id = "podwindows";
	dir = 8
	},
/obj/structure/window/reinforced/polarized/survival_pod{
	id = "podwindows";
	dir = 4
	},
/turf/simulated/shuttle/floor/voidcraft/dark,
/area/survivalpod)
"e" = (
/turf/simulated/floor/carpet/bcarpet,
/area/survivalpod)
"f" = (
/obj/machinery/button/remote/airlock/survival_pod/bolts{
	pixel_y = -22;
	pixel_x = 21
	},
/obj/machinery/light_switch/survival_pod{
	dir = 1;
	pixel_x = 29;
	pixel_y = -21
	},
/obj/structure/disposalpipe/segment{
	dir = 8;
	icon_state = "pipe-c"
	},
/turf/simulated/floor/carpet/blue2,
/area/survivalpod/dorms)
"h" = (
/obj/structure/sign/mining/survival{
	dir = 1;
	layer = 2.9
	},
/obj/structure/disposalpipe/segment{
	dir = 4;
	icon_state = "pipe-c"
	},
/turf/simulated/shuttle/wall/voidcraft/survival,
/area/survivalpod/dorms)
"i" = (
/turf/simulated/shuttle/wall/voidcraft/survival/hard_corner,
/area/survivalpod/dorms)
"k" = (
/obj/machinery/door/window/survival_pod{
	dir = 2
	},
/obj/structure/sink/kitchen{
	dir = 4;
	pixel_x = 13;
	pixel_y = 9
	},
/turf/simulated/shuttle/floor/voidcraft/dark,
/area/survivalpod)
"l" = (
/obj/machinery/button/windowtint{
	pixel_x = 9;
	id = "podwindows";
	pixel_y = 30;
	range = 3
	},
/turf/simulated/floor/carpet/bcarpet,
/area/survivalpod)
"m" = (
/obj/structure/disposalpipe/segment{
	dir = 8;
	icon_state = "pipe-c"
	},
/turf/simulated/shuttle/wall/voidcraft/survival/hard_corner,
/area/survivalpod/dorms)
"n" = (
/obj/machinery/light,
/turf/simulated/floor/carpet/bcarpet,
/area/survivalpod)
"o" = (
/obj/structure/sign/mining/survival{
	dir = 1;
	layer = 2.9
	},
/obj/structure/sign/mining/survival{
	dir = 1;
	layer = 2.9
	},
/turf/simulated/shuttle/wall/voidcraft/survival,
/area/survivalpod)
"q" = (
/obj/structure/fans/tiny,
/obj/machinery/door/airlock/voidcraft/survival_pod,
/obj/effect/floor_decal/industrial/danger/full,
/turf/simulated/shuttle/floor/voidcraft,
/area/survivalpod/dorms)
"r" = (
/obj/structure/table/standard,
/turf/simulated/floor/carpet/blue2,
/area/survivalpod/dorms)
"u" = (
/obj/structure/fans/tiny,
/obj/machinery/door/airlock/voidcraft/survival_pod,
/obj/effect/floor_decal/industrial/danger/full,
/turf/simulated/shuttle/floor/voidcraft,
/area/survivalpod)
"x" = (
/obj/machinery/light{
	dir = 8
	},
/obj/structure/disposalpipe/segment{
	dir = 2;
	icon_state = "pipe-c"
	},
/turf/simulated/floor/carpet/blue2,
/area/survivalpod/dorms)
"y" = (
/obj/machinery/recharge_station,
/turf/simulated/floor/carpet/bcarpet,
/area/survivalpod)
"z" = (
/obj/structure/grille,
/obj/structure/window/reinforced/polarized/survival_pod{
	id = "podwindows";
	dir = 8
	},
/obj/structure/window/reinforced/polarized/survival_pod{
	id = "podwindows";
	dir = 4
	},
/obj/structure/window/reinforced/polarized/survival_pod{
	id = "podwindows"
	},
/turf/simulated/shuttle/floor/voidcraft/dark,
/area/survivalpod)
"A" = (
/obj/structure/sign/mining/survival,
/turf/simulated/shuttle/wall/voidcraft/survival,
/area/survivalpod)
"C" = (
/obj/structure/bed/chair/comfy/black{
	dir = 1
	},
/turf/simulated/floor/carpet/bcarpet,
/area/survivalpod)
"D" = (
/obj/structure/bed/chair/comfy/black,
/turf/simulated/floor/carpet/bcarpet,
/area/survivalpod)
"E" = (
/obj/machinery/holoplant,
/turf/simulated/floor/carpet/bcarpet,
/area/survivalpod)
"F" = (
/obj/structure/fans{
	pixel_y = 32;
	density = 0
	},
/obj/machinery/sleeper/survival_pod,
/turf/simulated/shuttle/floor/voidcraft/dark,
/area/survivalpod)
"G" = (
/obj/structure/table/steel_reinforced,
/obj/item/reagent_containers/food/drinks/bottle/melonliquor{
	pixel_y = 11;
	pixel_x = -6
	},
/obj/item/reagent_containers/food/drinks/metaglass{
	pixel_y = 10;
	pixel_x = 8
	},
/obj/item/reagent_containers/food/drinks/metaglass{
	pixel_y = 5;
	pixel_x = 3
	},
/turf/simulated/floor/carpet/bcarpet,
/area/survivalpod)
"H" = (
/obj/machinery/smartfridge/survival_pod{
	pixel_y = 27;
	density = 0
	},
/obj/item/storage/mre/random,
/obj/item/storage/mre/random,
/obj/item/storage/mre/random,
/obj/item/storage/mre/random,
/obj/item/storage/mre/random,
/obj/item/storage/mre/random,
/obj/item/storage/mre/menu9,
/obj/item/storage/mre/menu9,
/obj/item/storage/mre/menu10,
/obj/item/storage/mre/menu10,
/obj/item/storage/mre/menu11,
/obj/item/storage/mre/menu11,
/obj/item/fbp_backup_cell,
/obj/item/fbp_backup_cell,
/obj/item/fbp_backup_cell,
/obj/item/fbp_backup_cell,
/obj/item/fbp_backup_cell,
/obj/item/storage/firstaid/fire,
/obj/item/storage/firstaid/toxin,
/obj/item/storage/firstaid/o2,
/obj/item/storage/box/survival/space,
/obj/item/clothing/accessory/watch/survival,
/obj/item/emergency_beacon,
/obj/item/healthanalyzer,
/obj/item/storage/pill_bottle/dice_nerd,
/obj/item/deck/cards,
/obj/item/deck/cards/triple,
/obj/item/storage/mre/random,
/obj/item/spacecasinocash_fake/c1000,
/obj/item/spacecasinocash_fake/c1000,
/obj/item/storage/mre/random,
/obj/item/radio{
	icon_state = "walkietalkiebay";
	name = "emergency radio"
	},
/obj/item/stack/material/steel{
	amount = 5
	},
/obj/item/gps,
/obj/machinery/light/floortube,
/obj/item/storage/mre/random,
/obj/item/storage/mre/random,
/obj/item/reagent_containers/food/drinks/bottle/whiskey,
/turf/simulated/shuttle/floor/voidcraft/dark,
/area/survivalpod)
"I" = (
/obj/structure/sign/mining/survival{
	dir = 1;
	layer = 2.9
	},
/turf/simulated/shuttle/wall/voidcraft/survival,
/area/survivalpod/dorms)
"J" = (
/obj/structure/disposalpipe/segment{
	dir = 1;
	icon_state = "pipe-c"
	},
/turf/simulated/shuttle/wall/voidcraft/survival/hard_corner,
/area/survivalpod/dorms)
"K" = (
/obj/structure/sign/mining/survival{
	dir = 4
	},
/turf/simulated/shuttle/wall/voidcraft/survival,
/area/survivalpod/dorms)
"L" = (
/obj/machinery/disposal/wall{
	dir = 8
	},
/obj/structure/disposalpipe/trunk{
	dir = 4
	},
/turf/simulated/floor/carpet/bcarpet,
/area/survivalpod)
"M" = (
/obj/structure/sign/mining/survival{
	dir = 8
	},
/turf/simulated/shuttle/wall/voidcraft/survival,
/area/survivalpod)
"O" = (
/obj/structure/grille,
/obj/structure/window/reinforced/polarized/survival_pod{
	id = "podwindows";
	dir = 8
	},
/obj/structure/window/reinforced/polarized/survival_pod{
	id = "podwindows";
	dir = 4
	},
/obj/structure/window/reinforced/polarized/survival_pod{
	id = "podwindows";
	dir = 1
	},
/turf/simulated/shuttle/floor/voidcraft/dark,
/area/survivalpod)
"P" = (
/obj/structure/table/survival_pod,
/obj/machinery/recharger{
	pixel_y = 5;
	pixel_x = -5
	},
/obj/structure/window/reinforced/survival_pod,
/turf/simulated/shuttle/floor/voidcraft/dark,
/area/survivalpod)
"Q" = (
/obj/structure/disposalpipe/segment{
	dir = 4;
	icon_state = "pipe-c"
	},
/turf/simulated/shuttle/wall/voidcraft/survival/hard_corner,
/area/survivalpod/dorms)
"S" = (
/obj/structure/disposalpipe/segment{
	dir = 8;
	icon_state = "pipe-c"
	},
/turf/simulated/shuttle/wall/voidcraft/survival,
/area/survivalpod/dorms)
"U" = (
/turf/simulated/shuttle/wall/voidcraft/survival,
/area/survivalpod/dorms)
"X" = (
/obj/structure/bed/double/padded,
/obj/item/bedsheet/yellowdouble,
/turf/simulated/floor/carpet/blue2,
/area/survivalpod/dorms)

(1,1,1) = {"
a
M
a
O
d
z
a
"}
(2,1,1) = {"
o
F
P
D
G
C
A
"}
(3,1,1) = {"
a
H
k
L
e
n
a
"}
(4,1,1) = {"
h
J
Q
m
l
c
u
"}
(5,1,1) = {"
S
x
f
q
e
e
a
"}
(6,1,1) = {"
I
X
r
i
y
E
A
"}
(7,1,1) = {"
U
K
U
K
O
z
a
"}
