//MAP CONVERTED BY dmm2tgm.py THIS HEADER COMMENT PREVENTS RECONVERSION, DO NOT REMOVE
"a" = (
/turf/simulated/floor/carpet/blue2,
/area/survivalpod)
"c" = (
/obj/structure/bed/double/padded,
/obj/item/bedsheet/yellowdouble,
/turf/simulated/floor/carpet/blue2,
/area/survivalpod)
"d" = (
/obj/structure/sign/mining/survival{
	dir = 1;
	layer = 2.9
	},
/turf/simulated/shuttle/wall/voidcraft/survival,
/area/survivalpod)
"f" = (
/obj/structure/sign/mining/survival{
	dir = 4
	},
/turf/simulated/shuttle/wall/voidcraft/survival,
/area/survivalpod)
"h" = (
/obj/structure/grille,
/obj/structure/window/reinforced/polarized/survival_pod{
	id = "jeannepod";
	dir = 8
	},
/obj/structure/window/reinforced/polarized/survival_pod{
	id = "jeannepod";
	dir = 4
	},
/obj/structure/window/reinforced/polarized/survival_pod{
	id = "jeannepod";
	dir = 1
	},
/turf/simulated/shuttle/floor/voidcraft/dark,
/area/survivalpod)
"k" = (
/obj/machinery/smartfridge/survival_pod{
	pixel_y = 27;
	density = 0
	},
/obj/item/storage/mre/random,
/obj/item/storage/mre/random,
/obj/item/storage/mre/random,
/obj/item/storage/mre/random,
/obj/item/storage/mre/random,
/obj/item/storage/mre/random,
/obj/item/storage/mre/menu9,
/obj/item/storage/mre/menu9,
/obj/item/storage/mre/menu10,
/obj/item/storage/mre/menu10,
/obj/item/storage/mre/menu11,
/obj/item/storage/mre/menu11,
/obj/item/fbp_backup_cell,
/obj/item/fbp_backup_cell,
/obj/item/fbp_backup_cell,
/obj/item/fbp_backup_cell,
/obj/item/fbp_backup_cell,
/obj/item/storage/firstaid/fire,
/obj/item/storage/firstaid/toxin,
/obj/item/storage/firstaid/o2,
/obj/item/storage/box/survival/space,
/obj/item/clothing/accessory/watch/survival,
/obj/item/emergency_beacon,
/obj/item/healthanalyzer,
/obj/item/storage/pill_bottle/dice_nerd,
/obj/item/deck/cards,
/obj/item/deck/cards/triple,
/obj/item/spacecasinocash_fake/c1000,
/obj/item/spacecasinocash_fake/c1000,
/obj/item/storage/mre/random,
/obj/item/storage/mre/random,
/obj/item/radio{
	icon_state = "walkietalkiebay";
	name = "emergency radio"
	},
/obj/item/stack/material/steel{
	amount = 5
	},
/obj/item/juke_remote,
/obj/item/gps,
/obj/machinery/light/floortube,
/turf/simulated/shuttle/floor/voidcraft/dark,
/area/survivalpod)
"l" = (
/obj/structure/table/survival_pod,
/obj/machinery/recharger{
	pixel_y = 5;
	pixel_x = -5
	},
/obj/structure/window/reinforced/survival_pod,
/turf/simulated/shuttle/floor/voidcraft/dark,
/area/survivalpod)
"n" = (
/obj/structure/grille,
/obj/structure/window/reinforced/polarized/survival_pod{
	id = "jeannepod";
	dir = 8
	},
/obj/structure/window/reinforced/polarized/survival_pod{
	id = "jeannepod";
	dir = 4
	},
/turf/simulated/shuttle/floor/voidcraft/dark,
/area/survivalpod)
"o" = (
/obj/machinery/button/remote/airlock/survival_pod/bolts{
	pixel_y = -24;
	pixel_x = 23
	},
/turf/simulated/floor/carpet/bcarpet,
/area/survivalpod)
"s" = (
/obj/structure/table/standard,
/turf/simulated/floor/carpet/blue2,
/area/survivalpod)
"t" = (
/obj/structure/sign/mining/survival{
	dir = 4
	},
/turf/simulated/shuttle/wall/voidcraft/survival/hard_corner,
/area/survivalpod)
"v" = (
/obj/structure/bed/chair/comfy/black,
/turf/simulated/floor/carpet/bcarpet,
/area/survivalpod)
"w" = (
/obj/structure/fans{
	pixel_y = 32;
	density = 0
	},
/obj/machinery/sleeper/survival_pod,
/turf/simulated/shuttle/floor/voidcraft/dark,
/area/survivalpod)
"x" = (
/obj/machinery/holoplant,
/turf/simulated/floor/carpet/bcarpet,
/area/survivalpod)
"y" = (
/obj/structure/table/steel_reinforced,
/obj/item/reagent_containers/food/drinks/bottle/melonliquor{
	pixel_y = 11;
	pixel_x = -6
	},
/obj/item/reagent_containers/food/drinks/metaglass{
	pixel_y = 10;
	pixel_x = 8
	},
/obj/item/reagent_containers/food/drinks/metaglass{
	pixel_y = 5;
	pixel_x = 3
	},
/turf/simulated/floor/carpet/bcarpet,
/area/survivalpod)
"z" = (
/obj/machinery/button/remote/airlock/survival_pod/bolts{
	pixel_y = -24;
	pixel_x = 23
	},
/turf/simulated/floor/carpet/blue2,
/area/survivalpod)
"A" = (
/obj/structure/bed/chair/comfy/black{
	dir = 1
	},
/turf/simulated/floor/carpet/bcarpet,
/area/survivalpod)
"G" = (
/turf/simulated/shuttle/wall/voidcraft/survival,
/area/survivalpod)
"I" = (
/obj/machinery/button/windowtint{
	pixel_x = -1;
	id = "jeannepod";
	pixel_y = 30;
	range = 3
	},
/turf/simulated/floor/carpet/bcarpet,
/area/survivalpod)
"J" = (
/obj/structure/fans/tiny,
/obj/machinery/door/airlock/voidcraft/survival_pod,
/obj/effect/floor_decal/industrial/danger/full,
/turf/simulated/shuttle/floor/voidcraft,
/area/survivalpod)
"K" = (
/turf/simulated/shuttle/wall/voidcraft/survival/hard_corner,
/area/survivalpod)
"N" = (
/obj/structure/grille,
/obj/structure/window/reinforced/polarized/survival_pod{
	id = "jeannepod";
	dir = 8
	},
/obj/structure/window/reinforced/polarized/survival_pod{
	id = "jeannepod";
	dir = 4
	},
/obj/structure/window/reinforced/polarized/survival_pod{
	id = "jeannepod"
	},
/turf/simulated/shuttle/floor/voidcraft/dark,
/area/survivalpod)
"P" = (
/obj/structure/sign/mining/survival{
	dir = 8
	},
/turf/simulated/shuttle/wall/voidcraft/survival,
/area/survivalpod)
"U" = (
/obj/structure/sign/mining/survival,
/turf/simulated/shuttle/wall/voidcraft/survival,
/area/survivalpod)
"W" = (
/obj/machinery/recharge_station,
/turf/simulated/floor/carpet/bcarpet,
/area/survivalpod)
"X" = (
/turf/simulated/floor/carpet/bcarpet,
/area/survivalpod)
"Y" = (
/obj/machinery/door/window/survival_pod{
	dir = 2
	},
/turf/simulated/shuttle/floor/voidcraft/dark,
/area/survivalpod)
"Z" = (
/obj/structure/sign/mining/survival{
	dir = 1;
	layer = 2.9
	},
/obj/structure/sign/mining/survival{
	dir = 1;
	layer = 2.9
	},
/turf/simulated/shuttle/wall/voidcraft/survival,
/area/survivalpod)

(1,1,1) = {"
G
P
G
h
n
N
G
"}
(2,1,1) = {"
Z
w
l
v
y
A
U
"}
(3,1,1) = {"
G
k
Y
X
X
X
G
"}
(4,1,1) = {"
d
t
K
K
I
o
J
"}
(5,1,1) = {"
G
a
z
J
X
X
G
"}
(6,1,1) = {"
d
c
s
K
W
x
U
"}
(7,1,1) = {"
G
f
G
f
h
N
G
"}
