//MAP CONVERTED BY dmm2tgm.py THIS HEADER COMMENT PREVENTS RECONVERSION, DO NOT REMOVE
"a" = (
/turf/simulated/shuttle/wall/voidcraft/survival,
/area/survivalpod)
"b" = (
/obj/structure/sign/mining/survival{
	dir = 1
	},
/turf/simulated/shuttle/wall/voidcraft/survival,
/area/survivalpod)
"c" = (
/obj/structure/table/steel,
/obj/item/weapon/reagent_containers/food/drinks/glass2/rocks{
	pixel_x = 7;
	pixel_y = 2
	},
/obj/random/mre,
/obj/item/weapon/material/kitchen/utensil/fork{
	pixel_x = 12
	},
/turf/simulated/floor/carpet/bcarpet,
/area/survivalpod)
"d" = (
/obj/structure/sign/mining/survival{
	dir = 8
	},
/turf/simulated/shuttle/wall/voidcraft/survival,
/area/survivalpod)
"e" = (
/obj/structure/fans,
/turf/simulated/shuttle/floor/voidcraft,
/area/survivalpod)
"f" = (
/obj/machinery/smartfridge/survival_pod,
/obj/item/weapon/storage/mre/random,
/obj/item/weapon/storage/mre/random,
/obj/item/weapon/storage/mre/random,
/obj/item/weapon/storage/mre/random,
/obj/item/weapon/storage/mre/random,
/obj/item/weapon/storage/mre/random,
/obj/item/weapon/storage/mre/menu9,
/obj/item/weapon/storage/mre/menu9,
/obj/item/weapon/storage/mre/menu10,
/obj/item/weapon/storage/mre/menu10,
/obj/item/weapon/storage/mre/menu11,
/obj/item/weapon/storage/mre/menu11,
/obj/item/device/fbp_backup_cell,
/obj/item/device/fbp_backup_cell,
/obj/item/device/fbp_backup_cell,
/obj/item/device/fbp_backup_cell,
/obj/item/device/fbp_backup_cell,
/obj/item/weapon/storage/firstaid/fire,
/obj/item/weapon/storage/firstaid/toxin,
/obj/item/weapon/storage/firstaid/o2,
/obj/item/weapon/storage/box/survival/space,
/obj/item/clothing/gloves/watch/survival,
/obj/item/device/emergency_beacon,
/obj/item/device/healthanalyzer,
/obj/item/weapon/storage/pill_bottle/dice_nerd,
/turf/simulated/shuttle/floor/voidcraft,
/area/survivalpod)
"g" = (
/obj/item/device/gps/computer,
/turf/simulated/shuttle/floor/voidcraft,
/area/survivalpod)
"h" = (
/obj/machinery/shower,
/obj/item/weapon/soap/deluxe,
/obj/structure/curtain,
/turf/simulated/shuttle/floor/voidcraft,
/area/survivalpod)
"i" = (
/obj/structure/toilet,
/turf/simulated/shuttle/floor/voidcraft,
/area/survivalpod)
"j" = (
/obj/structure/sign/mining/survival{
	dir = 4
	},
/turf/simulated/shuttle/wall/voidcraft/survival,
/area/survivalpod)
"k" = (
/obj/machinery/sleeper/survival_pod,
/turf/simulated/shuttle/floor/voidcraft,
/area/survivalpod)
"l" = (
/turf/simulated/shuttle/floor/voidcraft,
/area/survivalpod)
"m" = (
/obj/structure/bed/pod,
/obj/item/weapon/bedsheet/blue,
/turf/simulated/shuttle/floor/voidcraft,
/area/survivalpod)
"n" = (
/obj/structure/window/reinforced/survival_pod{
	dir = 8;
	layer = 2.6
	},
/obj/machinery/door/window/survival_pod{
	dir = 1;
	icon_state = "windoor"
	},
/turf/simulated/floor/carpet/bcarpet,
/area/survivalpod)
"o" = (
/obj/structure/bed/chair/comfy/black,
/obj/structure/window/reinforced/survival_pod{
	dir = 1;
	icon_state = "pwindow"
	},
/turf/simulated/floor/carpet/bcarpet,
/area/survivalpod)
"p" = (
/obj/structure/table/survival_pod,
/obj/item/weapon/storage/firstaid/adv,
/turf/simulated/shuttle/floor/voidcraft,
/area/survivalpod)
"q" = (
/obj/structure/tubes,
/obj/machinery/recharge_station,
/turf/simulated/shuttle/floor/voidcraft,
/area/survivalpod)
"r" = (
/obj/structure/window/reinforced/survival_pod{
	dir = 8;
	icon_state = "pwindow"
	},
/turf/simulated/floor/carpet/bcarpet,
/area/survivalpod)
"s" = (
/obj/machinery/light{
	dir = 4;
	light_color = "#DDFFD3"
	},
/obj/structure/table/steel,
/obj/item/weapon/reagent_containers/food/drinks/glass2/rocks{
	pixel_x = 7;
	pixel_y = 2
	},
/obj/item/weapon/reagent_containers/food/drinks/bottle/wine{
	pixel_x = -6;
	pixel_y = 10
	},
/turf/simulated/floor/carpet/bcarpet,
/area/survivalpod)
"t" = (
/obj/machinery/microwave{
	pixel_y = -2
	},
/obj/structure/window/reinforced/survival_pod{
	dir = 1;
	icon_state = "pwindow"
	},
/obj/structure/table/steel{
	pixel_y = -9
	},
/turf/simulated/floor/carpet/bcarpet,
/area/survivalpod)
"u" = (
/obj/machinery/door/window/survival_pod{
	dir = 1;
	icon_state = "windoor"
	},
/turf/simulated/floor/carpet/bcarpet,
/area/survivalpod)
"v" = (
/obj/structure/window/reinforced/survival_pod{
	dir = 1;
	icon_state = "pwindow"
	},
/obj/machinery/holoplant,
/turf/simulated/floor/carpet/bcarpet,
/area/survivalpod)
"w" = (
/obj/structure/window/reinforced/survival_pod{
	density = 0;
	dir = 9;
	icon_state = "pwindow"
	},
/turf/simulated/floor/carpet/bcarpet,
/area/survivalpod)
"y" = (
/obj/structure/sink/kitchen{
	dir = 8;
	pixel_x = -13
	},
/turf/simulated/floor/carpet/bcarpet,
/area/survivalpod)
"z" = (
/obj/machinery/light,
/turf/simulated/floor/carpet/bcarpet,
/area/survivalpod)
"A" = (
/turf/simulated/floor/carpet/bcarpet,
/area/survivalpod)
"B" = (
/obj/structure/bed/chair/comfy/black{
	dir = 1
	},
/turf/simulated/floor/carpet/bcarpet,
/area/survivalpod)
"C" = (
/obj/structure/sign/mining/survival,
/turf/simulated/shuttle/wall/voidcraft/survival,
/area/survivalpod)
"D" = (
/obj/structure/fans/tiny,
/obj/machinery/door/airlock/voidcraft/survival_pod,
/obj/effect/floor_decal/industrial/danger/full,
/turf/simulated/shuttle/floor/voidcraft,
/area/survivalpod)
"E" = (
/obj/structure/sign/mining,
/turf/simulated/shuttle/wall/voidcraft/survival,
/area/survivalpod)
"S" = (
/obj/machinery/button/remote/airlock/survival_pod{
	dir = 10;
	pixel_y = -24
	},
/turf/simulated/floor/carpet/bcarpet,
/area/survivalpod)

(1,1,1) = {"
a
d
a
d
a
d
a
"}
(2,1,1) = {"
b
e
k
p
t
y
C
"}
(3,1,1) = {"
a
f
l
l
u
z
a
"}
(4,1,1) = {"
b
g
m
q
v
A
D
"}
(5,1,1) = {"
a
h
n
r
w
S
a
"}
(6,1,1) = {"
b
i
o
s
c
B
E
"}
(7,1,1) = {"
a
j
a
j
a
j
a
"}
