//MAP CONVERTED BY dmm2tgm.py THIS HEADER COMMENT PREVENTS RECONVERSION, DO NOT REMOVE
"a" = (
/turf/simulated/shuttle/wall/voidcraft/survival,
/area/survivalpod)
"b" = (
/obj/structure/sign/mining/survival{
	dir = 1
	},
/turf/simulated/shuttle/wall/voidcraft/survival,
/area/survivalpod)
"c" = (
/turf/simulated/shuttle/wall/voidcraft/survival/hard_corner,
/area/survivalpod)
"d" = (
/obj/structure/sign/mining/survival{
	dir = 1
	},
/turf/simulated/shuttle/wall/voidcraft/survival/hard_corner,
/area/survivalpod)
"e" = (
/obj/structure/sign/mining/survival{
	dir = 8
	},
/turf/simulated/shuttle/wall/voidcraft/survival/hard_corner,
/area/survivalpod)
"f" = (
/obj/structure/table/gamblingtable,
/obj/machinery/chemical_dispenser/bar_alc/full,
/turf/simulated/shuttle/floor/voidcraft/dark,
/area/survivalpod)
"g" = (
/obj/structure/table/gamblingtable,
/obj/machinery/chemical_dispenser/bar_soft/full,
/obj/machinery/light{
	dir = 1
	},
/turf/simulated/shuttle/floor/voidcraft/dark,
/area/survivalpod)
"h" = (
/obj/machinery/vending/boozeomat{
	req_access = newlist()
	},
/turf/simulated/shuttle/floor/voidcraft/dark,
/area/survivalpod)
"i" = (
/obj/item/weapon/book/manual/barman_recipes,
/obj/item/weapon/reagent_containers/food/drinks/shaker,
/obj/item/weapon/reagent_containers/glass/rag,
/obj/structure/table/gamblingtable,
/turf/simulated/shuttle/floor/voidcraft/dark,
/area/survivalpod)
"j" = (
/obj/structure/fans,
/turf/simulated/shuttle/floor/voidcraft/dark,
/area/survivalpod)
"k" = (
/obj/structure/table/gamblingtable,
/obj/item/weapon/clipboard,
/obj/item/toy/figure/bartender,
/obj/item/weapon/storage/fancy/cigar,
/turf/simulated/shuttle/floor/voidcraft/dark,
/area/survivalpod)
"l" = (
/obj/structure/table/gamblingtable,
/obj/structure/reagent_dispensers/beerkeg,
/turf/simulated/shuttle/floor/voidcraft/dark,
/area/survivalpod)
"m" = (
/obj/structure/closet/secure_closet/bar{
	req_access = newlist()
	},
/obj/machinery/light{
	dir = 1
	},
/turf/simulated/shuttle/floor/voidcraft/dark,
/area/survivalpod)
"n" = (
/obj/structure/disposalpipe/trunk{
	dir = 4
	},
/obj/machinery/disposal,
/turf/simulated/shuttle/floor/voidcraft/dark,
/area/survivalpod)
"o" = (
/obj/structure/sign/mining/survival{
	dir = 4
	},
/obj/structure/disposalpipe/junction{
	dir = 4
	},
/turf/simulated/shuttle/wall/voidcraft/survival,
/area/survivalpod)
"p" = (
/obj/machinery/door/airlock/voidcraft/survival_pod,
/obj/structure/fans/tiny,
/obj/effect/floor_decal/industrial/danger/full,
/turf/simulated/shuttle/floor/voidcraft/dark,
/area/survivalpod)
"q" = (
/turf/simulated/shuttle/floor/voidcraft/dark,
/area/survivalpod)
"r" = (
/obj/structure/disposalpipe/segment,
/turf/simulated/shuttle/wall/voidcraft/survival/hard_corner,
/area/survivalpod)
"s" = (
/obj/structure/table/reinforced,
/obj/item/weapon/flame/lighter/random{
	pixel_x = -4;
	pixel_y = 4
	},
/obj/item/weapon/flame/lighter/random,
/obj/item/weapon/storage/firstaid/regular,
/turf/simulated/shuttle/floor/voidcraft/dark,
/area/survivalpod)
"t" = (
/obj/structure/table/reinforced,
/turf/simulated/shuttle/floor/voidcraft/dark,
/area/survivalpod)
"u" = (
/obj/structure/table/reinforced,
/obj/item/weapon/storage/box/matches{
	pixel_x = -4;
	pixel_y = 8
	},
/turf/simulated/shuttle/floor/voidcraft/dark,
/area/survivalpod)
"v" = (
/obj/machinery/door/window/survival_pod{
	dir = 2
	},
/turf/simulated/shuttle/floor/voidcraft/dark,
/area/survivalpod)
"w" = (
/obj/structure/sign/mining/survival{
	dir = 4
	},
/obj/structure/disposalpipe/segment,
/turf/simulated/shuttle/wall/voidcraft/survival/hard_corner,
/area/survivalpod)
"x" = (
/obj/item/weapon/stool/padded,
/turf/simulated/floor/carpet/bcarpet,
/area/survivalpod)
"y" = (
/turf/simulated/floor/carpet/bcarpet,
/area/survivalpod)
"z" = (
/obj/machinery/vending/cigarette,
/turf/simulated/floor/carpet/bcarpet,
/area/survivalpod)
"A" = (
/obj/structure/disposalpipe/trunk{
	dir = 4
	},
/obj/machinery/disposal,
/turf/simulated/floor/carpet/bcarpet,
/area/survivalpod)
"B" = (
/obj/structure/sign/mining/survival{
	dir = 4
	},
/obj/structure/disposalpipe/segment{
	dir = 8;
	icon_state = "pipe-c"
	},
/turf/simulated/shuttle/wall/voidcraft/survival/hard_corner,
/area/survivalpod)
"C" = (
/obj/structure/window/reinforced/survival_pod{
	dir = 8
	},
/obj/structure/window/reinforced/survival_pod{
	dir = 4
	},
/obj/structure/window/reinforced/survival_pod{
	dir = 1
	},
/obj/structure/window/reinforced/survival_pod,
/obj/structure/grille,
/turf/simulated/shuttle/floor/voidcraft/dark,
/area/survivalpod)
"D" = (
/obj/structure/bed/chair/comfy/black,
/turf/simulated/floor/carpet/bcarpet,
/area/survivalpod)
"E" = (
/obj/machinery/door/airlock/voidcraft/survival_pod,
/turf/simulated/shuttle/floor/voidcraft/light,
/area/survivalpod)
"F" = (
/obj/structure/table/gamblingtable,
/obj/item/weapon/reagent_containers/food/condiment/small/peppermill{
	pixel_x = -4;
	pixel_y = 12
	},
/obj/item/weapon/reagent_containers/food/condiment/small/saltshaker{
	pixel_x = 4;
	pixel_y = 4
	},
/turf/simulated/floor/carpet/bcarpet,
/area/survivalpod)
"G" = (
/obj/structure/urinal{
	pixel_y = 24
	},
/turf/simulated/shuttle/floor/voidcraft/light,
/area/survivalpod)
"H" = (
/turf/simulated/shuttle/floor/voidcraft/light,
/area/survivalpod)
"I" = (
/obj/structure/sink{
	dir = 4;
	pixel_x = 11
	},
/obj/machinery/light/small{
	dir = 4
	},
/turf/simulated/shuttle/floor/voidcraft/light,
/area/survivalpod)
"J" = (
/obj/structure/sign/mining/survival{
	dir = 4
	},
/turf/simulated/shuttle/wall/voidcraft/survival/hard_corner,
/area/survivalpod)
"K" = (
/obj/structure/bed/chair/comfy/black{
	dir = 1
	},
/turf/simulated/floor/carpet/bcarpet,
/area/survivalpod)
"L" = (
/obj/machinery/vending/snack,
/turf/simulated/floor/carpet/bcarpet,
/area/survivalpod)
"M" = (
/obj/machinery/light,
/turf/simulated/floor/carpet/bcarpet,
/area/survivalpod)
"N" = (
/obj/structure/toilet{
	dir = 8
	},
/obj/machinery/light/small{
	dir = 4
	},
/turf/simulated/shuttle/floor/voidcraft/light,
/area/survivalpod)
"O" = (
/obj/structure/sign/mining/survival{
	dir = 4
	},
/turf/simulated/shuttle/wall/voidcraft/survival,
/area/survivalpod)
"P" = (
/obj/structure/sign/mining/survival,
/turf/simulated/shuttle/wall/voidcraft/survival,
/area/survivalpod)
"Q" = (
/obj/structure/sign/mining/survival,
/turf/simulated/shuttle/wall/voidcraft/survival/hard_corner,
/area/survivalpod)

(1,1,1) = {"
a
e
p
e
c
e
C
e
C
e
a
"}
(2,1,1) = {"
b
j
q
s
x
y
D
F
K
L
P
"}
(3,1,1) = {"
c
f
q
t
x
y
y
y
y
M
c
"}
(4,1,1) = {"
d
g
q
t
x
y
D
F
K
y
Q
"}
(5,1,1) = {"
c
h
q
u
x
y
D
F
K
y
c
"}
(6,1,1) = {"
d
i
q
t
x
y
y
y
y
y
p
"}
(7,1,1) = {"
c
k
q
t
x
y
c
c
c
c
c
"}
(8,1,1) = {"
d
l
q
t
x
y
c
G
H
H
Q
"}
(9,1,1) = {"
c
m
q
v
y
y
E
H
c
E
c
"}
(10,1,1) = {"
b
n
q
t
z
A
c
I
c
N
P
"}
(11,1,1) = {"
a
o
r
w
r
B
c
J
c
O
a
"}
