"a" = (/turf/template_noop,/area/template_noop)
"b" = (/turf/simulated/wall/log_sif,/area/submap/ButcherShack)
"c" = (/turf/simulated/floor/wood/sif,/area/submap/ButcherShack)
"d" = (/obj/structure/closet,/obj/effect/decal/cleanable/cobweb,/obj/item/weapon/beartrap{start_anomalous = 1},/obj/item/weapon/beartrap,/obj/item/weapon/packageWrap,/obj/item/weapon/material/knife/hook,/turf/simulated/floor/wood/sif,/area/submap/ButcherShack)
"e" = (/obj/structure/closet/secure_closet/freezer/meat,/turf/simulated/floor/wood/sif,/area/submap/ButcherShack)
"f" = (/obj/structure/closet/crate/freezer,/obj/effect/decal/cleanable/blood/gibs,/obj/random/meat,/obj/random/meat,/obj/random/meat,/obj/random/meat,/obj/random/meat,/obj/random/meat,/obj/random/meat,/obj/random/meat,/obj/random/meat,/obj/random/meat,/turf/simulated/floor/wood/sif/broken,/area/submap/ButcherShack)
"g" = (/obj/machinery/gibber/autogibber,/turf/simulated/floor/wood/sif,/area/submap/ButcherShack)
"h" = (/turf/simulated/floor/wood/sif/broken,/area/submap/ButcherShack)
"i" = (/obj/structure/window/basic,/obj/structure/curtain,/turf/simulated/floor/wood/sif/broken,/area/submap/ButcherShack)
"j" = (/turf/template_noop,/area/submap/ButcherShack)
"k" = (/obj/structure/simple_door/sifwood,/turf/simulated/floor/wood/sif,/area/submap/ButcherShack)
"l" = (/obj/structure/loot_pile/maint/trash,/turf/simulated/floor/outdoors/dirt,/area/submap/ButcherShack)
"m" = (/obj/structure/kitchenspike,/obj/effect/decal/cleanable/blood,/turf/simulated/floor/wood/sif,/area/submap/ButcherShack)
"n" = (/obj/structure/kitchenspike,/obj/effect/decal/cleanable/blood/drip,/turf/simulated/floor/wood/sif,/area/submap/ButcherShack)
"o" = (/obj/effect/decal/cleanable/blood,/turf/simulated/floor/wood/sif,/area/submap/ButcherShack)
"p" = (/obj/structure/table/standard,/obj/item/clothing/suit/chef/classic{start_anomalous = 1},/turf/simulated/floor/wood/sif,/area/submap/ButcherShack)
"q" = (/obj/structure/table/standard,/obj/effect/decal/cleanable/blood,/obj/item/weapon/material/knife/butch{start_anomalous = 1},/turf/simulated/floor/wood/sif/broken,/area/submap/ButcherShack)
"r" = (/obj/structure/table/standard,/obj/item/weapon/reagent_containers/food/snacks/cutlet,/obj/item/weapon/reagent_containers/food/snacks/cutlet,/obj/item/weapon/reagent_containers/food/snacks/cutlet,/obj/item/weapon/reagent_containers/food/snacks/sausage,/turf/simulated/floor/wood/sif,/area/submap/ButcherShack)
"s" = (/obj/structure/coatrack,/turf/simulated/floor/wood/sif,/area/submap/ButcherShack)
"t" = (/obj/structure/bed/padded,/obj/item/weapon/bedsheet/brown,/turf/simulated/floor/wood/sif,/area/submap/ButcherShack)
"u" = (/obj/effect/decal/cleanable/blood/drip,/turf/simulated/floor/wood/sif/broken,/area/submap/ButcherShack)
"v" = (/turf/simulated/floor/outdoors/dirt,/area/submap/ButcherShack)
"w" = (/obj/structure/window/basic,/obj/structure/curtain,/turf/simulated/floor/wood/sif,/area/submap/ButcherShack)

(1,1,1) = {"
aaaaaaaaaa
abbbbbbbba
abdmnefgba
abhcccocba
abcpqrccba
absocchtba
abbubiwbba
ajbkbllvja
ajvvvvvjja
aaaaaaaaaa
"}
