//MAP CONVERTED BY dmm2tgm.py THIS HEADER COMMENT PREVENTS RECONVERSION, DO NOT REMOVE
"a" = (
/turf/template_noop,
/area/template_noop)
"b" = (
/turf/template_noop,
/area/submap/CaveS)
"c" = (
/obj/item/ammo_casing/a45,
/turf/template_noop,
/area/submap/CaveS)
"d" = (
/turf/simulated/mineral/ignore_mapgen,
/area/submap/CaveS)
"e" = (
/obj/item/ammo_casing/a45,
/obj/item/weapon/reagent_containers/food/snacks/xenomeat/spidermeat,
/turf/template_noop,
/area/submap/CaveS)
"f" = (
/obj/random/landmine,
/turf/template_noop,
/area/submap/CaveS)
"g" = (
/obj/item/ammo_casing/a45,
/obj/random/landmine,
/turf/template_noop,
/area/submap/CaveS)
"h" = (
/obj/random/landmine,
/turf/simulated/floor/outdoors/dirt{
	outdoors = 0
	},
/area/submap/CaveS)
"i" = (
/obj/effect/spider/stickyweb,
/turf/simulated/floor/outdoors/dirt{
	outdoors = 0
	},
/area/submap/CaveS)
"j" = (
/obj/item/ammo_casing/a45,
/obj/item/ammo_casing/a45,
/turf/template_noop,
/area/submap/CaveS)
"k" = (
/turf/simulated/floor/outdoors/dirt{
	outdoors = 0
	},
/area/submap/CaveS)
"l" = (
/obj/item/weapon/reagent_containers/food/snacks/xenomeat/spidermeat,
/turf/template_noop,
/area/submap/CaveS)
"m" = (
/obj/effect/spider/stickyweb,
/turf/simulated/floor/outdoors/dirt,
/area/submap/CaveS)
"n" = (
/obj/item/clothing/accessory/storage/webbing,
/obj/item/weapon/material/knife/tacknife/combatknife,
/turf/simulated/floor/outdoors/dirt{
	outdoors = 0
	},
/area/submap/CaveS)
"o" = (
/mob/living/simple_animal/hostile/giant_spider,
/turf/simulated/floor/outdoors/dirt{
	outdoors = 0
	},
/area/submap/CaveS)
"p" = (
/obj/effect/decal/cleanable/cobweb,
/turf/simulated/floor/outdoors/dirt{
	outdoors = 0
	},
/area/submap/CaveS)
"q" = (
/mob/living/simple_animal/hostile/giant_spider/lurker,
/turf/simulated/floor/outdoors/dirt{
	outdoors = 0
	},
/area/submap/CaveS)
"r" = (
/obj/effect/decal/cleanable/cobweb2,
/turf/simulated/floor/outdoors/dirt{
	outdoors = 0
	},
/area/submap/CaveS)
"s" = (
/mob/living/simple_animal/hostile/giant_spider/webslinger,
/turf/simulated/floor/outdoors/dirt{
	outdoors = 0
	},
/area/submap/CaveS)
"t" = (
/obj/effect/decal/cleanable/cobweb2,
/mob/living/simple_animal/hostile/giant_spider/lurker,
/turf/simulated/floor/outdoors/dirt{
	outdoors = 0
	},
/area/submap/CaveS)
"u" = (
/turf/simulated/floor/outdoors/grass/sif/forest,
/area/submap/CaveS)
"v" = (
/mob/living/simple_animal/hostile/giant_spider/lurker,
/turf/simulated/floor/outdoors/dirt,
/area/submap/CaveS)
"x" = (
/obj/structure/flora/tree/sif,
/turf/simulated/floor/outdoors/grass/sif/forest,
/area/submap/CaveS)
"y" = (
/obj/random/landmine,
/turf/simulated/floor/outdoors/grass/sif/forest,
/area/submap/CaveS)
"z" = (
/turf/simulated/floor,
/area/submap/CaveS)
"A" = (
/obj/structure/closet/crate,
/obj/item/stack/cable_coil,
/obj/item/stack/cable_coil,
/obj/item/weapon/storage/toolbox,
/obj/random/toolbox,
/turf/simulated/floor,
/area/submap/CaveS)
"B" = (
/obj/structure/loot_pile/maint/technical,
/turf/simulated/floor,
/area/submap/CaveS)
"C" = (
/obj/structure/table/woodentable,
/turf/simulated/floor,
/area/submap/CaveS)
"E" = (
/obj/machinery/power/port_gen/pacman,
/obj/structure/cable{
	icon_state = "0-2";
	d2 = 2
	},
/turf/simulated/floor,
/area/submap/CaveS)
"F" = (
/turf/simulated/wall,
/area/submap/CaveS)
"G" = (
/obj/structure/closet/crate,
/obj/item/weapon/reagent_containers/hypospray,
/obj/item/weapon/reagent_containers/glass/bottle/stoxin,
/obj/item/weapon/reagent_containers/glass/bottle/antitoxin,
/obj/item/weapon/reagent_containers/pill/antitox,
/obj/item/weapon/reagent_containers/pill/antitox,
/obj/item/weapon/reagent_containers/pill/antitox,
/obj/item/weapon/reagent_containers/pill/paracetamol,
/obj/random/firstaid,
/turf/simulated/floor,
/area/submap/CaveS)
"H" = (
/obj/structure/cable{
	d1 = 1;
	d2 = 2;
	icon_state = "1-2";
	pixel_y = 0
	},
/turf/simulated/floor,
/area/submap/CaveS)
"I" = (
/obj/structure/closet/crate,
/obj/random/contraband,
/obj/random/contraband,
/obj/random/contraband,
/obj/random/energy,
/obj/item/weapon/material/star,
/obj/item/weapon/material/star,
/obj/item/weapon/material/star,
/obj/item/weapon/material/star,
/obj/item/weapon/material/star,
/turf/simulated/floor,
/area/submap/CaveS)
"J" = (
/obj/effect/spider/stickyweb,
/mob/living/simple_animal/hostile/giant_spider/lurker,
/turf/simulated/floor/outdoors/dirt{
	outdoors = 0
	},
/area/submap/CaveS)
"K" = (
/obj/structure/cable{
	d1 = 1;
	d2 = 4;
	icon_state = "1-4"
	},
/turf/simulated/floor,
/area/submap/CaveS)
"L" = (
/obj/structure/cable{
	d1 = 4;
	d2 = 8;
	icon_state = "4-8";
	pixel_x = 0
	},
/turf/simulated/floor,
/area/submap/CaveS)
"M" = (
/obj/machinery/computer/communications,
/obj/structure/cable{
	d2 = 8;
	icon_state = "0-8"
	},
/turf/simulated/floor,
/area/submap/CaveS)
"N" = (
/obj/structure/loot_pile/maint/boxfort,
/turf/simulated/floor,
/area/submap/CaveS)
"P" = (
/obj/random/mob/spider/mutant,
/turf/simulated/floor/outdoors/dirt{
	outdoors = 0
	},
/area/submap/CaveS)
"V" = (
/obj/random/mob/spider,
/turf/simulated/floor/outdoors/dirt{
	outdoors = 0
	},
/area/submap/CaveS)

(1,1,1) = {"
a
a
a
a
a
a
a
a
a
a
a
a
a
a
a
a
a
a
a
a
a
a
a
a
a
a
a
a
a
a
a
a
a
a
a
a
a
a
a
a
"}
(2,1,1) = {"
a
b
b
b
b
b
b
b
b
b
b
b
b
b
b
b
b
b
b
b
b
b
b
b
b
b
b
b
b
b
b
b
b
b
b
b
b
b
b
a
"}
(3,1,1) = {"
a
b
b
b
b
b
b
b
b
b
b
b
b
b
b
b
b
b
d
d
d
d
d
d
d
d
d
d
d
d
d
d
d
b
b
b
b
b
b
a
"}
(4,1,1) = {"
a
b
b
b
b
b
b
b
b
b
b
b
b
b
d
d
d
d
d
d
d
d
d
d
d
d
d
d
d
d
d
d
d
d
d
d
b
b
b
a
"}
(5,1,1) = {"
a
b
b
b
b
b
b
b
b
b
b
d
d
d
d
d
d
d
d
d
d
d
d
d
u
u
d
d
u
u
d
d
d
d
d
d
d
d
d
a
"}
(6,1,1) = {"
a
b
b
b
b
b
b
b
b
d
d
d
d
d
d
d
d
d
d
d
d
d
d
u
x
u
u
u
u
u
u
d
d
d
d
d
d
d
d
a
"}
(7,1,1) = {"
a
b
b
b
b
b
b
b
b
d
d
d
d
d
d
o
i
d
d
d
d
d
d
u
u
y
u
u
u
u
u
d
d
d
d
d
d
d
b
a
"}
(8,1,1) = {"
a
b
b
b
b
b
b
b
b
d
d
d
d
d
d
k
k
k
d
d
d
d
u
u
u
u
u
u
u
u
u
x
d
d
d
d
d
d
b
a
"}
(9,1,1) = {"
a
b
b
b
b
b
b
b
b
d
d
d
d
d
n
k
k
V
d
d
d
d
u
u
u
u
x
y
u
u
u
u
d
d
d
d
d
b
b
a
"}
(10,1,1) = {"
a
b
b
b
b
b
b
b
b
d
d
d
d
d
d
k
k
k
k
k
d
d
d
d
d
u
u
u
u
u
u
k
u
d
d
d
d
b
b
a
"}
(11,1,1) = {"
a
b
b
b
b
b
b
b
b
b
d
d
d
d
k
k
k
k
k
k
k
d
d
d
d
d
i
k
u
k
k
k
i
d
d
d
d
b
b
a
"}
(12,1,1) = {"
a
b
b
b
b
b
b
b
b
b
d
d
d
d
k
k
k
k
k
k
k
s
d
d
d
d
d
k
k
k
k
d
d
d
d
d
d
b
b
a
"}
(13,1,1) = {"
a
b
b
b
b
b
b
b
b
b
d
d
d
d
i
k
q
d
k
k
k
k
d
d
d
d
d
k
k
d
v
d
d
d
d
d
d
d
b
a
"}
(14,1,1) = {"
a
b
b
b
b
b
b
b
b
b
b
d
d
d
d
d
d
d
d
r
k
k
d
d
d
d
d
k
k
d
d
d
d
d
d
d
d
d
d
a
"}
(15,1,1) = {"
a
b
b
b
b
b
b
b
b
c
b
b
d
d
d
d
d
d
d
d
k
k
P
k
k
d
d
k
k
d
d
d
d
d
d
d
d
d
d
a
"}
(16,1,1) = {"
a
b
b
b
b
b
b
b
b
b
b
b
b
d
d
d
b
b
d
d
k
k
k
k
k
k
k
k
i
d
d
d
d
d
d
d
d
d
d
a
"}
(17,1,1) = {"
a
b
b
b
b
b
c
b
b
b
b
b
b
b
b
b
b
d
d
d
k
k
d
d
q
k
k
k
d
d
d
d
d
d
d
d
d
d
d
a
"}
(18,1,1) = {"
a
b
b
b
b
b
b
b
b
b
b
b
b
b
b
b
d
d
d
d
k
k
d
d
d
k
k
d
d
d
d
i
J
k
d
d
d
d
b
a
"}
(19,1,1) = {"
a
b
b
b
b
b
b
b
b
b
j
c
b
b
d
d
d
d
d
d
k
k
d
d
d
k
k
k
d
d
d
k
k
k
k
d
d
d
b
a
"}
(20,1,1) = {"
a
b
b
b
b
b
b
b
b
g
b
b
b
b
d
d
d
d
d
p
k
k
v
d
d
k
k
k
i
d
k
k
k
k
i
d
d
b
b
a
"}
(21,1,1) = {"
a
b
b
b
b
b
b
b
b
b
b
l
b
d
d
d
d
d
d
k
k
k
d
d
d
d
k
k
k
k
k
k
k
k
d
d
d
b
b
a
"}
(22,1,1) = {"
a
b
b
b
b
b
b
b
b
b
f
b
d
d
d
d
d
d
d
V
k
k
d
d
d
d
k
k
k
h
k
k
k
k
d
d
d
d
d
a
"}
(23,1,1) = {"
a
b
b
b
c
b
b
b
f
b
b
d
d
d
d
d
d
d
d
k
k
k
d
d
d
d
h
k
k
k
i
d
d
d
d
d
d
d
b
a
"}
(24,1,1) = {"
a
b
b
b
b
b
c
b
b
h
k
m
d
d
d
d
d
d
d
k
k
k
d
d
d
d
i
i
h
k
d
d
d
d
d
d
d
d
b
a
"}
(25,1,1) = {"
a
b
b
b
b
b
c
e
d
i
k
k
m
d
d
d
d
d
d
k
k
k
d
d
d
d
d
d
k
k
k
k
k
d
d
d
d
d
d
a
"}
(26,1,1) = {"
a
b
b
b
b
b
c
d
d
d
d
i
k
d
d
p
k
k
h
k
k
k
i
d
d
d
d
d
k
k
k
k
k
k
P
d
d
d
d
a
"}
(27,1,1) = {"
a
b
b
b
b
b
d
d
d
d
d
i
k
h
k
k
k
k
k
d
d
k
k
k
d
d
d
k
k
k
z
z
z
k
k
q
d
d
d
a
"}
(28,1,1) = {"
a
b
b
b
b
b
d
d
d
d
d
d
k
k
k
k
k
d
d
d
d
t
k
k
d
d
k
k
k
z
E
H
K
k
k
k
d
d
d
a
"}
(29,1,1) = {"
a
b
b
b
b
b
d
d
d
d
d
d
d
m
k
k
k
d
d
d
d
d
k
k
d
q
k
z
z
C
F
F
L
z
z
k
d
d
d
a
"}
(30,1,1) = {"
a
b
b
b
b
b
d
d
d
d
d
d
d
d
k
k
k
d
d
d
d
d
k
k
d
k
k
z
z
C
F
F
M
z
N
d
d
d
b
a
"}
(31,1,1) = {"
a
b
b
b
b
b
d
d
d
d
d
d
d
d
k
k
k
d
d
p
h
k
k
V
d
d
k
A
z
z
G
I
z
z
d
d
d
b
b
a
"}
(32,1,1) = {"
a
b
b
b
b
b
b
d
d
d
d
d
d
d
k
k
k
k
k
k
k
k
k
d
d
d
k
k
B
z
P
k
z
d
d
d
b
b
b
a
"}
(33,1,1) = {"
a
b
b
b
b
b
b
d
d
d
d
d
d
d
d
V
d
r
k
d
d
d
d
d
d
d
d
k
k
k
k
k
d
d
d
d
b
b
b
a
"}
(34,1,1) = {"
a
b
b
b
b
b
b
b
d
d
d
d
d
d
d
d
d
d
d
d
d
d
d
d
d
d
d
k
d
k
k
d
d
d
d
b
b
b
b
a
"}
(35,1,1) = {"
a
b
b
b
b
b
b
b
d
d
d
d
d
d
d
d
d
d
d
d
d
d
d
d
d
d
d
d
d
d
d
d
d
d
d
b
b
b
b
a
"}
(36,1,1) = {"
a
b
b
b
b
b
b
d
d
d
d
d
b
b
d
d
d
d
d
d
d
d
d
d
d
d
b
d
d
d
d
d
d
d
b
b
b
b
b
a
"}
(37,1,1) = {"
a
b
b
b
b
b
b
d
d
d
d
b
b
b
b
b
d
d
d
d
d
d
d
d
b
b
b
b
b
b
d
d
b
b
b
b
b
b
b
a
"}
(38,1,1) = {"
a
b
b
b
b
b
b
b
b
b
b
b
b
b
b
b
b
b
d
d
d
d
d
b
b
b
b
b
b
b
b
b
b
b
b
b
b
b
b
a
"}
(39,1,1) = {"
a
b
b
b
b
b
b
b
b
b
b
b
b
b
b
b
b
b
b
b
d
d
b
b
b
b
b
b
b
b
b
b
b
b
b
b
b
b
b
a
"}
(40,1,1) = {"
a
a
a
a
a
a
a
a
a
a
a
a
a
a
a
a
a
a
a
a
a
a
a
a
a
a
a
a
a
a
a
a
a
a
a
a
a
a
a
a
"}
