"a" = (/turf/template_noop,/area/template_noop)
"b" = (/turf/template_noop,/area/submap/CaveS)
"c" = (/obj/item/ammo_casing/a45,/turf/template_noop,/area/submap/CaveS)
"d" = (/turf/simulated/mineral/ignore_mapgen,/area/submap/CaveS)
"e" = (/obj/item/ammo_casing/a45,/obj/item/weapon/reagent_containers/food/snacks/xenomeat/spidermeat,/turf/template_noop,/area/submap/CaveS)
"f" = (/obj/random/landmine,/turf/template_noop,/area/submap/CaveS)
"g" = (/obj/item/ammo_casing/a45,/obj/random/landmine,/turf/template_noop,/area/submap/CaveS)
"h" = (/obj/random/landmine,/turf/simulated/floor/outdoors/dirt{outdoors = 0},/area/submap/CaveS)
"i" = (/obj/effect/spider/stickyweb,/turf/simulated/floor/outdoors/dirt{outdoors = 0},/area/submap/CaveS)
"j" = (/obj/item/ammo_casing/a45,/obj/item/ammo_casing/a45,/turf/template_noop,/area/submap/CaveS)
"k" = (/turf/simulated/floor/outdoors/dirt{outdoors = 0},/area/submap/CaveS)
"l" = (/obj/item/weapon/reagent_containers/food/snacks/xenomeat/spidermeat,/turf/template_noop,/area/submap/CaveS)
"m" = (/obj/effect/spider/stickyweb,/turf/simulated/floor/outdoors/dirt,/area/submap/CaveS)
"n" = (/obj/item/clothing/accessory/storage/webbing,/obj/item/weapon/material/knife/tacknife/combatknife,/turf/simulated/floor/outdoors/dirt{outdoors = 0},/area/submap/CaveS)
"o" = (/mob/living/simple_animal/hostile/giant_spider,/turf/simulated/floor/outdoors/dirt{outdoors = 0},/area/submap/CaveS)
"p" = (/obj/effect/decal/cleanable/cobweb,/turf/simulated/floor/outdoors/dirt{outdoors = 0},/area/submap/CaveS)
"q" = (/mob/living/simple_animal/hostile/giant_spider/lurker,/turf/simulated/floor/outdoors/dirt{outdoors = 0},/area/submap/CaveS)
"r" = (/obj/effect/decal/cleanable/cobweb2,/turf/simulated/floor/outdoors/dirt{outdoors = 0},/area/submap/CaveS)
"s" = (/mob/living/simple_animal/hostile/giant_spider/webslinger,/turf/simulated/floor/outdoors/dirt{outdoors = 0},/area/submap/CaveS)
"t" = (/obj/effect/decal/cleanable/cobweb2,/mob/living/simple_animal/hostile/giant_spider/lurker,/turf/simulated/floor/outdoors/dirt{outdoors = 0},/area/submap/CaveS)
"u" = (/turf/simulated/floor/outdoors/grass/sif/forest,/area/submap/CaveS)
"v" = (/mob/living/simple_animal/hostile/giant_spider/lurker,/turf/simulated/floor/outdoors/dirt,/area/submap/CaveS)
"w" = (/mob/living/simple_animal/hostile/giant_spider/hunter,/turf/simulated/floor/outdoors/dirt{outdoors = 0},/area/submap/CaveS)
"x" = (/obj/structure/flora/tree/sif,/turf/simulated/floor/outdoors/grass/sif/forest,/area/submap/CaveS)
"y" = (/obj/random/landmine,/turf/simulated/floor/outdoors/grass/sif/forest,/area/submap/CaveS)
"z" = (/turf/simulated/floor,/area/submap/CaveS)
"A" = (/obj/structure/closet/crate,/obj/item/stack/cable_coil,/obj/item/stack/cable_coil,/obj/item/weapon/storage/toolbox,/obj/random/toolbox,/turf/simulated/floor,/area/submap/CaveS)
"B" = (/obj/structure/loot_pile/maint/technical,/turf/simulated/floor,/area/submap/CaveS)
"C" = (/obj/structure/table/woodentable,/turf/simulated/floor,/area/submap/CaveS)
"D" = (/obj/random/landmine,/turf/simulated/floor,/area/submap/CaveS)
"E" = (/obj/machinery/power/port_gen/pacman,/obj/structure/cable{icon_state = "0-2"; d2 = 2},/turf/simulated/floor,/area/submap/CaveS)
"F" = (/turf/simulated/wall,/area/submap/CaveS)
"G" = (/obj/structure/closet/crate,/obj/item/weapon/reagent_containers/hypospray,/obj/item/weapon/reagent_containers/glass/bottle/stoxin,/obj/item/weapon/reagent_containers/glass/bottle/antitoxin,/obj/item/weapon/reagent_containers/pill/antitox,/obj/item/weapon/reagent_containers/pill/antitox,/obj/item/weapon/reagent_containers/pill/antitox,/obj/item/weapon/reagent_containers/pill/paracetamol,/obj/random/firstaid,/obj/random/landmine,/turf/simulated/floor,/area/submap/CaveS)
"H" = (/obj/structure/cable{d1 = 1; d2 = 2; icon_state = "1-2"; pixel_y = 0},/turf/simulated/floor,/area/submap/CaveS)
"I" = (/obj/structure/closet/crate,/obj/random/contraband,/obj/random/contraband,/obj/random/contraband,/obj/random/energy,/obj/item/weapon/material/star,/obj/item/weapon/material/star,/obj/item/weapon/material/star,/obj/item/weapon/material/star,/obj/item/weapon/material/star,/turf/simulated/floor,/area/submap/CaveS)
"J" = (/obj/effect/spider/stickyweb,/mob/living/simple_animal/hostile/giant_spider/lurker,/turf/simulated/floor/outdoors/dirt{outdoors = 0},/area/submap/CaveS)
"K" = (/obj/structure/cable{d1 = 1; d2 = 4; icon_state = "1-4"},/turf/simulated/floor,/area/submap/CaveS)
"L" = (/obj/structure/cable{d1 = 4; d2 = 8; icon_state = "4-8"; pixel_x = 0},/turf/simulated/floor,/area/submap/CaveS)
"M" = (/obj/machinery/computer/communications,/obj/structure/cable{d2 = 8; icon_state = "0-8"},/turf/simulated/floor,/area/submap/CaveS)
"N" = (/obj/structure/loot_pile/maint/boxfort,/turf/simulated/floor,/area/submap/CaveS)

(1,1,1) = {"
aaaaaaaaaaaaaaaaaaaaaaaaaaaaaaaaaaaaaaaa
abbbbbbbbbbbbbbbbbbbbbbbbbbbbbbbbbbbbbba
abbbbbbbbbbbbbbbbbbbbbbbbbbbbbbbbbbbbbba
abbbbbbbbbbbbbbbbbbbbbbbbbbbbbbbbbbbbbba
abbbbbbbbbbbbbbbbbbbbbcbbbbbbbbbbbbbbbba
abbbbbbbbbbbbbbbbbbbbbbbbbbbbbbbbbbbbbba
abbbbbbbbbbbbbbbcbbbbbbcccdddddbbbbbbbba
abbbbbbbbbbbbbbbbbbbbbbbeddddddddbbddbba
abbbbbbbbbbbbbbbbbbbbbfbdddddddddddddbba
abbbbdddddbbbbcbbbbgbbbhiddddddddddddbba
abbbbddddddddbbbbbjbbfbkkddddddddddddbba
abbbddddddddddbbbbcblbdmkiidddddddddbbba
abbbdddddddddddbbbbbbdddmkkkdddddddbbbba
abbbddddddddddddbbbbddddddhkmddddddbbbba
abbdddddndkkidddbbddddddddkkkkkkddddbbba
abbdddokkkkkkdddbbdddddddpkkkkkkodddbbba
abbdddikkkkkqddbbddddddddkkkkkkkdddddbba
abbddddkkkkkdddbdddddddddkkddddkrddddbba
abdddddddkkkkddddddddddddhkddddkkdddddba
abdddddddkkkkrdddddpkokkkkddddpkddddddba
abddddddddkkkkkkkkkkkkkkkkddddhkddddddda
abdddddddddskkkkkkkkkkkkkkktddkkddddddda
abddddduudddddkkdddvdddddikkkkkkddddddba
abddduuuudddddkkddddddddddkkkkwddddddbba
abdduxuuudddddkkqdddddddddddddddddddbbba
abdduuyuuudddddkkkkkddddddddqkddddddbbba
abddduuuxuiddddkkkkkkkhidddkkkkkdddbbbba
abddduuuyukkkkkkkdkkkkkiddkkzzAkkkddbbba
abdduuuuuuukkkkidddikkkhkkkkzzzBkdddbbba
abdduuuuuukkddddddddkhkkkkkzCCDzkkddbbba
abddduuuuukkvddddddkkkidkkzEFFGkkkdddbba
abdddddxukkddddddikkkkddkkzHFFIkkddddbba
abddddddduiddddddJkkkkddkkzKLMDzddddbbba
abbddddddddddddddkkkkkdddkkkzzzdddddbbba
abbdddddddddddddddkidddddkkkzNdddddbbbba
abbdddddddddddddddddddddddqkkddddbbbbbba
abbbdddddddddddddddddddddddddddbbbbbbbba
abbbddddbbbbdddddddbbdddddddddbbbbbbbbba
abbbddbbbbbbbddddbbbbdbbdddddbbbbbbbbbba
aaaaaaaaaaaaaaaaaaaaaaaaaaaaaaaaaaaaaaaa
"}
