//MAP CONVERTED BY dmm2tgm.py THIS HEADER COMMENT PREVENTS RECONVERSION, DO NOT REMOVE
"a" = (
/turf/template_noop,
/area/template_noop)
"b" = (
/turf/simulated/floor/outdoors/dirt/sif,
/area/submap/ChemSpill2)
"c" = (
/turf/simulated/floor/snow,
/area/submap/ChemSpill2)
"d" = (
/turf/simulated/floor/outdoors/mud,
/area/submap/ChemSpill2)
"e" = (
/turf/simulated/floor/outdoors/ice,
/area/submap/ChemSpill2)
"f" = (
/turf/simulated/floor/water/contaminated,
/area/submap/ChemSpill2)
"g" = (
/turf/template_noop,
/area/submap/ChemSpill2)
"h" = (
/turf/simulated/floor/outdoors/rocks,
/area/submap/ChemSpill1)
"i" = (
/obj/structure/prop/poicanister,
/turf/simulated/floor/water/contaminated,
/area/submap/ChemSpill2)
"j" = (
/turf/simulated/floor/outdoors/rocks,
/area/submap/ChemSpill2)
"k" = (
/obj/random/trash,
/turf/simulated/floor/outdoors/rocks,
/area/submap/ChemSpill2)
"l" = (
/obj/effect/decal/remains/deer,
/turf/simulated/floor/outdoors/dirt/sif,
/area/submap/ChemSpill2)
"m" = (
/obj/structure/prop/poicanister,
/turf/simulated/floor/outdoors/mud,
/area/submap/ChemSpill2)
"n" = (
/obj/effect/decal/remains/ribcage,
/turf/simulated/floor/water/contaminated,
/area/submap/ChemSpill2)
"o" = (
/obj/item/stack/rods,
/turf/simulated/floor/water/contaminated,
/area/submap/ChemSpill2)
"p" = (
/obj/random/firstaid,
/turf/simulated/floor/outdoors/dirt/sif,
/area/submap/ChemSpill2)
"q" = (
/obj/random/tech_supply,
/obj/random/energy,
/turf/simulated/floor/outdoors/dirt/sif,
/area/submap/ChemSpill2)
"r" = (
/obj/random/humanoidremains,
/obj/random/rigsuit,
/turf/simulated/floor/outdoors/dirt/sif,
/area/submap/ChemSpill2)
"s" = (
/obj/effect/decal/remains/lizard,
/turf/simulated/floor/outdoors/mud,
/area/submap/ChemSpill2)
"t" = (
/obj/item/storage/mre/random,
/turf/simulated/floor/outdoors/dirt/sif,
/area/submap/ChemSpill2)
"u" = (
/obj/effect/decal/remains/mouse,
/turf/simulated/floor/outdoors/mud,
/area/submap/ChemSpill2)
"v" = (
/obj/effect/decal/cleanable/blood/oil,
/turf/simulated/floor/outdoors/rocks,
/area/submap/ChemSpill2)
"w" = (
/obj/effect/decal/remains/xeno,
/turf/simulated/floor/outdoors/mud,
/area/submap/ChemSpill2)
"x" = (
/obj/effect/decal/cleanable/blood/oil,
/turf/simulated/floor/outdoors/ice,
/area/submap/ChemSpill2)

(1,1,1) = {"
a
a
a
a
a
a
a
a
a
a
a
a
a
a
a
a
a
a
a
a
a
a
a
a
a
a
a
a
a
a
"}
(2,1,1) = {"
a
a
a
a
a
a
a
a
a
a
a
a
a
b
a
a
a
a
a
a
a
a
a
a
a
a
a
a
a
a
"}
(3,1,1) = {"
a
a
a
a
a
b
b
l
b
a
a
b
b
b
b
a
a
a
a
a
a
a
a
a
a
a
a
a
a
a
"}
(4,1,1) = {"
a
a
a
a
a
b
b
b
b
a
d
c
c
b
b
a
a
c
c
b
b
a
a
a
b
b
a
a
a
a
"}
(5,1,1) = {"
a
a
b
b
b
b
b
c
c
d
d
d
d
c
c
c
c
b
j
u
b
b
b
b
b
b
b
b
a
a
"}
(6,1,1) = {"
a
a
b
b
b
d
d
d
d
e
e
e
d
d
d
d
d
d
j
j
d
d
d
d
c
b
b
l
a
a
"}
(7,1,1) = {"
a
a
b
d
d
e
f
e
e
e
e
f
f
e
d
d
e
f
j
j
j
v
d
j
c
b
b
b
a
a
"}
(8,1,1) = {"
a
a
b
d
f
f
f
f
f
e
f
f
f
f
f
f
f
f
f
f
f
e
e
j
j
d
b
a
a
a
"}
(9,1,1) = {"
a
b
b
d
f
f
f
f
f
f
f
f
f
f
f
f
f
f
f
f
f
f
e
j
j
d
b
a
a
a
"}
(10,1,1) = {"
a
b
c
d
f
f
f
d
d
f
f
f
f
f
f
f
f
f
f
f
f
f
f
e
d
c
b
a
a
a
"}
(11,1,1) = {"
a
b
d
f
f
f
f
m
d
f
f
f
o
b
e
e
c
b
b
i
f
f
f
f
d
c
b
b
a
a
"}
(12,1,1) = {"
b
b
d
f
f
f
f
f
d
f
f
f
f
b
c
e
c
b
b
b
f
f
f
f
k
j
b
b
a
a
"}
(13,1,1) = {"
b
b
b
d
d
f
f
f
f
f
f
f
b
b
b
c
b
b
b
b
f
f
f
f
j
j
d
b
a
a
"}
(14,1,1) = {"
a
b
b
b
f
f
f
f
f
f
f
e
b
b
b
p
q
b
b
e
f
f
f
f
f
j
d
a
a
a
"}
(15,1,1) = {"
a
b
b
d
d
f
f
f
f
f
f
e
b
b
b
b
r
b
b
b
b
f
f
f
f
w
c
a
a
a
"}
(16,1,1) = {"
a
b
b
d
f
f
f
f
f
f
f
f
e
b
b
b
b
t
b
b
f
f
f
f
f
j
d
a
a
a
"}
(17,1,1) = {"
a
a
b
d
f
f
f
f
f
f
f
f
e
b
b
b
b
b
b
b
f
f
f
f
f
f
d
c
a
a
"}
(18,1,1) = {"
a
a
b
d
f
f
f
f
f
f
f
f
b
b
b
b
b
b
b
f
f
f
f
f
f
f
d
d
b
a
"}
(19,1,1) = {"
a
b
b
c
d
f
f
n
f
f
f
f
b
b
b
b
b
e
f
f
f
f
f
f
f
f
i
d
c
a
"}
(20,1,1) = {"
a
b
c
c
d
j
f
f
f
f
f
f
f
b
f
f
f
f
f
f
f
f
f
f
f
d
e
d
c
a
"}
(21,1,1) = {"
a
b
c
d
d
j
f
f
f
f
f
f
f
f
f
f
f
f
f
f
f
f
f
f
f
d
e
d
b
a
"}
(22,1,1) = {"
a
c
d
e
d
k
f
j
j
j
f
f
f
f
f
d
s
d
d
d
d
d
d
e
f
f
e
d
a
a
"}
(23,1,1) = {"
a
d
e
f
f
d
j
d
d
j
e
e
f
d
d
d
d
d
d
d
s
d
d
d
d
e
x
j
a
a
"}
(24,1,1) = {"
a
d
f
i
f
d
d
d
d
d
d
d
d
d
c
c
c
b
b
b
b
b
j
b
c
j
j
j
a
a
"}
(25,1,1) = {"
a
d
d
f
f
j
b
b
b
b
b
b
l
b
b
b
b
a
b
b
b
j
j
b
c
c
b
h
a
a
"}
(26,1,1) = {"
a
b
d
j
j
j
b
b
b
b
b
b
j
b
b
b
a
a
b
b
b
j
j
j
j
c
b
a
a
a
"}
(27,1,1) = {"
a
b
b
b
b
b
b
b
b
l
b
b
b
b
b
a
a
a
a
a
a
a
b
b
b
b
b
a
a
a
"}
(28,1,1) = {"
a
a
g
g
b
b
b
b
b
b
b
b
b
b
b
a
a
a
a
a
a
a
a
a
a
a
a
a
a
a
"}
(29,1,1) = {"
a
a
a
a
a
a
a
a
a
a
a
a
a
a
a
a
a
a
a
a
a
a
a
a
a
a
a
a
a
a
"}
(30,1,1) = {"
a
a
a
a
a
a
a
a
a
a
a
a
a
a
a
a
a
a
a
a
a
a
a
a
a
a
a
a
a
a
"}
