//MAP CONVERTED BY dmm2tgm.py THIS HEADER COMMENT PREVENTS RECONVERSION, DO NOT REMOVE
"a" = (
/turf/template_noop,
/area/template_noop)
"b" = (
/turf/template_noop,
/area/submap/Cragzone1)
"c" = (
/obj/structure/flora/tree/sif,
/turf/template_noop,
/area/submap/Cragzone1)
"d" = (
/turf/simulated/mineral/ignore_mapgen,
/area/submap/Cragzone1)
"e" = (
/turf/simulated/floor/outdoors/dirt,
/area/submap/Cragzone1)

(1,1,1) = {"
a
a
a
a
a
a
a
a
a
a
a
a
a
a
a
a
a
a
a
a
a
a
a
a
a
a
a
a
a
a
"}
(2,1,1) = {"
a
b
b
b
b
b
b
b
b
b
b
b
b
b
b
b
b
b
b
b
b
b
b
b
b
b
b
b
b
a
"}
(3,1,1) = {"
a
b
b
c
b
b
b
b
b
b
b
b
c
b
b
b
b
b
b
b
c
b
b
b
b
b
b
b
c
a
"}
(4,1,1) = {"
a
b
b
b
b
b
b
b
b
b
b
b
b
b
b
b
d
d
b
b
b
b
b
b
b
b
b
b
b
a
"}
(5,1,1) = {"
a
b
c
d
d
d
b
b
b
b
b
b
b
b
d
d
d
d
b
b
b
b
c
b
b
b
b
b
b
a
"}
(6,1,1) = {"
a
b
b
d
d
d
d
b
b
b
b
b
b
b
d
d
d
d
b
b
b
b
b
b
b
d
d
b
b
a
"}
(7,1,1) = {"
a
b
d
d
d
d
d
b
b
c
b
b
b
b
b
d
d
d
d
b
b
b
b
b
b
d
d
d
b
a
"}
(8,1,1) = {"
a
b
d
d
d
b
b
b
b
b
b
b
b
b
b
e
e
d
d
d
b
b
b
b
b
d
d
d
b
a
"}
(9,1,1) = {"
a
b
b
b
b
b
b
b
b
b
b
b
b
b
b
b
e
d
d
d
d
b
b
b
b
b
d
d
b
a
"}
(10,1,1) = {"
a
b
b
b
b
b
c
b
b
b
b
b
b
c
b
b
e
e
d
d
d
b
b
b
b
b
b
b
b
a
"}
(11,1,1) = {"
a
b
b
b
b
b
b
d
d
d
d
b
b
b
b
b
e
e
e
e
d
d
b
b
b
c
b
b
b
a
"}
(12,1,1) = {"
a
b
b
b
b
b
b
d
d
d
d
b
b
b
b
b
b
e
e
e
e
b
b
b
b
b
b
b
b
a
"}
(13,1,1) = {"
a
b
b
b
b
b
d
d
d
d
d
e
b
b
b
b
b
b
b
b
b
b
b
b
b
b
d
b
b
a
"}
(14,1,1) = {"
a
b
b
b
b
b
b
b
d
d
d
d
e
b
b
b
b
b
b
b
b
b
b
b
b
d
d
d
b
a
"}
(15,1,1) = {"
a
b
c
b
b
b
b
b
b
d
d
e
e
e
b
b
b
b
b
b
b
b
b
b
d
d
d
d
b
a
"}
(16,1,1) = {"
a
b
b
b
b
b
b
b
b
b
d
e
e
e
b
b
d
b
b
b
b
b
c
b
b
b
d
b
b
a
"}
(17,1,1) = {"
a
b
b
b
b
c
b
b
d
d
d
e
e
e
b
d
d
d
d
b
b
b
b
b
b
b
b
b
c
a
"}
(18,1,1) = {"
a
b
b
b
b
b
b
d
d
d
d
d
e
e
b
b
d
d
b
b
b
b
b
b
b
b
b
b
b
a
"}
(19,1,1) = {"
a
b
b
b
b
b
d
d
d
d
d
d
e
b
b
b
b
b
b
b
b
b
b
b
b
d
b
b
b
a
"}
(20,1,1) = {"
a
b
b
b
b
b
b
b
d
d
d
e
b
b
b
b
b
b
b
b
b
b
b
d
d
d
d
b
b
a
"}
(21,1,1) = {"
a
b
b
b
d
d
b
b
b
b
d
b
b
b
b
b
b
b
b
b
b
b
b
d
d
d
d
b
b
a
"}
(22,1,1) = {"
a
b
b
b
d
d
d
b
b
b
b
b
b
b
b
c
b
d
d
b
b
b
b
b
d
d
d
b
b
a
"}
(23,1,1) = {"
a
b
b
d
d
d
d
b
c
b
b
b
b
b
b
b
d
d
d
d
b
b
b
b
b
b
b
b
b
a
"}
(24,1,1) = {"
a
b
b
d
d
d
d
b
b
b
b
b
b
b
b
b
d
d
d
d
d
b
c
b
b
b
b
b
c
a
"}
(25,1,1) = {"
a
b
b
d
d
d
b
b
b
b
b
b
d
d
b
b
b
d
d
d
d
b
b
b
b
d
d
b
b
a
"}
(26,1,1) = {"
a
b
b
b
b
b
b
b
b
c
b
b
d
d
d
b
b
b
b
b
b
b
b
b
d
d
d
d
b
a
"}
(27,1,1) = {"
a
b
b
b
b
b
b
b
b
b
b
b
d
d
d
b
b
b
b
b
b
b
b
b
d
d
d
d
b
a
"}
(28,1,1) = {"
a
b
b
b
b
c
b
b
b
b
c
b
b
d
d
b
b
b
b
b
c
b
b
b
b
b
d
b
b
a
"}
(29,1,1) = {"
a
b
b
b
b
b
b
b
b
b
b
b
b
b
b
b
b
b
b
b
b
b
b
b
b
b
b
b
b
a
"}
(30,1,1) = {"
a
a
a
a
a
a
a
a
a
a
a
a
a
a
a
a
a
a
a
a
a
a
a
a
a
a
a
a
a
a
"}
