"aa" = (/turf/template_noop,/area/template_noop)
"ab" = (/obj/random/landmine,/turf/template_noop,/area/template_noop)
"ac" = (/obj/machinery/porta_turret/poi{faction = "malf_drone"},/obj/effect/overlay/snow/floor,/turf/simulated/floor{outdoors = 1},/area/submap/DJOutpost1)
"ad" = (/obj/structure/grille,/obj/structure/window/reinforced/full,/turf/simulated/floor,/area/submap/DJOutpost1)
"ae" = (/obj/random/humanoidremains{spawn_nothing_percentage = 60},/turf/template_noop,/area/template_noop)
"af" = (/turf/simulated/floor/tiled/techfloor,/area/submap/DJOutpost1)
"ag" = (/obj/random/landmine,/obj/effect/overlay/snow/floor,/turf/simulated/floor{outdoors = 1},/area/submap/DJOutpost1)
"ah" = (/obj/machinery/telecomms/relay/preset/ruskie,/turf/simulated/floor/tiled/techfloor,/area/submap/DJOutpost1)
"ai" = (/obj/structure/loot_pile/maint/technical,/turf/simulated/floor/tiled/techfloor,/area/submap/DJOutpost1)
"aj" = (/obj/structure/bookcase,/turf/simulated/floor/tiled/techfloor,/area/submap/DJOutpost1)
"ak" = (/turf/simulated/wall/rpshull,/area/submap/DJOutpost1)
"al" = (/obj/structure/sign/goldenplaque{desc = "An award given to Sif Free Radio for media excellency. It looks fake."; name = "Best Radio Station 2558"; pixel_y = 30},/turf/simulated/floor/tiled/techfloor,/area/submap/DJOutpost1)
"am" = (/obj/structure/sign/warning/lethal_turrets,/turf/simulated/wall/rpshull,/area/submap/DJOutpost1)
"an" = (/obj/structure/grille,/obj/structure/window/reinforced/full,/obj/structure/cable{d1 = 4; d2 = 8; icon_state = "4-8"; pixel_x = 0},/turf/simulated/floor,/area/submap/DJOutpost1)
"ao" = (/obj/effect/overlay/snow/floor,/obj/structure/cable/yellow{d1 = 2; d2 = 8; icon_state = "2-8"},/turf/simulated/floor{outdoors = 1},/area/submap/DJOutpost1)
"ap" = (/obj/random/mob/robotic,/turf/simulated/floor/tiled/techfloor,/area/submap/DJOutpost1)
"aq" = (/obj/effect/decal/remains,/obj/effect/decal/cleanable/blood,/obj/item/clothing/under/frontier,/obj/random_multi/single_item/sfr_headset,/obj/item/weapon/archaeological_find,/turf/simulated/floor/tiled/techfloor,/area/submap/DJOutpost1)
"ar" = (/obj/structure/table/steel_reinforced,/obj/item/device/radio/intercom{icon_state = "intercom"; dir = 8},/obj/random/firstaid,/turf/simulated/floor/tiled/techfloor,/area/submap/DJOutpost1)
"as" = (/obj/machinery/computer/message_monitor,/obj/item/weapon/paper/monitorkey,/obj/structure/cable/yellow{d1 = 2; d2 = 4; icon_state = "2-4"},/turf/simulated/floor/tiled/techfloor,/area/submap/DJOutpost1)
"at" = (/obj/structure/table/steel_reinforced,/obj/item/device/radio/intercom{icon_state = "intercom"; dir = 8},/obj/item/weapon/book/codex/lore/news,/turf/simulated/floor/tiled/techfloor,/area/submap/DJOutpost1)
"au" = (/obj/machinery/light{dir = 4; icon_state = "tube1"; pixel_x = 0},/obj/structure/cable/yellow{d1 = 1; d2 = 2; icon_state = "1-2"},/obj/structure/cable/yellow,/obj/machinery/power/solar_control/autostart,/turf/simulated/floor/tiled/techfloor,/area/submap/DJOutpost1)
"av" = (/obj/effect/overlay/snow/floor,/obj/structure/cable/yellow{d1 = 1; d2 = 2; icon_state = "1-2"},/obj/random/landmine,/turf/simulated/floor{outdoors = 1},/area/submap/DJOutpost1)
"aw" = (/obj/structure/bookcase,/obj/item/weapon/book/codex/lore/robutt,/turf/simulated/floor/tiled/techfloor,/area/submap/DJOutpost1)
"ax" = (/obj/structure/bookcase,/obj/item/weapon/book/codex/lore/vir,/obj/item/weapon/book/manual/excavation,/obj/item/weapon/book/manual/engineering_construction,/turf/simulated/floor/tiled/techfloor,/area/submap/DJOutpost1)
"ay" = (/obj/machinery/holoplant,/turf/simulated/floor/tiled/techfloor,/area/submap/DJOutpost1)
"az" = (/obj/item/weapon/storage/toolbox/mechanical,/turf/simulated/floor/tiled/techfloor,/area/submap/DJOutpost1)
"aA" = (/obj/structure/table/steel_reinforced,/obj/item/device/radio/phone,/obj/random_multi/single_item/sfr_headset,/turf/simulated/floor/tiled/techfloor,/area/submap/DJOutpost1)
"aB" = (/obj/structure/table/steel_reinforced,/obj/item/device/radio/intercom/syndicate{desc = "Talk through this."; name = "station intercom (General)"},/obj/item/device/multitool,/turf/simulated/floor/tiled/techfloor,/area/submap/DJOutpost1)
"aC" = (/obj/structure/table/steel_reinforced,/obj/item/device/radio,/obj/machinery/power/apc{cell_type = /obj/item/weapon/cell/hyper; dir = 4; environ = 1; equipment = 1; lighting = 1; locked = 0; name = "Sif Free Radio APC"; operating = 0; pixel_x = 24},/obj/structure/cable/yellow,/turf/simulated/floor/tiled/techfloor,/area/submap/DJOutpost1)
"aD" = (/obj/structure/sign/warning/server_room,/turf/simulated/wall/rpshull,/area/submap/DJOutpost1)
"aE" = (/obj/effect/overlay/snow/floor,/obj/structure/cable/yellow,/obj/machinery/power/solar,/turf/simulated/floor{outdoors = 1},/area/submap/DJOutpost1)
"aF" = (/obj/structure/bookcase,/obj/structure/safe/floor,/obj/item/weapon/gun/energy/ionrifle/pistol,/obj/item/weapon/bone/skull/unknown,/obj/item/weapon/bone,/obj/item/weapon/bone/ribs,/turf/simulated/floor/tiled/techfloor,/area/submap/DJOutpost1)
"aG" = (/obj/machinery/biogenerator,/turf/simulated/floor/tiled/techfloor,/area/submap/DJOutpost1)
"aH" = (/obj/item/weapon/reagent_containers/food/snacks/unajerky,/obj/machinery/light{icon_state = "tube1"; dir = 8},/obj/random_multi/single_item/sfr_headset,/obj/structure/table/steel_reinforced,/turf/simulated/floor/tiled/techfloor,/area/submap/DJOutpost1)
"aI" = (/obj/machinery/light{dir = 4; icon_state = "tube1"; pixel_x = 0},/obj/machinery/seed_extractor,/turf/simulated/floor/tiled/techfloor,/area/submap/DJOutpost1)
"aJ" = (/obj/machinery/door/airlock/maintenance/int,/turf/simulated/floor/tiled/techfloor/grid,/area/submap/DJOutpost1)
"aK" = (/obj/machinery/portable_atmospherics/hydroponics,/turf/simulated/floor/tiled/techfloor,/area/submap/DJOutpost1)
"aL" = (/obj/structure/table/woodentable,/obj/item/weapon/material/knife/machete/hatchet,/obj/item/weapon/reagent_containers/glass/bucket,/obj/item/weapon/material/minihoe,/obj/item/device/analyzer/plant_analyzer,/obj/random_multi/single_item/sfr_headset,/turf/simulated/floor/tiled/techfloor,/area/submap/DJOutpost1)
"aM" = (/obj/structure/undies_wardrobe,/turf/simulated/floor/tiled/techfloor,/area/submap/DJOutpost1)
"aN" = (/obj/structure/table/rack,/obj/item/clothing/shoes/boots/winter,/obj/item/clothing/suit/storage/hooded/wintercoat,/obj/random_multi/single_item/sfr_headset,/turf/simulated/floor/tiled/techfloor,/area/submap/DJOutpost1)
"aO" = (/obj/structure/sink{dir = 4; icon_state = "sink"; pixel_x = 15},/turf/simulated/floor/tiled/techfloor,/area/submap/DJOutpost1)
"aP" = (/obj/structure/bed/padded,/obj/item/weapon/bedsheet/clown,/turf/simulated/floor/tiled/techfloor,/area/submap/DJOutpost1)
"aQ" = (/obj/structure/table/rack,/obj/item/weapon/gun/energy/lasershotgun,/turf/simulated/floor/tiled/techfloor,/area/submap/DJOutpost1)
"aR" = (/obj/structure/grille/broken,/obj/item/weapon/material/shard,/obj/item/weapon/material/shard{icon_state = "shardmedium"},/obj/item/stack/rods,/obj/effect/overlay/snow/floor,/turf/simulated/floor,/area/submap/DJOutpost1)
"aS" = (/obj/effect/overlay/snow/floor,/turf/simulated/floor{outdoors = 1},/area/submap/DJOutpost1)
"aT" = (/obj/effect/overlay/snow/floor,/turf/simulated/floor/tiled/techfloor,/area/submap/DJOutpost1)
"aU" = (/obj/machinery/media/jukebox,/obj/effect/overlay/snow/floor,/turf/simulated/floor/tiled/techfloor,/area/submap/DJOutpost1)
"aV" = (/obj/item/clothing/under/pcrc,/obj/random/humanoidremains{spawn_nothing_percentage = 60},/turf/simulated/floor/tiled/techfloor,/area/submap/DJOutpost1)
"aW" = (/obj/item/device/gps/internal/poi,/obj/machinery/door/airlock/maintenance/int,/turf/simulated/floor/tiled/techfloor/grid,/area/submap/DJOutpost1)
"aX" = (/obj/structure/table/bench/padded,/obj/random/humanoidremains{spawn_nothing_percentage = 60},/turf/simulated/floor/tiled/techfloor,/area/submap/DJOutpost1)
"aY" = (/obj/machinery/door/airlock/maintenance/common,/turf/simulated/floor/tiled/techfloor/grid,/area/submap/DJOutpost1)
"aZ" = (/obj/structure/sign/warning/emergence,/turf/simulated/wall/rpshull,/area/submap/DJOutpost1)
"ba" = (/obj/random/humanoidremains{spawn_nothing_percentage = 60},/turf/simulated/floor/tiled/techfloor,/area/submap/DJOutpost1)

(1,1,1) = {"
aeaaaaaaaaaaabaaaaaaaaaaaaaaaaab
aaacagakaRakakakakakadakaSacaaaa
abaSamakaTaUakahaiahaiakamaSaaaa
aaakakajafaTaDafafafafalakakaaab
aaadaFapaqafaJafafaparafasanaoaa
aaakafafafafakafafafataVauakavaa
aaakawajajaxakafayazaAaBaCakaEaa
aaakakakakakakaWaDakakakakakaaaa
aaakaXafafafayafayafafafaGakaaaa
aaakaHafafafafafafafafafaIakabaa
abadaXapafakakaYakaKafapaLadaaaa
aaakakaMafakaNafaZaKafaOakakaaaa
aaaSamakaPakaQbaakaKafakamaSaaaa
aaacaSakadakakaYakakadakaSacaaaa
aaabaaaaaaaaaaaaabaaaaaaaaaaaaab
"}
