"a" = (/turf/template_noop,/area/template_noop)
"b" = (/turf/template_noop,/area/submap/Drugd)
"c" = (/turf/simulated/mineral/ignore_mapgen,/area/submap/Drugd)
"d" = (/turf/simulated/wall,/area/submap/Drugd)
"e" = (/obj/machinery/door/airlock,/turf/simulated/floor,/area/submap/Drugd)
"f" = (/turf/simulated/floor/tiled,/area/submap/Drugd)
"g" = (/obj/effect/floor_decal/rust,/turf/simulated/floor/tiled,/area/submap/Drugd)
"h" = (/obj/random/trash,/turf/simulated/floor,/area/submap/Drugd)
"i" = (/obj/structure/closet/cabinet,/obj/item/lipstick/random,/turf/simulated/floor/carpet,/area/submap/Drugd)
"j" = (/obj/structure/bed,/obj/item/bedsheet,/obj/structure/curtain/open/bed,/turf/simulated/floor/carpet,/area/submap/Drugd)
"k" = (/obj/structure/table/woodentable,/obj/item/reagent_containers/pill/happy{name = "pill"},/turf/simulated/floor/carpet,/area/submap/Drugd)
"l" = (/turf/simulated/floor,/area/submap/Drugd)
"m" = (/obj/structure/curtain/black,/turf/simulated/floor,/area/submap/Drugd)
"n" = (/obj/random/trash,/turf/simulated/floor/carpet,/area/submap/Drugd)
"o" = (/turf/simulated/floor/carpet,/area/submap/Drugd)
"p" = (/obj/effect/decal/remains/mouse,/turf/simulated/floor,/area/submap/Drugd)
"q" = (/obj/structure/closet/cabinet,/turf/simulated/floor/carpet,/area/submap/Drugd)
"r" = (/obj/structure/table/woodentable,/obj/item/reagent_containers/pill/methylphenidate{name = "pill"},/turf/simulated/floor/carpet,/area/submap/Drugd)
"s" = (/obj/structure/bed/chair/comfy/beige{icon_state = "armchair_preview"; dir = 1},/turf/simulated/floor/carpet,/area/submap/Drugd)
"t" = (/obj/item/reagent_containers/pill/citalopram{name = "pill"},/turf/simulated/floor/carpet,/area/submap/Drugd)
"u" = (/obj/random/junk,/turf/simulated/floor,/area/submap/Drugd)
"v" = (/obj/structure/closet/cabinet,/obj/item/poster,/turf/simulated/floor/carpet,/area/submap/Drugd)
"w" = (/obj/structure/bed/chair/comfy/beige,/turf/simulated/floor/carpet,/area/submap/Drugd)
"x" = (/obj/structure/table/woodentable,/obj/item/flashlight/lamp,/obj/item/reagent_containers/syringe/drugs,/turf/simulated/floor/carpet,/area/submap/Drugd)
"y" = (/obj/structure/bed/chair/comfy/beige,/obj/item/reagent_containers/pill/citalopram{name = "pill"},/turf/simulated/floor/carpet,/area/submap/Drugd)
"z" = (/obj/structure/loot_pile/maint/junk,/turf/simulated/floor,/area/submap/Drugd)
"A" = (/obj/item/reagent_containers/pill/citalopram{name = "pill"},/obj/item/reagent_containers/pill/citalopram{name = "pill"},/turf/simulated/floor/carpet,/area/submap/Drugd)
"B" = (/obj/structure/table/standard,/obj/item/storage/pill_bottle/happy,/turf/simulated/floor/tiled,/area/submap/Drugd)
"C" = (/obj/structure/table/standard,/obj/item/stack/medical/splint,/turf/simulated/floor/tiled,/area/submap/Drugd)
"D" = (/obj/structure/table/standard,/obj/item/reagent_containers/pill/citalopram,/obj/item/reagent_containers/pill/citalopram,/turf/simulated/floor/tiled,/area/submap/Drugd)
"E" = (/obj/structure/table/standard,/obj/item/reagent_containers/pill/tramadol,/obj/item/reagent_containers/pill/tramadol,/turf/simulated/floor/tiled,/area/submap/Drugd)
"F" = (/obj/structure/closet/cabinet,/obj/item/clothing/accessory/jacket,/obj/item/material/butterfly/switchblade,/turf/simulated/floor/carpet,/area/submap/Drugd)
"G" = (/obj/item/reagent_containers/pill/zoom{name = "pill"},/obj/random/trash,/turf/simulated/floor/carpet,/area/submap/Drugd)
"H" = (/obj/item/reagent_containers/pill/zoom{name = "pill"},/turf/simulated/floor/carpet,/area/submap/Drugd)
"I" = (/obj/structure/loot_pile/maint/boxfort,/turf/simulated/floor/carpet,/area/submap/Drugd)
"J" = (/obj/structure/table/standard,/obj/item/surgical/scalpel,/turf/simulated/floor/tiled,/area/submap/Drugd)
"K" = (/obj/item/wheelchair,/turf/simulated/floor/tiled,/area/submap/Drugd)
"L" = (/obj/structure/table/standard,/obj/random/firstaid,/turf/simulated/floor,/area/submap/Drugd)
"M" = (/obj/structure/loot_pile/maint/junk,/turf/simulated/floor/tiled,/area/submap/Drugd)
"N" = (/obj/effect/floor_decal/rust,/obj/structure/table/standard,/turf/simulated/floor/tiled,/area/submap/Drugd)
"O" = (/obj/structure/table/standard,/obj/item/reagent_containers/pill/zoom,/obj/item/reagent_containers/pill/zoom,/turf/simulated/floor,/area/submap/Drugd)
"P" = (/obj/structure/table/woodentable,/obj/item/reagent_containers/pill/tramadol{name = "pill"},/turf/simulated/floor/carpet,/area/submap/Drugd)
"Q" = (/mob/living/simple_mob/mechanical/hivebot/ranged_damage/strong/guard,/turf/simulated/floor,/area/submap/Drugd)
"R" = (/obj/structure/girder,/turf/simulated/floor,/area/submap/Drugd)
"S" = (/obj/item/material/shard,/turf/simulated/floor,/area/submap/Drugd)
"T" = (/obj/structure/table/woodentable,/obj/item/flashlight/lamp,/turf/simulated/floor/carpet,/area/submap/Drugd)
"U" = (/obj/structure/table/woodentable,/obj/item/reagent_containers/syringe/drugs,/turf/simulated/floor/carpet,/area/submap/Drugd)
"V" = (/obj/structure/closet/cabinet,/obj/random/projectile/scrapped_gun,/obj/random/toy,/turf/simulated/floor/carpet,/area/submap/Drugd)
"W" = (/obj/structure/closet/cabinet,/obj/random/mre,/obj/random/medical/lite,/turf/simulated/floor/carpet,/area/submap/Drugd)

(1,1,1) = {"
aaaaaaaaaaaaaaaaaaaaaaaaa
abbbbbbbbbbbbbbbbbbbbbbba
abbbbbbbbbbbbbbbbbbbbbbba
abbbbbbbbbbbbbbbbbbbbbbba
abbcccccbbbbbbbbbbbbbbbba
abbccccccbbbbbbbbccccbbba
abcccccccccbbbbbccccccbba
abcccccccccddeddcccccccba
abcccccccccdfffddddddccba
abcccccccccdgghdijkjdccca
abcccccccccdgllmnooodccca
abcccccccccdplldqrstdccca
abcccccccccdulhddddddccca
abcccccccccdllldvwxydccba
acccccddddddzlgmoooAdccba
acccccdBCDEdllfdFGHIdccba
acccccdJKgLdlfMddddddccba
abccccdNllOdhlgdVPwwdccca
abbcccdlQllelllmoooodccca
abbcccdRlSldllhdWTUndccca
abbcccddddddludddddddccca
abbccccccccccccccccccccba
abbbcccccccccccccccccccba
abbbbcccccbbbbbccccbccbba
aaaaaaaaaaaaaaaaaaaaaaaaa
"}