//MAP CONVERTED BY dmm2tgm.py THIS HEADER COMMENT PREVENTS RECONVERSION, DO NOT REMOVE
"a" = (
/turf/template_noop,
/area/template_noop)
"b" = (
/turf/template_noop,
/area/submap/Drugd)
"c" = (
/turf/simulated/mineral/ignore_mapgen,
/area/submap/Drugd)
"d" = (
/turf/simulated/wall,
/area/submap/Drugd)
"e" = (
/obj/machinery/door/airlock,
/turf/simulated/floor,
/area/submap/Drugd)
"f" = (
/turf/simulated/floor/tiled,
/area/submap/Drugd)
"g" = (
/obj/effect/floor_decal/rust,
/turf/simulated/floor/tiled,
/area/submap/Drugd)
"h" = (
/obj/random/trash,
/turf/simulated/floor,
/area/submap/Drugd)
"i" = (
/obj/structure/closet/cabinet,
/obj/item/lipstick/random,
/turf/simulated/floor/carpet,
/area/submap/Drugd)
"j" = (
/obj/structure/bed,
/obj/item/bedsheet,
/obj/structure/curtain/open/bed,
/turf/simulated/floor/carpet,
/area/submap/Drugd)
"k" = (
/obj/structure/table/woodentable,
/obj/item/reagent_containers/pill/happy{
	name = "pill"
	},
/turf/simulated/floor/carpet,
/area/submap/Drugd)
"l" = (
/turf/simulated/floor,
/area/submap/Drugd)
"m" = (
/obj/structure/curtain/black,
/turf/simulated/floor,
/area/submap/Drugd)
"n" = (
/obj/random/trash,
/turf/simulated/floor/carpet,
/area/submap/Drugd)
"o" = (
/turf/simulated/floor/carpet,
/area/submap/Drugd)
"p" = (
/obj/effect/decal/remains/mouse,
/turf/simulated/floor,
/area/submap/Drugd)
"q" = (
/obj/structure/closet/cabinet,
/turf/simulated/floor/carpet,
/area/submap/Drugd)
"r" = (
/obj/structure/table/woodentable,
/obj/item/reagent_containers/pill/methylphenidate{
	name = "pill"
	},
/turf/simulated/floor/carpet,
/area/submap/Drugd)
"s" = (
/obj/structure/bed/chair/comfy/beige{
	icon_state = "armchair_preview";
	dir = 1
	},
/turf/simulated/floor/carpet,
/area/submap/Drugd)
"t" = (
/obj/item/reagent_containers/pill/citalopram{
	name = "pill"
	},
/turf/simulated/floor/carpet,
/area/submap/Drugd)
"u" = (
/obj/random/junk,
/turf/simulated/floor,
/area/submap/Drugd)
"v" = (
/obj/structure/closet/cabinet,
/obj/item/poster,
/turf/simulated/floor/carpet,
/area/submap/Drugd)
"w" = (
/obj/structure/bed/chair/comfy/beige,
/turf/simulated/floor/carpet,
/area/submap/Drugd)
"x" = (
/obj/structure/table/woodentable,
/obj/item/flashlight/lamp,
/obj/item/reagent_containers/syringe/drugs,
/turf/simulated/floor/carpet,
/area/submap/Drugd)
"y" = (
/obj/structure/bed/chair/comfy/beige,
/obj/item/reagent_containers/pill/citalopram{
	name = "pill"
	},
/turf/simulated/floor/carpet,
/area/submap/Drugd)
"z" = (
/obj/structure/loot_pile/maint/junk,
/turf/simulated/floor,
/area/submap/Drugd)
"A" = (
/obj/item/reagent_containers/pill/citalopram{
	name = "pill"
	},
/obj/item/reagent_containers/pill/citalopram{
	name = "pill"
	},
/turf/simulated/floor/carpet,
/area/submap/Drugd)
"B" = (
/obj/structure/table/standard,
/obj/item/storage/pill_bottle/happy,
/turf/simulated/floor/tiled,
/area/submap/Drugd)
"C" = (
/obj/structure/table/standard,
/obj/item/stack/medical/splint,
/turf/simulated/floor/tiled,
/area/submap/Drugd)
"D" = (
/obj/structure/table/standard,
/obj/item/reagent_containers/pill/citalopram,
/obj/item/reagent_containers/pill/citalopram,
/turf/simulated/floor/tiled,
/area/submap/Drugd)
"E" = (
/obj/structure/table/standard,
/obj/item/reagent_containers/pill/tramadol,
/obj/item/reagent_containers/pill/tramadol,
/turf/simulated/floor/tiled,
/area/submap/Drugd)
"F" = (
/obj/structure/closet/cabinet,
/obj/item/clothing/accessory/jacket,
/obj/item/material/butterfly/switchblade,
/turf/simulated/floor/carpet,
/area/submap/Drugd)
"G" = (
/obj/item/reagent_containers/pill/zoom{
	name = "pill"
	},
/obj/random/trash,
/turf/simulated/floor/carpet,
/area/submap/Drugd)
"H" = (
/obj/item/reagent_containers/pill/zoom{
	name = "pill"
	},
/turf/simulated/floor/carpet,
/area/submap/Drugd)
"I" = (
/obj/structure/loot_pile/maint/boxfort,
/turf/simulated/floor/carpet,
/area/submap/Drugd)
"J" = (
/obj/structure/table/standard,
/obj/item/surgical/scalpel,
/turf/simulated/floor/tiled,
/area/submap/Drugd)
"K" = (
/obj/item/wheelchair,
/turf/simulated/floor/tiled,
/area/submap/Drugd)
"L" = (
/obj/structure/table/standard,
/obj/random/firstaid,
/turf/simulated/floor,
/area/submap/Drugd)
"M" = (
/obj/structure/loot_pile/maint/junk,
/turf/simulated/floor/tiled,
/area/submap/Drugd)
"N" = (
/obj/effect/floor_decal/rust,
/obj/structure/table/standard,
/turf/simulated/floor/tiled,
/area/submap/Drugd)
"O" = (
/obj/structure/table/standard,
/obj/item/reagent_containers/pill/zoom,
/obj/item/reagent_containers/pill/zoom,
/turf/simulated/floor,
/area/submap/Drugd)
"P" = (
/obj/structure/table/woodentable,
/obj/item/reagent_containers/pill/tramadol{
	name = "pill"
	},
/turf/simulated/floor/carpet,
/area/submap/Drugd)
"Q" = (
/mob/living/simple_mob/mechanical/hivebot/ranged_damage/strong/guard,
/turf/simulated/floor,
/area/submap/Drugd)
"R" = (
/obj/structure/girder,
/turf/simulated/floor,
/area/submap/Drugd)
"S" = (
/obj/item/material/shard,
/turf/simulated/floor,
/area/submap/Drugd)
"T" = (
/obj/structure/table/woodentable,
/obj/item/flashlight/lamp,
/turf/simulated/floor/carpet,
/area/submap/Drugd)
"U" = (
/obj/structure/table/woodentable,
/obj/item/reagent_containers/syringe/drugs,
/turf/simulated/floor/carpet,
/area/submap/Drugd)
"V" = (
/obj/structure/closet/cabinet,
/obj/random/projectile/scrapped_gun,
/obj/random/toy,
/turf/simulated/floor/carpet,
/area/submap/Drugd)
"W" = (
/obj/structure/closet/cabinet,
/obj/random/mre,
/obj/random/medical/lite,
/turf/simulated/floor/carpet,
/area/submap/Drugd)

(1,1,1) = {"
a
a
a
a
a
a
a
a
a
a
a
a
a
a
a
a
a
a
a
a
a
a
a
a
a
"}
(2,1,1) = {"
a
b
b
b
b
b
b
b
b
b
b
b
b
b
c
c
c
b
b
b
b
b
b
b
a
"}
(3,1,1) = {"
a
b
b
b
b
b
c
c
c
c
c
c
c
c
c
c
c
c
b
b
b
b
b
b
a
"}
(4,1,1) = {"
a
b
b
b
c
c
c
c
c
c
c
c
c
c
c
c
c
c
c
c
c
c
b
b
a
"}
(5,1,1) = {"
a
b
b
b
c
c
c
c
c
c
c
c
c
c
c
c
c
c
c
c
c
c
c
b
a
"}
(6,1,1) = {"
a
b
b
b
c
c
c
c
c
c
c
c
c
c
c
c
c
c
c
c
c
c
c
c
a
"}
(7,1,1) = {"
a
b
b
b
c
c
c
c
c
c
c
c
c
c
d
d
d
d
d
d
d
c
c
c
a
"}
(8,1,1) = {"
a
b
b
b
c
c
c
c
c
c
c
c
c
c
d
B
J
N
l
R
d
c
c
c
a
"}
(9,1,1) = {"
a
b
b
b
b
c
c
c
c
c
c
c
c
c
d
C
K
l
Q
l
d
c
c
c
a
"}
(10,1,1) = {"
a
b
b
b
b
b
c
c
c
c
c
c
c
c
d
D
g
l
l
S
d
c
c
c
a
"}
(11,1,1) = {"
a
b
b
b
b
b
c
c
c
c
c
c
c
c
d
E
L
O
l
l
d
c
c
b
a
"}
(12,1,1) = {"
a
b
b
b
b
b
b
d
d
d
d
d
d
d
d
d
d
d
e
d
d
c
c
b
a
"}
(13,1,1) = {"
a
b
b
b
b
b
b
d
f
g
g
p
u
l
z
l
l
h
l
l
l
c
c
b
a
"}
(14,1,1) = {"
a
b
b
b
b
b
b
e
f
g
l
l
l
l
l
l
f
l
l
l
u
c
c
b
a
"}
(15,1,1) = {"
a
b
b
b
b
b
b
d
f
h
l
l
h
l
g
f
M
g
l
h
d
c
c
b
a
"}
(16,1,1) = {"
a
b
b
b
b
b
b
d
d
d
m
d
d
d
m
d
d
d
m
d
d
c
c
c
a
"}
(17,1,1) = {"
a
b
b
b
b
b
c
c
d
i
n
q
d
v
o
F
d
V
o
W
d
c
c
c
a
"}
(18,1,1) = {"
a
b
b
b
b
c
c
c
d
j
o
r
d
w
o
G
d
P
o
T
d
c
c
c
a
"}
(19,1,1) = {"
a
b
b
b
b
c
c
c
d
k
o
s
d
x
o
H
d
w
o
U
d
c
c
c
a
"}
(20,1,1) = {"
a
b
b
b
b
c
c
c
d
j
o
t
d
y
A
I
d
w
o
n
d
c
c
b
a
"}
(21,1,1) = {"
a
b
b
b
b
c
c
c
d
d
d
d
d
d
d
d
d
d
d
d
d
c
c
c
a
"}
(22,1,1) = {"
a
b
b
b
b
b
c
c
c
c
c
c
c
c
c
c
c
c
c
c
c
c
c
c
a
"}
(23,1,1) = {"
a
b
b
b
b
b
b
c
c
c
c
c
c
c
c
c
c
c
c
c
c
c
c
b
a
"}
(24,1,1) = {"
a
b
b
b
b
b
b
b
b
c
c
c
c
b
b
b
b
c
c
c
c
b
b
b
a
"}
(25,1,1) = {"
a
a
a
a
a
a
a
a
a
a
a
a
a
a
a
a
a
a
a
a
a
a
a
a
a
"}
