"a" = (/turf/template_noop,/area/template_noop)
"b" = (/obj/effect/decal/cleanable/filth,/obj/item/weapon/bone/arm,/obj/item/weapon/bone/skull/unathi,/turf/simulated/floor/wood/sif,/area/submap/EmptyCabin)
"c" = (/obj/structure/curtain/black,/obj/structure/simple_door/sifwood,/turf/simulated/floor/wood/sif,/area/submap/EmptyCabin)
"d" = (/obj/structure/closet/wardrobe,/obj/item/weapon/material/fishing_rod/modern,/obj/item/weapon/storage/toolbox/mechanical,/obj/item/weapon/storage/toolbox/lunchbox/nymph/filled,/turf/simulated/floor/wood/sif,/area/submap/EmptyCabin)
"e" = (/turf/simulated/wall/sifwood,/area/submap/EmptyCabin)
"f" = (/obj/structure/railing/grey{dir = 1},/turf/simulated/floor/wood/sif,/area/submap/EmptyCabin)
"g" = (/obj/structure/bed/double/padded,/obj/item/weapon/bedsheet/purpledouble,/turf/simulated/floor/wood/sif,/area/submap/EmptyCabin)
"i" = (/obj/structure/bed/chair/sofa/blue/right{dir = 1},/turf/simulated/floor/wood/sif,/area/submap/EmptyCabin)
"k" = (/obj/structure/railing/grey{dir = 8},/obj/structure/bed/chair/oldsofa/right{dir = 8},/turf/simulated/floor/wood/sif,/area/submap/EmptyCabin)
"l" = (/obj/structure/railing/grey{dir = 8},/obj/structure/bed/chair/oldsofa{dir = 8},/turf/simulated/floor/wood/sif,/area/submap/EmptyCabin)
"n" = (/obj/structure/table/sifwoodentable,/obj/item/weapon/storage/fancy/candle_box,/obj/item/weapon/paper/crumpled/bloody{info = "I found an otie while picking flowers today. He's so cute! I took him back home, and he seemed quite happy to share food with me. He really likes fish. Though, he never really seems to not be hungry..."},/turf/simulated/floor/wood/sif,/area/submap/EmptyCabin)
"q" = (/obj/structure/railing/grey{dir = 4},/turf/template_noop,/area/submap/EmptyCabin)
"r" = (/obj/effect/landmark/loot_spawn/low,/turf/simulated/floor/wood/sif,/area/submap/EmptyCabin)
"t" = (/obj/structure/railing/grey,/turf/simulated/floor/wood/sif,/area/submap/EmptyCabin)
"y" = (/obj/structure/window/reinforced{dir = 1},/obj/structure/curtain/black,/obj/structure/grille/rustic,/turf/simulated/floor/plating,/area/submap/EmptyCabin)
"z" = (/obj/effect/decal/cleanable/blood/drip{icon_state = "4"},/turf/simulated/floor/wood/sif,/area/submap/EmptyCabin)
"A" = (/obj/structure/bonfire/permanent/sifwood,/obj/structure/railing/grey{dir = 8},/turf/simulated/floor/tiled/eris/steel/techfloor,/area/submap/EmptyCabin)
"B" = (/obj/effect/floor_decal/stairs/dark_stairs{dir = 1},/turf/template_noop,/area/submap/EmptyCabin)
"C" = (/obj/structure/railing/grey{dir = 8},/turf/simulated/floor/wood/sif,/area/submap/EmptyCabin)
"D" = (/turf/simulated/floor/wood/sif,/area/submap/EmptyCabin)
"F" = (/mob/living/simple_mob/otie/friendly/chubby{desc = "The classic bioengineered longdog. This one still probably won't tolerate you. What an absolute unit"; faction = "spiders"},/obj/effect/decal/cleanable/blood,/turf/simulated/floor/wood/sif,/area/submap/EmptyCabin)
"G" = (/obj/structure/bed/chair/sofa/blue{dir = 1},/turf/simulated/floor/wood/sif,/area/submap/EmptyCabin)
"I" = (/obj/structure/table/sifwoodentable,/obj/item/pizzabox/meat,/turf/simulated/floor/wood/sif,/area/submap/EmptyCabin)
"J" = (/obj/structure/bed/chair/sofa/blue/left{dir = 1},/turf/simulated/floor/wood/sif,/area/submap/EmptyCabin)
"L" = (/obj/structure/table/sifwoodentable,/obj/item/weapon/flame/candle/candelabra,/turf/simulated/floor/wood/sif,/area/submap/EmptyCabin)
"M" = (/obj/item/weapon/bone/leg,/turf/simulated/floor/wood/sif,/area/submap/EmptyCabin)
"O" = (/obj/structure/railing/grey{dir = 8},/obj/structure/bed/chair/oldsofa/left{dir = 8},/turf/simulated/floor/wood/sif,/area/submap/EmptyCabin)
"Q" = (/obj/effect/decal/cleanable/blood/drip{icon_state = "5"},/obj/effect/decal/cleanable/blood/drip{icon_state = "2"},/obj/effect/decal/cleanable/blood/drip,/obj/effect/decal/cleanable/blood/drip{icon_state = "3"},/obj/effect/decal/cleanable/blood,/turf/simulated/floor/wood/sif,/area/submap/EmptyCabin)
"R" = (/obj/structure/loot_pile/surface,/turf/template_noop,/area/template_noop)
"T" = (/obj/structure/railing/grey{dir = 8},/turf/template_noop,/area/submap/EmptyCabin)
"V" = (/obj/effect/decal/cleanable/blood/drip{icon_state = "5"},/turf/simulated/floor/wood/sif,/area/submap/EmptyCabin)
"W" = (/obj/effect/decal/cleanable/blood/drip,/obj/effect/decal/cleanable/blood/drip{icon_state = "2"},/turf/simulated/floor/wood/sif,/area/submap/EmptyCabin)
"X" = (/obj/item/weapon/bone,/turf/simulated/floor/wood/sif,/area/submap/EmptyCabin)
"Z" = (/obj/effect/decal/cleanable/blood/drip{icon_state = "3"},/turf/simulated/floor/wood/sif,/area/submap/EmptyCabin)

(1,1,1) = {"
aaaaaaaaaa
qBTaaaaaaa
eDfeeyeeRa
kDeegndeeR
lDebFWZzee
lDcMXDrVAe
ODeDLIDQee
CDeeiGJeea
etteeeeeaa
aaaaaaaaaa
"}
