//MAP CONVERTED BY dmm2tgm.py THIS HEADER COMMENT PREVENTS RECONVERSION, DO NOT REMOVE
"a" = (
/turf/template_noop,
/area/template_noop)
"b" = (
/turf/template_noop,
/area/submap/Lake1)
"c" = (
/obj/structure/flora/tree/sif,
/turf/template_noop,
/area/submap/Lake1)
"d" = (
/obj/structure/flora/ausbushes/grassybush,
/turf/template_noop,
/area/submap/Lake1)
"e" = (
/obj/structure/flora/tree/dead,
/turf/template_noop,
/area/submap/Lake1)
"f" = (
/turf/simulated/floor/outdoors/rocks,
/area/submap/Lake1)
"g" = (
/obj/structure/flora/ausbushes/palebush,
/turf/template_noop,
/area/submap/Lake1)
"h" = (
/turf/simulated/floor/water,
/area/submap/Lake1)
"i" = (
/turf/simulated/floor/outdoors/dirt,
/area/submap/Lake1)
"j" = (
/turf/simulated/mineral,
/area/submap/Lake1)
"k" = (
/obj/structure/flora/ausbushes/stalkybush,
/turf/template_noop,
/area/submap/Lake1)

(1,1,1) = {"
a
a
a
a
a
a
a
a
a
a
a
a
a
a
a
a
a
a
a
a
"}
(2,1,1) = {"
a
a
a
b
b
b
b
b
b
e
b
b
b
b
b
b
a
a
a
a
"}
(3,1,1) = {"
a
a
a
a
g
b
f
f
f
f
f
f
f
f
b
b
b
a
a
a
"}
(4,1,1) = {"
a
a
a
a
b
f
f
h
h
h
h
h
h
f
f
f
b
b
a
a
"}
(5,1,1) = {"
a
a
a
b
b
f
h
h
h
h
h
h
h
h
h
f
b
c
b
a
"}
(6,1,1) = {"
a
a
a
b
e
f
h
h
h
h
h
h
h
h
h
f
b
b
b
a
"}
(7,1,1) = {"
a
a
a
b
b
f
h
h
h
h
h
h
h
h
h
f
f
b
b
a
"}
(8,1,1) = {"
a
a
b
b
f
f
h
h
h
h
h
h
h
h
h
h
f
b
b
a
"}
(9,1,1) = {"
a
b
b
d
f
h
h
h
h
h
h
h
h
h
h
h
f
b
c
a
"}
(10,1,1) = {"
a
b
b
b
f
h
h
h
h
h
h
h
h
h
h
h
f
b
b
a
"}
(11,1,1) = {"
a
b
c
b
f
h
h
h
h
h
h
h
h
h
h
h
f
b
a
a
"}
(12,1,1) = {"
a
b
b
b
f
h
h
h
h
h
h
h
h
h
h
h
f
a
a
a
"}
(13,1,1) = {"
a
b
b
b
f
h
h
h
h
h
h
h
h
h
h
h
f
a
a
a
"}
(14,1,1) = {"
a
b
d
b
f
h
h
h
h
h
h
h
h
h
h
h
f
a
a
a
"}
(15,1,1) = {"
a
b
b
f
f
h
h
h
h
h
h
h
h
h
h
h
f
b
a
a
"}
(16,1,1) = {"
a
b
b
f
h
h
h
h
h
h
h
h
h
h
h
h
f
k
b
a
"}
(17,1,1) = {"
a
b
b
f
h
h
h
h
h
h
h
h
h
h
h
f
f
b
b
a
"}
(18,1,1) = {"
a
b
b
f
h
h
h
h
h
h
h
h
h
h
h
f
b
k
b
a
"}
(19,1,1) = {"
a
b
c
f
h
h
h
h
h
h
h
h
h
h
h
f
b
c
b
a
"}
(20,1,1) = {"
a
b
b
f
f
h
h
h
h
h
h
h
h
h
h
f
k
b
b
a
"}
(21,1,1) = {"
a
b
b
b
f
f
f
h
h
h
h
h
h
f
f
f
b
b
b
a
"}
(22,1,1) = {"
a
b
b
b
c
b
f
f
f
f
f
f
f
f
i
i
b
b
a
a
"}
(23,1,1) = {"
a
b
b
b
b
b
b
b
b
i
i
i
i
i
i
i
b
b
a
a
"}
(24,1,1) = {"
a
a
b
b
b
b
b
b
b
i
i
i
i
j
i
i
b
a
a
a
"}
(25,1,1) = {"
a
a
a
b
b
b
b
c
b
i
i
j
j
j
i
b
c
a
a
a
"}
(26,1,1) = {"
a
a
a
b
b
b
b
b
b
i
j
j
j
j
i
b
b
a
a
a
"}
(27,1,1) = {"
a
a
e
b
b
a
a
b
b
b
i
j
j
i
i
b
b
a
a
a
"}
(28,1,1) = {"
a
a
b
a
a
a
a
a
b
e
b
i
i
i
b
b
b
a
a
a
"}
(29,1,1) = {"
a
a
a
a
a
a
a
a
b
b
b
b
b
b
b
c
a
a
a
a
"}
(30,1,1) = {"
a
a
a
a
a
a
a
a
a
a
a
a
a
a
a
a
a
a
a
a
"}
