"a" = (/turf/template_noop,/area/template_noop)
"b" = (/turf/simulated/mineral/ignore_mapgen/sif,/area/submap/FrostflyNest)
"c" = (/obj/structure/boulder,/turf/simulated/mineral/floor/ignore_mapgen/sif,/area/submap/FrostflyNest)
"d" = (/turf/simulated/wall/solidrock,/area/submap/FrostflyNest)
"e" = (/turf/simulated/mineral/floor/ignore_mapgen/sif,/area/submap/FrostflyNest)
"f" = (/obj/structure/outcrop/diamond,/turf/simulated/mineral/floor/ignore_mapgen/sif,/area/submap/FrostflyNest)
"g" = (/obj/random/humanoidremains,/turf/simulated/mineral/floor/ignore_mapgen/sif,/area/submap/FrostflyNest)
"h" = (/obj/structure/prop/nest{color = "#041164"; creature_types = list(/mob/living/simple_mob/animal/sif/frostfly); name = "frostfly den"; spawn_delay = 300},/turf/simulated/mineral/floor/ignore_mapgen/sif,/area/submap/FrostflyNest)
"i" = (/obj/random/medical/lite,/turf/simulated/mineral/floor/ignore_mapgen/sif,/area/submap/FrostflyNest)
"j" = (/obj/random/humanoidremains,/obj/random/gun/random,/turf/simulated/mineral/floor/ignore_mapgen/sif,/area/submap/FrostflyNest)
"k" = (/obj/random/medical/pillbottle,/turf/simulated/mineral/floor/ignore_mapgen/sif,/area/submap/FrostflyNest)
"l" = (/obj/random/gun/random,/turf/simulated/mineral/floor/ignore_mapgen/sif,/area/submap/FrostflyNest)

(1,1,1) = {"
aabbbcbbaa
abbddedbba
bbddfgddbb
bddhieiddb
bdfjefefdb
bdkeegeddb
ceefefldbb
bdddgdddba
bbbdddbbba
abbbbbbaaa
"}
