"aa" = (/obj/effect/decal/cleanable/blood/drip,/mob/living/simple_mob/animal/wolf/direwolf{desc = "The biggest and baddest wolf around. Seems pretty chill, for a wolf."; faction = "sif"; ai_holder_type = /datum/ai_holder/simple_mob/retaliate},/turf/simulated/mineral/floor/ignore_mapgen,/area/submap/GreatWolfDen)
"bp" = (/obj/structure/cliff/automatic/corner{dir = 6},/turf/simulated/floor/outdoors/dirt,/area/template_noop)
"bz" = (/obj/structure/flora/bboulder1,/turf/simulated/mineral/floor/ignore_mapgen,/area/submap/GreatWolfDen)
"bI" = (/obj/effect/decal/cleanable/dirt,/obj/effect/decal/cleanable/blood/drip,/turf/simulated/mineral/floor/ignore_mapgen,/area/submap/GreatWolfDen)
"bY" = (/turf/simulated/floor/outdoors/snow,/area/submap/GreatWolfDen)
"dM" = (/obj/structure/flora/bboulder2,/turf/simulated/floor/outdoors/dirt,/area/template_noop)
"dX" = (/obj/structure/cliff/automatic{dir = 4},/turf/simulated/floor/outdoors/dirt,/area/template_noop)
"eq" = (/obj/structure/flora/ausbushes/ppflowers,/turf/simulated/floor/outdoors/snow,/area/submap/GreatWolfDen)
"fh" = (/obj/structure/cliff/automatic{dir = 2},/turf/simulated/floor/outdoors/dirt,/area/template_noop)
"fX" = (/obj/effect/decal/cleanable/dirt,/obj/structure/flora/rocks2,/turf/simulated/floor/outdoors/dirt,/area/template_noop)
"ge" = (/obj/structure/flora/sif/subterranean{icon_state = "frostbelle"},/turf/simulated/mineral/floor/ignore_mapgen,/area/submap/GreatWolfDen)
"hJ" = (/obj/structure/cliff/automatic{dir = 9},/turf/simulated/floor/outdoors/dirt,/area/template_noop)
"iX" = (/obj/effect/decal/cleanable/blood/drip,/obj/effect/decal/cleanable/blood/drip,/obj/effect/decal/cleanable/blood/drip{icon_state = "2"},/turf/simulated/mineral/floor/ignore_mapgen,/area/submap/GreatWolfDen)
"jg" = (/obj/effect/decal/cleanable/cobweb,/obj/item/ammo_casing/a10mm{dir = 8},/turf/simulated/mineral/floor/ignore_mapgen,/area/submap/GreatWolfDen)
"ju" = (/obj/item/weapon/reagent_containers/food/snacks/meat/human,/obj/item/weapon/reagent_containers/food/snacks/meat/human,/obj/item/weapon/reagent_containers/food/snacks/meat/human,/obj/item/weapon/reagent_containers/food/snacks/meat/human,/obj/item/weapon/reagent_containers/food/snacks/meat/human,/turf/simulated/mineral/floor/ignore_mapgen,/area/submap/GreatWolfDen)
"kg" = (/obj/item/weapon/bone/skull/unathi,/turf/simulated/mineral/floor/ignore_mapgen,/area/submap/GreatWolfDen)
"kk" = (/obj/effect/decal/cleanable/blood/gibs{color = "red"; icon_state = "gib2_flesh"},/turf/simulated/mineral/floor/ignore_mapgen,/area/submap/GreatWolfDen)
"kL" = (/obj/structure/flora/sif/subterranean{icon_state = "grass3"},/turf/simulated/floor/outdoors/grass/sif/forest{outdoors = 0},/area/submap/GreatWolfDen)
"lu" = (/obj/effect/decal/cleanable/dirt,/obj/item/ammo_casing/a10mm,/turf/simulated/mineral/floor/ignore_mapgen,/area/submap/GreatWolfDen)
"lL" = (/obj/structure/loot_pile/surface/bones,/obj/effect/landmark/loot_spawn/low,/obj/random/projectile/scrapped_gun,/turf/simulated/mineral/floor/ignore_mapgen,/area/submap/GreatWolfDen)
"lQ" = (/obj/effect/decal/cleanable/filth,/obj/item/weapon/card/emag_broken,/turf/simulated/mineral/floor/ignore_mapgen,/area/submap/GreatWolfDen)
"mk" = (/obj/effect/decal/cleanable/dirt,/obj/effect/decal/cleanable/blood/drip,/obj/effect/decal/cleanable/blood/drip{icon_state = "3"},/obj/item/ammo_casing/a10mm{dir = 8},/turf/simulated/mineral/floor/ignore_mapgen,/area/submap/GreatWolfDen)
"mm" = (/obj/random/trash_pile,/turf/simulated/mineral/floor/ignore_mapgen,/area/submap/GreatWolfDen)
"nd" = (/obj/structure/flora/rocks2,/obj/effect/decal/remains/lizard,/turf/simulated/mineral/floor/ignore_mapgen,/area/submap/GreatWolfDen)
"nv" = (/mob/living/simple_mob/vore/greatwolf{dir = 8},/turf/simulated/floor/outdoors/grass/sif/forest{outdoors = 0},/area/submap/GreatWolfDen)
"pS" = (/turf/template_noop,/area/template_noop)
"qb" = (/obj/effect/decal/cleanable/blood/drip,/turf/simulated/mineral/floor/ignore_mapgen,/area/submap/GreatWolfDen)
"rn" = (/obj/structure/loot_pile/mecha/gygax/dark/adv,/obj/effect/decal/cleanable/blood/gibs/robot/down,/obj/effect/decal/cleanable/dirt,/turf/simulated/mineral/floor/ignore_mapgen,/area/submap/GreatWolfDen)
"rM" = (/obj/structure/flora/sif/subterranean{icon_state = "eyeplant2"},/turf/simulated/floor/outdoors/grass/sif/forest{outdoors = 0},/area/submap/GreatWolfDen)
"tb" = (/obj/structure/flora/smallbould,/turf/simulated/mineral/floor/ignore_mapgen,/area/submap/GreatWolfDen)
"tm" = (/turf/simulated/mineral/ignore_mapgen,/area/submap/GreatWolfDen)
"tC" = (/obj/effect/decal/remains/mouse,/turf/simulated/mineral/floor/ignore_mapgen,/area/submap/GreatWolfDen)
"uz" = (/mob/living/simple_mob/animal/wolf/direwolf{desc = "The biggest and baddest wolf around. Seems pretty chill, for a wolf."; faction = "sif"; ai_holder_type = /datum/ai_holder/simple_mob/retaliate},/turf/simulated/mineral/floor/ignore_mapgen,/area/submap/GreatWolfDen)
"uY" = (/obj/item/ammo_casing/a10mm,/turf/simulated/mineral/floor/ignore_mapgen,/area/submap/GreatWolfDen)
"vu" = (/obj/item/weapon/bone/skull/tajaran,/turf/simulated/mineral/floor/ignore_mapgen,/area/submap/GreatWolfDen)
"wc" = (/obj/item/weapon/bone/skull/unathi,/obj/effect/decal/cleanable/dirt,/turf/simulated/mineral/floor/ignore_mapgen,/area/submap/GreatWolfDen)
"xt" = (/obj/effect/landmark/loot_spawn/low,/turf/simulated/mineral/floor/ignore_mapgen,/area/submap/GreatWolfDen)
"xK" = (/obj/effect/decal/remains/human,/obj/item/clothing/under/syndicate,/obj/random/projectile/scrapped_gun,/turf/simulated/mineral/floor/ignore_mapgen,/area/submap/GreatWolfDen)
"yi" = (/obj/structure/flora/sif/subterranean{icon_state = "frostbelle2"},/turf/simulated/mineral/floor/ignore_mapgen,/area/submap/GreatWolfDen)
"yF" = (/obj/structure/flora/smallbould,/obj/effect/decal/cleanable/cobweb,/turf/simulated/mineral/floor/ignore_mapgen,/area/submap/GreatWolfDen)
"yG" = (/obj/structure/flora/ausbushes/ywflowers,/turf/simulated/floor/outdoors/snow,/area/submap/GreatWolfDen)
"yH" = (/obj/effect/decal/cleanable/blood/drip,/obj/effect/decal/cleanable/blood,/obj/effect/decal/cleanable/blood/drip,/obj/effect/decal/cleanable/blood/drip{icon_state = "3"},/turf/simulated/mineral/floor/ignore_mapgen,/area/submap/GreatWolfDen)
"zl" = (/obj/structure/flora/bboulder1,/obj/effect/decal/cleanable/cobweb2,/turf/simulated/mineral/floor/ignore_mapgen,/area/submap/GreatWolfDen)
"zs" = (/obj/structure/flora/bboulder2,/turf/simulated/mineral/floor/ignore_mapgen,/area/submap/GreatWolfDen)
"zV" = (/obj/effect/decal/cleanable/dirt,/obj/effect/decal/cleanable/dirt,/obj/structure/ledge/ledge_stairs,/turf/simulated/floor/outdoors/dirt,/area/template_noop)
"AG" = (/obj/effect/decal/cleanable/dirt,/obj/effect/decal/cleanable/dirt,/obj/effect/decal/cleanable/dirt,/obj/structure/flora/rocks2,/obj/structure/ledge/ledge_stairs,/turf/simulated/floor/outdoors/rocks,/area/submap/GreatWolfDen)
"AK" = (/obj/structure/cliff/automatic/ramp{dir = 9},/turf/simulated/floor/outdoors/dirt,/area/template_noop)
"Cd" = (/mob/living/simple_mob/otie/feral/chubby{desc = "The classic bioengineered longdog. No pets. Only bite. What an absolute unit."; faction = "sif"; ai_holder_type = /datum/ai_holder/simple_mob/retaliate},/turf/simulated/mineral/floor/ignore_mapgen,/area/submap/GreatWolfDen)
"CR" = (/obj/effect/decal/cleanable/dirt,/turf/simulated/mineral/floor/ignore_mapgen,/area/submap/GreatWolfDen)
"Dj" = (/obj/structure/cliff/automatic/corner,/turf/simulated/floor/outdoors/dirt,/area/template_noop)
"DV" = (/obj/effect/decal/cleanable/dirt,/obj/random/outcrop,/turf/simulated/mineral/floor/ignore_mapgen,/area/submap/GreatWolfDen)
"EU" = (/obj/structure/flora/rocks1,/turf/simulated/mineral/floor/ignore_mapgen,/area/submap/GreatWolfDen)
"Fy" = (/obj/structure/flora/sif/subterranean{icon_state = "eyeplant1"},/turf/simulated/floor/outdoors/grass/sif/forest{outdoors = 0},/area/submap/GreatWolfDen)
"Hb" = (/obj/structure/closet/crate/secure/loot,/turf/simulated/mineral/floor/ignore_mapgen,/area/submap/GreatWolfDen)
"HC" = (/obj/random/outcrop,/turf/simulated/floor/outdoors/dirt,/area/template_noop)
"Ic" = (/obj/effect/decal/remains/deer,/obj/effect/decal/cleanable/blood/drip,/turf/simulated/mineral/floor/ignore_mapgen,/area/submap/GreatWolfDen)
"Id" = (/obj/effect/decal/cleanable/dirt,/turf/template_noop,/area/template_noop)
"If" = (/obj/effect/decal/cleanable/blood/gibs/robot/limb,/turf/simulated/mineral/floor/ignore_mapgen,/area/submap/GreatWolfDen)
"Iw" = (/obj/effect/decal/remains/deer,/turf/simulated/mineral/floor/ignore_mapgen,/area/submap/GreatWolfDen)
"Kb" = (/obj/item/ammo_casing/a10mm{dir = 8},/turf/simulated/mineral/floor/ignore_mapgen,/area/submap/GreatWolfDen)
"Ko" = (/obj/effect/decal/cleanable/blood/gibs{color = "red"; icon_state = "gibdown1_flesh"},/obj/effect/decal/cleanable/dirt,/turf/simulated/mineral/floor/ignore_mapgen,/area/submap/GreatWolfDen)
"Kp" = (/obj/structure/flora/ausbushes/brflowers,/turf/simulated/floor/outdoors/snow,/area/submap/GreatWolfDen)
"KU" = (/obj/structure/flora/sif/subterranean{icon_state = "grass3"},/turf/simulated/floor/outdoors/snow,/area/submap/GreatWolfDen)
"Lx" = (/obj/structure/cliff/automatic{dir = 8},/turf/simulated/floor/outdoors/dirt,/area/template_noop)
"Lz" = (/obj/effect/decal/cleanable/blood/gibs{color = "red"; icon_state = "gib1_flesh"},/turf/simulated/floor/outdoors/grass/sif/forest{outdoors = 0},/area/submap/GreatWolfDen)
"LJ" = (/obj/effect/decal/cleanable/dirt,/obj/structure/flora/sif/subterranean{icon_state = "glowplant2"},/turf/simulated/mineral/floor/ignore_mapgen,/area/submap/GreatWolfDen)
"LP" = (/obj/effect/decal/cleanable/dirt,/obj/effect/decal/cleanable/dirt,/obj/effect/decal/cleanable/dirt,/obj/structure/flora/rocks2,/obj/structure/ledge/ledge_stairs,/turf/simulated/floor/outdoors/dirt,/area/template_noop)
"LT" = (/obj/structure/cliff/automatic/corner{dir = 10},/turf/simulated/floor/outdoors/dirt,/area/template_noop)
"Mc" = (/obj/effect/decal/cleanable/ash,/turf/simulated/mineral/floor/ignore_mapgen,/area/submap/GreatWolfDen)
"Mv" = (/obj/random/outcrop,/turf/simulated/mineral/floor/ignore_mapgen,/area/submap/GreatWolfDen)
"MD" = (/obj/structure/flora/tree/sif{icon_state = "tree_sif4"},/turf/simulated/floor/outdoors/snow,/area/submap/GreatWolfDen)
"OB" = (/obj/item/stack/material/log{amount = 25},/obj/effect/decal/cleanable/dirt,/turf/simulated/mineral/floor/ignore_mapgen,/area/submap/GreatWolfDen)
"OL" = (/obj/structure/cliff/automatic,/turf/simulated/floor/outdoors/dirt,/area/template_noop)
"OV" = (/obj/structure/cliff/automatic{dir = 6},/turf/simulated/floor/outdoors/dirt,/area/template_noop)
"OW" = (/obj/structure/cliff/automatic{dir = 5},/turf/simulated/floor/outdoors/dirt,/area/template_noop)
"Pa" = (/obj/structure/cliff/automatic/ramp,/turf/simulated/floor/outdoors/dirt,/area/template_noop)
"Pf" = (/obj/effect/decal/cleanable/dirt,/obj/effect/decal/cleanable/dirt,/turf/simulated/mineral/floor/ignore_mapgen,/area/submap/GreatWolfDen)
"Pl" = (/obj/effect/decal/remains/lizard,/obj/effect/decal/cleanable/dirt,/turf/simulated/mineral/floor/ignore_mapgen,/area/submap/GreatWolfDen)
"PC" = (/obj/structure/closet/crate/secure/loot,/obj/effect/decal/cleanable/cobweb2,/turf/simulated/mineral/floor/ignore_mapgen,/area/submap/GreatWolfDen)
"PX" = (/obj/effect/decal/cleanable/blood/drip,/obj/effect/decal/cleanable/dirt,/turf/simulated/mineral/floor/ignore_mapgen,/area/submap/GreatWolfDen)
"Qb" = (/obj/effect/decal/cleanable/dirt,/obj/effect/decal/cleanable/dirt,/obj/effect/decal/cleanable/dirt,/obj/structure/flora/rocks1,/obj/structure/ledge/ledge_stairs,/turf/simulated/floor/outdoors/dirt,/area/template_noop)
"Qv" = (/turf/simulated/floor/outdoors/dirt,/area/template_noop)
"QA" = (/obj/structure/flora/sif/subterranean{icon_state = "grass2"},/turf/simulated/floor/outdoors/snow,/area/submap/GreatWolfDen)
"QJ" = (/turf/simulated/mineral/floor/ignore_mapgen,/area/submap/GreatWolfDen)
"QM" = (/obj/effect/decal/cleanable/dirt,/obj/effect/decal/cleanable/blood/drip,/obj/effect/decal/cleanable/blood/drip{icon_state = "2"},/turf/simulated/mineral/floor/ignore_mapgen,/area/submap/GreatWolfDen)
"Rb" = (/obj/item/weapon/bone/leg,/obj/effect/decal/cleanable/dirt,/turf/simulated/mineral/floor/ignore_mapgen,/area/submap/GreatWolfDen)
"Rf" = (/obj/structure/loot_pile/surface/bones,/obj/structure/flora/sif/subterranean{icon_state = "frostbelle"},/obj/item/weapon/gun/projectile/pistol,/turf/simulated/mineral/floor/ignore_mapgen,/area/submap/GreatWolfDen)
"Rj" = (/obj/structure/flora/grass/both,/turf/simulated/floor/outdoors/snow,/area/submap/GreatWolfDen)
"Rx" = (/obj/effect/decal/cleanable/dirt,/turf/simulated/floor/outdoors/dirt,/area/template_noop)
"RW" = (/obj/structure/flora/rocks2,/turf/simulated/mineral/floor/ignore_mapgen,/area/submap/GreatWolfDen)
"SO" = (/obj/item/weapon/telecube/mated,/turf/simulated/mineral/floor/ignore_mapgen,/area/submap/GreatWolfDen)
"SQ" = (/obj/structure/cliff/automatic/corner{dir = 9},/turf/simulated/floor/outdoors/dirt,/area/template_noop)
"Tf" = (/obj/item/weapon/paper/card/heart{desc = "A gift card with a heart on the cover. This appears to be a thank-you to the.. wolves??"},/obj/item/weapon/paper/crumpled{icon_state = "scrap_bloodied"; info = "The wolves dragged me back to their den when they found me incapacitated, and nursed me back to health, instead of eating me. I don't know why. Anyway, they're a bunch of goodboyes. Don't let the bones strewn about their den frighten you. Just be nice to them and they won't hurt you."; name = "survivor's note"},/turf/simulated/mineral/floor/ignore_mapgen,/area/submap/GreatWolfDen)
"Tn" = (/obj/structure/bonfire,/turf/simulated/floor/outdoors/grass/sif/forest{outdoors = 0},/area/submap/GreatWolfDen)
"Ty" = (/obj/random/trash_pile,/turf/simulated/floor/outdoors/dirt,/area/template_noop)
"UV" = (/obj/structure/cliff/automatic{dir = 10},/turf/simulated/floor/outdoors/dirt,/area/template_noop)
"Vq" = (/obj/structure/loot_pile/surface/bones,/obj/random/projectile/scrapped_gun,/turf/simulated/mineral/floor/ignore_mapgen,/area/submap/GreatWolfDen)
"WH" = (/obj/structure/loot_pile/surface/bones,/obj/item/weapon/storage/toolbox/syndicate,/obj/random/projectile/scrapped_gun,/turf/simulated/mineral/floor/ignore_mapgen,/area/submap/GreatWolfDen)
"WR" = (/obj/structure/flora/sif/subterranean{icon_state = "glowplant1"},/obj/effect/decal/cleanable/blood/drip,/turf/simulated/mineral/floor/ignore_mapgen,/area/submap/GreatWolfDen)
"WY" = (/obj/effect/decal/cleanable/dirt,/obj/effect/decal/cleanable/dirt,/obj/structure/flora/rocks1,/turf/simulated/floor/outdoors/dirt,/area/template_noop)
"Xx" = (/obj/structure/flora/sif/subterranean{icon_state = "grass1"},/turf/simulated/floor/outdoors/snow,/area/submap/GreatWolfDen)
"Xy" = (/obj/item/weapon/bone/ribs,/obj/effect/landmark/loot_spawn/low,/turf/simulated/mineral/floor/ignore_mapgen,/area/submap/GreatWolfDen)
"Yw" = (/obj/structure/loot_pile/surface/bones,/obj/effect/landmark/loot_spawn/low,/turf/simulated/mineral/floor/ignore_mapgen,/area/submap/GreatWolfDen)
"Zj" = (/turf/simulated/floor/outdoors/grass/sif/forest{outdoors = 0},/area/submap/GreatWolfDen)
"Zk" = (/obj/structure/flora/sif/subterranean{icon_state = "glowplant2"},/turf/simulated/mineral/floor/ignore_mapgen,/area/submap/GreatWolfDen)
"Zu" = (/obj/structure/loot_pile/surface/bones,/obj/effect/landmark/loot_spawn/low,/obj/effect/decal/cleanable/dirt,/obj/random/projectile/scrapped_gun,/turf/simulated/mineral/floor/ignore_mapgen,/area/submap/GreatWolfDen)

(1,1,1) = {"
pSpSpSpSpSpSpSpSpSpSpSpSpSpSpSQvpSpSpSpSpSpSpSpSpSpSpSpSpSpS
pSpSpSpSpSpSpSpSpSpSpSpSpSpSQvpSpSpSpSpSpSpSpSpSpSpSpSpSpSpS
pSpSpSpSpSpSpSpSpSpSpSpSIdpSIdQvQvpSpSpSpSpSpSpSpSpSpSpSpSpS
pSpSpSpSpSpSpSpSpSpSQvQvpSpSfXIdRxpSpSpSpSpSpSpSpSpSpSpSpSpS
pSpSpSQvpSpSQvpSpSQvQvHCQvIdpSRxWYpSpSpSpSpSpSpSpSpSpSpSpSpS
pSpSpSpSpSQvQvQvQvQvQvQvQvQvdMzVRxpSpSpSpSpSpSpSQvpSpSpSpSpS
pSpSpSpSQvQvbpfhfhfhfhLTQvQvPaLPAKQvQvQvpSpSpSpSpSpSpSpSpSpS
pSpSpSQvbpfhOVtmtmtmtmUVfhfhOVQbUVLTQvQvQvQvpSpSpSpSpSpSpSpS
pSpSpSQvdXtmtmtmtmtmtmtmtmtmtmAGtmUVfhfhLTHCQvQvpSpSpSpSpSpS
pSpSpSQvdXtmtmtmMcmmbztmtmtmLJCRtmtmtmtmUVfhLTQvQvQvpSpSpSpS
pSpSQvbpOVtmtmyiQJRbPlbITfCRPfCRtmtmtmtmtmtmUVLTQvQvpSpSpSpS
pSpSQvdXtmtmtmCRqbEUbICRKoCRCRCRtmtmtmtmtmtmtmLxQvQvpSpSpSpS
pSpSQvdXtmtmjgxKlulQDVtmtmtmtmtmtmzstmtmtmtmtmUVLTQvpSpSpSpS
pSpSHCdXtmtmyiuYmkyitmtmtmyFjuSOvuQJHbPCtmtmtmtmLxTyQvpSpSpS
pSTyQvdXtmtmMvQJuYKbwcrnOBqbaatCWRxKQJQJQJzltmtmUVLTQvQvpSpS
pSpSQvdXtmtmtmZuQJQMQJPXuzFyLzZjEUIcuzqbWHyitmtmtmLxQvQvpSpS
pSpSQvdXtmtmtmzsQJIwQJTnZjZjeqZjnvZjQJkkiXQJtmtmtmLxQvHCpSpS
pSQvQvdXtmtmtmQJkkQJQJZjXxRjbYbYKUZjZjIcyHgetmtmhJSQQvQvpSpS
pSQvQvDjOWtmtmQJQJRWQJZjrMKpMDQARjbYZjuzqbQJtmtmLxQvQvQvpSpS
pSQvQvQvdXtmtmMvQJZkQJuzZjLzyGZjZjZjZjQJQJVqtmtmLxQvpSpSpSpS
pSpSQvHCdXtmtmtmQJQJCdQJIwZjZjkLQJndQJVqVqxttmtmLxQvpSpSpSpS
pSpSpSQvDjOWtmtmtbQJQJQJQJQJQJuzQJQJuzxtYwtmtmtmLxQvpSpSpSpS
pSpSpSpSQvdXtmtmtmtmkgyiQJuzIfQJQJQJxtRftmtmtmhJSQQvpSpSpSpS
pSpSpSpSQvDjOWtmtmtmtmtmtmXyQJMvQJlLtmtmtmtmhJSQQvQvpSpSQvpS
pSpSpSpSQvQvDjOWtmtmtmtmtmtmtmtmtmtmtmtmtmhJSQQvQvpSpSpSpSpS
pSpSpSpSpSQvQvDjOLOLOWtmtmtmtmtmtmtmhJOLOLSQQvQvpSpSpSQvpSpS
pSpSpSQvpSpSpSQvQvQvDjOLOLOLOLOLOLOLSQQvQvQvQvQvpSpSpSQvpSpS
pSpSQvQvpSpSpSpSQvQvQvQvQvQvQvQvQvQvQvQvQvTypSpSpSpSpSpSpSpS
pSpSpSpSpSpSpSpSpSQvQvQvQvQvHCQvQvQvpSpSQvQvpSpSpSpSpSpSpSpS
pSpSpSpSpSpSpSpSpSpSpSpSpSQvQvQvpSpSQvpSpSpSpSpSpSpSpSpSpSpS
"}
