//MAP CONVERTED BY dmm2tgm.py THIS HEADER COMMENT PREVENTS RECONVERSION, DO NOT REMOVE
"a" = (
/turf/template_noop,
/area/template_noop)
"b" = (
/turf/simulated/mineral/ignore_mapgen,
/area/submap/KururakDen)
"c" = (
/turf/simulated/mineral/floor/ignore_mapgen,
/area/submap/KururakDen)
"d" = (
/obj/random/mob/sif/kururak,
/turf/simulated/mineral/floor/ignore_mapgen,
/area/submap/KururakDen)
"e" = (
/mob/living/simple_mob/animal/sif/kururak/leader,
/turf/simulated/mineral/floor/ignore_mapgen,
/area/submap/KururakDen)
"f" = (
/obj/random/outcrop,
/turf/simulated/mineral/floor/ignore_mapgen,
/area/submap/KururakDen)
"g" = (
/obj/random/junk,
/obj/random/medical/pillbottle,
/turf/simulated/mineral/floor/ignore_mapgen,
/area/submap/KururakDen)
"h" = (
/obj/random/junk,
/turf/simulated/mineral/floor/ignore_mapgen,
/area/submap/KururakDen)
"i" = (
/obj/random/powercell,
/obj/random/unidentified_medicine/old_medicine,
/obj/random/trash,
/turf/simulated/mineral/floor/ignore_mapgen,
/area/submap/KururakDen)
"j" = (
/obj/random/humanoidremains,
/obj/random/coin,
/obj/random/contraband,
/obj/random/projectile/random,
/turf/simulated/mineral/floor/ignore_mapgen,
/area/submap/KururakDen)

(1,1,1) = {"
a
a
a
a
a
a
a
a
a
a
"}
(2,1,1) = {"
a
a
a
a
a
b
b
b
b
a
"}
(3,1,1) = {"
a
a
a
b
c
h
f
b
b
a
"}
(4,1,1) = {"
a
a
b
b
b
d
c
d
b
a
"}
(5,1,1) = {"
a
a
b
b
g
c
e
j
b
a
"}
(6,1,1) = {"
a
b
b
f
d
c
f
b
b
a
"}
(7,1,1) = {"
a
b
b
b
c
i
b
b
b
a
"}
(8,1,1) = {"
a
a
b
b
c
b
b
a
a
a
"}
(9,1,1) = {"
a
a
a
a
a
a
a
a
a
a
"}
(10,1,1) = {"
a
a
a
a
a
a
a
a
a
a
"}
