//MAP CONVERTED BY dmm2tgm.py THIS HEADER COMMENT PREVENTS RECONVERSION, DO NOT REMOVE
"a" = (
/turf/template_noop,
/area/template_noop)
"b" = (
/turf/template_noop,
/area/submap/Lab1)
"c" = (
/turf/simulated/wall/r_wall,
/area/submap/Lab1)
"d" = (
/obj/structure/grille,
/obj/structure/window/reinforced{
	dir = 1
	},
/obj/structure/window/reinforced,
/obj/machinery/door/firedoor/border_only,
/obj/structure/window/reinforced{
	dir = 8
	},
/turf/simulated/floor/plating,
/area/submap/Lab1)
"e" = (
/obj/structure/grille,
/obj/structure/window/reinforced{
	dir = 1
	},
/obj/structure/window/reinforced,
/obj/machinery/door/firedoor/border_only,
/turf/simulated/floor/plating,
/area/submap/Lab1)
"f" = (
/obj/structure/grille,
/obj/structure/window/reinforced{
	dir = 1
	},
/obj/structure/window/reinforced,
/obj/structure/window/reinforced{
	dir = 4
	},
/obj/machinery/door/firedoor/border_only,
/turf/simulated/floor/plating,
/area/submap/Lab1)
"g" = (
/obj/machinery/space_heater,
/turf/simulated/floor/tiled/steel_dirty,
/area/submap/Lab1)
"h" = (
/turf/simulated/floor/tiled/steel_dirty,
/area/submap/Lab1)
"i" = (
/obj/machinery/door/airlock,
/turf/simulated/floor/tiled/steel_dirty,
/area/submap/Lab1)
"j" = (
/obj/machinery/light/small,
/turf/simulated/floor/tiled/steel_dirty,
/area/submap/Lab1)
"k" = (
/obj/structure/table/standard,
/obj/item/weapon/storage/toolbox,
/obj/random/tool,
/turf/simulated/floor/tiled/steel_dirty,
/area/submap/Lab1)
"l" = (
/obj/machinery/door/airlock/external,
/turf/simulated/floor/tiled/steel_dirty,
/area/submap/Lab1)
"m" = (
/obj/structure/table/standard,
/obj/random/tool,
/turf/simulated/floor/tiled/steel_dirty,
/area/submap/Lab1)
"n" = (
/obj/machinery/vending/tool,
/obj/machinery/light{
	dir = 4;
	icon_state = "tube1"
	},
/turf/simulated/floor/tiled/steel_dirty,
/area/submap/Lab1)
"o" = (
/obj/structure/table/rack,
/obj/item/clothing/suit/storage/hooded/wintercoat,
/obj/item/clothing/shoes/boots/winter,
/obj/machinery/light{
	icon_state = "tube1";
	dir = 8
	},
/turf/simulated/floor/tiled/steel_dirty,
/area/submap/Lab1)
"p" = (
/obj/structure/table/rack,
/obj/item/clothing/suit/storage/hooded/wintercoat,
/obj/item/clothing/shoes/boots/winter,
/turf/simulated/floor/tiled/steel_dirty,
/area/submap/Lab1)
"q" = (
/obj/structure/table/standard,
/obj/random/toolbox,
/obj/item/weapon/cell/super,
/turf/simulated/floor/tiled/steel_dirty,
/area/submap/Lab1)
"r" = (
/obj/structure/closet/toolcloset,
/turf/simulated/floor/tiled/steel_dirty,
/area/submap/Lab1)
"s" = (
/obj/machinery/light/small{
	dir = 8
	},
/turf/simulated/floor/tiled/steel_dirty,
/area/submap/Lab1)
"t" = (
/obj/structure/bed,
/obj/item/weapon/bedsheet,
/turf/simulated/floor/tiled/steel_dirty,
/area/submap/Lab1)
"u" = (
/obj/machinery/power/apc{
	cell_type = /obj/item/weapon/cell/hyper;
	dir = 8;
	name = "Unknown APC";
	operating = 0;
	pixel_x = -24
	},
/obj/structure/cable{
	icon_state = "0-4";
	d2 = 4
	},
/turf/simulated/floor/tiled/steel_dirty,
/area/submap/Lab1)
"v" = (
/obj/machinery/power/terminal{
	dir = 4
	},
/obj/structure/cable{
	d2 = 8;
	icon_state = "0-8"
	},
/turf/simulated/floor/tiled/steel_dirty,
/area/submap/Lab1)
"w" = (
/obj/machinery/power/smes/buildable/point_of_interest,
/turf/simulated/floor/tiled/steel_dirty,
/area/submap/Lab1)
"x" = (
/obj/structure/table/standard,
/obj/item/weapon/paper{
	desc = "Gladstone for the last fucking time, We have crowbars for a REASON. Stop breaking in through the goddamn windows! We big red shiny doors for god's sakes!"
	},
/turf/simulated/floor/tiled/steel_dirty,
/area/submap/Lab1)
"y" = (
/obj/structure/table/standard,
/obj/item/device/flashlight/lamp,
/turf/simulated/floor/tiled/steel_dirty,
/area/submap/Lab1)
"z" = (
/turf/simulated/floor,
/area/submap/Lab1)
"A" = (
/obj/machinery/vending/hydronutrients,
/turf/simulated/floor/tiled/steel_dirty,
/area/submap/Lab1)
"B" = (
/obj/machinery/vending/hydroseeds,
/turf/simulated/floor/tiled/steel_dirty,
/area/submap/Lab1)
"C" = (
/obj/machinery/light/small{
	dir = 4
	},
/turf/simulated/floor/tiled/steel_dirty,
/area/submap/Lab1)
"D" = (
/obj/structure/table/standard,
/obj/item/weapon/storage/toolbox/mechanical,
/turf/simulated/floor/tiled/steel_dirty,
/area/submap/Lab1)
"E" = (
/obj/structure/table/standard,
/obj/fiftyspawner/steel,
/obj/fiftyspawner/glass,
/turf/simulated/floor/tiled/steel_dirty,
/area/submap/Lab1)
"F" = (
/obj/structure/table/standard,
/obj/item/device/multitool,
/obj/item/clothing/glasses/welding,
/turf/simulated/floor/tiled/steel_dirty,
/area/submap/Lab1)
"G" = (
/obj/machinery/portable_atmospherics/hydroponics,
/turf/simulated/floor/tiled/steel_dirty,
/area/submap/Lab1)
"H" = (
/obj/structure/sink{
	dir = 4;
	icon_state = "sink";
	pixel_x = 11;
	pixel_y = 0
	},
/turf/simulated/floor/tiled/steel_dirty,
/area/submap/Lab1)
"I" = (
/obj/machinery/light{
	icon_state = "tube1";
	dir = 8
	},
/turf/simulated/floor/tiled/steel_dirty,
/area/submap/Lab1)
"J" = (
/obj/item/weapon/cell/super,
/turf/simulated/floor/tiled/steel_dirty,
/area/submap/Lab1)
"K" = (
/obj/machinery/pros_fabricator,
/turf/simulated/floor/tiled/steel_dirty,
/area/submap/Lab1)
"L" = (
/obj/machinery/portable_atmospherics/hydroponics,
/obj/machinery/light{
	icon_state = "tube1";
	dir = 8
	},
/turf/simulated/floor/tiled/steel_dirty,
/area/submap/Lab1)
"M" = (
/obj/machinery/light{
	dir = 4;
	icon_state = "tube1"
	},
/turf/simulated/floor/tiled/steel_dirty,
/area/submap/Lab1)
"N" = (
/obj/item/weapon/storage/bag/circuits,
/obj/structure/table/standard,
/turf/simulated/floor/tiled/steel_dirty,
/area/submap/Lab1)
"O" = (
/obj/machinery/light/small{
	dir = 1
	},
/turf/simulated/floor/tiled/steel_dirty,
/area/submap/Lab1)
"P" = (
/obj/item/robot_parts/chest,
/obj/item/robot_parts/l_arm,
/obj/item/robot_parts/r_arm,
/turf/simulated/floor/tiled/steel_dirty,
/area/submap/Lab1)
"Q" = (
/obj/structure/closet/crate/hydroponics,
/turf/simulated/floor/tiled/steel_dirty,
/area/submap/Lab1)
"R" = (
/obj/structure/closet/secure_closet/hydroponics,
/turf/simulated/floor/tiled/steel_dirty,
/area/submap/Lab1)
"S" = (
/obj/structure/table/standard,
/obj/item/seeds/ambrosiavulgarisseed,
/turf/simulated/floor/tiled/steel_dirty,
/area/submap/Lab1)
"T" = (
/obj/machinery/vending/robotics,
/turf/simulated/floor/tiled/steel_dirty,
/area/submap/Lab1)
"U" = (
/obj/structure/table/standard,
/obj/machinery/cell_charger,
/turf/simulated/floor/tiled/steel_dirty,
/area/submap/Lab1)
"V" = (
/obj/machinery/optable,
/turf/simulated/floor/tiled/steel_dirty,
/area/submap/Lab1)

(1,1,1) = {"
a
a
a
a
a
a
a
a
a
a
a
a
a
a
a
a
a
a
a
a
"}
(2,1,1) = {"
a
b
c
c
c
c
c
c
c
b
b
c
c
c
c
c
c
c
b
a
"}
(3,1,1) = {"
a
b
d
g
k
m
q
u
d
b
b
d
h
G
L
G
Q
d
b
a
"}
(4,1,1) = {"
a
b
e
h
h
h
h
v
e
b
b
e
A
h
h
h
R
e
b
a
"}
(5,1,1) = {"
a
b
f
h
g
n
r
w
f
b
b
f
B
H
M
h
S
f
b
a
"}
(6,1,1) = {"
a
b
c
i
c
c
c
c
c
b
b
c
c
c
c
i
c
c
b
a
"}
(7,1,1) = {"
a
b
d
h
d
b
b
b
b
b
b
b
b
b
d
h
d
b
b
a
"}
(8,1,1) = {"
a
b
e
h
f
b
b
b
b
b
b
b
b
b
f
h
e
b
b
a
"}
(9,1,1) = {"
a
b
e
j
c
c
c
c
c
b
b
c
c
c
c
O
e
b
b
a
"}
(10,1,1) = {"
a
b
e
h
l
h
s
h
l
z
z
l
h
h
l
h
e
b
b
a
"}
(11,1,1) = {"
a
b
e
h
l
h
h
h
l
z
z
l
C
h
l
h
e
b
b
a
"}
(12,1,1) = {"
a
b
e
j
c
c
c
c
c
b
b
c
c
c
c
O
e
b
b
a
"}
(13,1,1) = {"
a
b
e
h
d
b
b
b
b
b
b
b
b
b
d
h
e
b
b
a
"}
(14,1,1) = {"
a
b
f
h
f
b
b
b
b
b
b
b
b
b
f
h
f
b
b
a
"}
(15,1,1) = {"
a
b
c
i
c
c
c
c
c
b
b
c
c
c
c
i
c
c
b
a
"}
(16,1,1) = {"
a
b
d
h
h
o
t
x
d
b
b
d
D
I
h
h
T
d
b
a
"}
(17,1,1) = {"
a
b
e
h
h
h
h
h
e
b
b
e
E
J
h
h
U
e
b
a
"}
(18,1,1) = {"
a
b
f
h
h
p
t
y
f
b
b
f
F
K
N
P
V
f
b
a
"}
(19,1,1) = {"
a
b
c
c
c
c
c
c
c
b
b
c
c
c
c
c
c
c
b
a
"}
(20,1,1) = {"
a
a
a
a
a
a
a
a
a
a
a
a
a
a
a
a
a
a
a
a
"}
