"a" = (/turf/template_noop,/area/template_noop)
"b" = (/turf/template_noop,/area/submap/MilitaryCamp1)
"c" = (/turf/simulated/floor/outdoors/dirt,/area/submap/MilitaryCamp1)
"d" = (/turf/simulated/floor/outdoors/grass/sif/forest,/area/submap/MilitaryCamp1)
"e" = (/obj/effect/mine,/turf/simulated/floor/outdoors/grass/sif/forest,/area/submap/MilitaryCamp1)
"f" = (/obj/structure/flora/bush,/turf/simulated/floor/outdoors/grass/sif/forest,/area/submap/MilitaryCamp1)
"g" = (/obj/effect/decal/cleanable/blood,/turf/simulated/floor/outdoors/grass/sif/forest,/area/submap/MilitaryCamp1)
"h" = (/obj/effect/decal/remains,/turf/simulated/floor/outdoors/dirt,/area/submap/MilitaryCamp1)
"i" = (/obj/structure/flora/tree/sif,/turf/simulated/floor/outdoors/grass/sif/forest,/area/submap/MilitaryCamp1)
"j" = (/obj/item/stack/rods,/turf/simulated/floor/outdoors/grass/sif/forest,/area/submap/MilitaryCamp1)
"k" = (/obj/effect/mine,/turf/simulated/floor/outdoors/dirt,/area/submap/MilitaryCamp1)
"l" = (/turf/simulated/wall,/area/submap/MilitaryCamp1)
"m" = (/turf/simulated/floor,/area/submap/MilitaryCamp1)
"n" = (/obj/item/weapon/material/shard,/turf/simulated/floor/outdoors/grass/sif/forest,/area/submap/MilitaryCamp1)
"o" = (/mob/living/simple_animal/hostile/viscerator{returns_home = 1},/turf/simulated/floor,/area/submap/MilitaryCamp1)
"p" = (/obj/structure/girder,/turf/simulated/floor,/area/submap/MilitaryCamp1)
"q" = (/obj/machinery/computer/communications,/mob/living/simple_animal/hostile/viscerator{returns_home = 1},/mob/living/simple_animal/hostile/viscerator{returns_home = 1},/turf/simulated/floor,/area/submap/MilitaryCamp1)
"r" = (/obj/structure/table/standard,/mob/living/simple_animal/hostile/viscerator{returns_home = 1},/mob/living/simple_animal/hostile/viscerator{returns_home = 1},/turf/simulated/floor,/area/submap/MilitaryCamp1)
"s" = (/obj/effect/mine,/turf/simulated/floor,/area/submap/MilitaryCamp1)
"t" = (/obj/effect/decal/cleanable/dirt,/turf/simulated/floor,/area/submap/MilitaryCamp1)
"u" = (/obj/machinery/computer/security,/mob/living/simple_animal/hostile/viscerator{returns_home = 1},/mob/living/simple_animal/hostile/viscerator{returns_home = 1},/turf/simulated/floor,/area/submap/MilitaryCamp1)
"v" = (/mob/living/simple_animal/hostile/viscerator{returns_home = 1},/mob/living/simple_animal/hostile/viscerator{returns_home = 1},/turf/simulated/floor,/area/submap/MilitaryCamp1)
"w" = (/obj/machinery/door/airlock,/turf/simulated/floor,/area/submap/MilitaryCamp1)
"x" = (/obj/effect/decal/cleanable/dirt,/mob/living/simple_animal/hostile/viscerator{returns_home = 1},/turf/simulated/floor,/area/submap/MilitaryCamp1)
"y" = (/mob/living/simple_animal/hostile/viscerator{returns_home = 1},/turf/simulated/floor/outdoors/grass/sif/forest,/area/submap/MilitaryCamp1)
"z" = (/obj/structure/table,/turf/simulated/floor,/area/submap/MilitaryCamp1)
"A" = (/obj/structure/table/standard,/obj/random/firstaid,/turf/simulated/floor,/area/submap/MilitaryCamp1)
"B" = (/obj/machinery/door/airlock,/obj/effect/mine,/turf/simulated/floor,/area/submap/MilitaryCamp1)
"C" = (/obj/structure/flora/tree/dead,/turf/simulated/floor/outdoors/grass/sif/forest,/area/submap/MilitaryCamp1)
"D" = (/obj/structure/table/standard,/obj/item/weapon/gun/projectile/automatic/c20r,/turf/simulated/floor,/area/submap/MilitaryCamp1)
"E" = (/obj/structure/table/standard,/obj/item/weapon/gun/energy/gun,/turf/simulated/floor,/area/submap/MilitaryCamp1)
"F" = (/obj/effect/mine,/turf/template_noop,/area/submap/MilitaryCamp1)

(1,1,1) = {"
aaaaaaaaaaaaaaaaaaaa
abbcdedfgedddbbbbbba
achcdddddddgedchbbba
adccddeddijdddcckiba
adiddjllmmllmlncddda
abdddlllmmllllldedea
abbellommplqrolldfda
abbdllopstluvvllddda
abdnllwllxlllwlpyeda
adddmlommtmoxtllddda
agedmlommzAottlldeda
adddplwBllllwwlpdCda
addyllomptttoollddda
aCddllDElmmooollndga
addfdllllwmlllldedda
abedddllltmllldcceda
abcddddlldnlldkcddba
achcedddeedjddchibba
abccfbFdigddeccdbbba
aaaaaaaaaaaaaaaaaaaa
"}
