"a" = (/turf/template_noop,/area/template_noop)
"b" = (/turf/template_noop,/area/submap/MHR)
"c" = (/obj/structure/flora/tree/sif,/turf/template_noop,/area/submap/MHR)
"d" = (/turf/simulated/floor/outdoors/dirt{outdoors = 0},/area/submap/MHR)
"e" = (/turf/simulated/mineral/ignore_mapgen,/area/submap/MHR)
"f" = (/obj/effect/decal/cleanable/spiderling_remains,/turf/simulated/floor/outdoors/dirt{outdoors = 0},/area/submap/MHR)
"g" = (/turf/simulated/floor/outdoors/dirt,/area/submap/MHR)
"h" = (/obj/structure/table/rack,/obj/item/storage/backpack,/turf/template_noop,/area/submap/MHR)
"i" = (/obj/structure/table/standard,/turf/template_noop,/area/submap/MHR)
"j" = (/obj/structure/table/standard,/obj/item/paper{info = "Do not enter the cave. The estimated active time of the Vicerators is much longer due to the improvements on the rotor bearings. It's estimated to be roughly a few months before we start to see any chancces of mechanical failure. "; name = "NOTICE: DO NOT ENTER"},/turf/template_noop,/area/submap/MHR)
"k" = (/obj/effect/decal/cleanable/cobweb2,/turf/simulated/floor/outdoors/dirt{outdoors = 0},/area/submap/MHR)
"l" = (/mob/living/simple_mob/mechanical/viscerator,/turf/simulated/floor/outdoors/dirt{outdoors = 0},/area/submap/MHR)
"m" = (/obj/item/reagent_containers/food/snacks/xenomeat/spidermeat,/turf/simulated/floor/outdoors/dirt{outdoors = 0},/area/submap/MHR)
"n" = (/obj/effect/decal/cleanable/cobweb2,/mob/living/simple_mob/mechanical/viscerator,/turf/simulated/floor/outdoors/dirt{outdoors = 0},/area/submap/MHR)
"o" = (/obj/effect/decal/cleanable/cobweb,/turf/simulated/floor/outdoors/dirt{outdoors = 0},/area/submap/MHR)
"p" = (/obj/effect/decal/cleanable/spiderling_remains,/obj/effect/decal/cleanable/cobweb,/turf/simulated/floor/outdoors/dirt{outdoors = 0},/area/submap/MHR)
"q" = (/obj/effect/decal/remains/robot,/turf/simulated/floor/outdoors/dirt{outdoors = 0},/area/submap/MHR)
"r" = (/obj/effect/decal/remains,/obj/item/clothing/mask/gas/explorer,/obj/item/material/twohanded/fireaxe,/turf/simulated/floor/outdoors/dirt{outdoors = 0},/area/submap/MHR)
"s" = (/obj/effect/decal/cleanable/spiderling_remains,/mob/living/simple_mob/mechanical/viscerator,/turf/simulated/floor/outdoors/dirt{outdoors = 0},/area/submap/MHR)

(1,1,1) = {"
aaaaaaaaaaaaaaaaaaaa
abcbbbbbbbbbbdbeeeca
abbbbbbbbbbdddfeeeea
abbbbbbbbbbdfddgeeea
abbbbbhijeeeedddeeea
abbbbeeeeeeeeeddeeea
abbbeeeeeeeeeeddeeea
acbeeeeeeeeeeeddeeea
abeeeeeeeeeeedddkeea
abeeeeelmneeoddddeea
abeeepllldqfdddddeea
abeeeldldlddddddreea
abeeedldfdddddddeeea
abbeellllddmddqeeeea
abbeeeseedldddeeeeba
abbeeeeeeeeeeeeeebba
abbbeeeeeeeeeeeeebba
acbbbeeeeeeeebbbbbba
abbbbcbbbbbbbbbbbbca
aaaaaaaaaaaaaaaaaaaa
"}