"aa" = (/mob/living/simple_animal/hostile/viscerator{returns_home = 1},/turf/template_noop,/area/template_noop)
"ab" = (/turf/template_noop,/area/template_noop)
"ac" = (/obj/effect/decal/remains,/turf/template_noop,/area/submap/Rockybase)
"ad" = (/turf/template_noop,/area/submap/Rockybase)
"ae" = (/obj/structure/flora/tree/sif,/turf/template_noop,/area/submap/Rockybase)
"af" = (/turf/simulated/mineral/ignore_mapgen,/area/submap/Rockybase)
"ag" = (/mob/living/simple_animal/hostile/malf_drone/lesser,/turf/template_noop,/area/submap/Rockybase)
"ah" = (/turf/simulated/floor,/area/submap/Rockybase)
"ai" = (/obj/machinery/porta_turret/stationary,/turf/simulated/floor,/area/submap/Rockybase)
"aj" = (/obj/effect/decal/cleanable/blood,/turf/simulated/floor,/area/submap/Rockybase)
"ak" = (/obj/structure/flora/tree/sif,/turf/template_noop,/area/template_noop)
"al" = (/obj/effect/floor_decal/industrial/danger,/turf/simulated/floor,/area/submap/Rockybase)
"am" = (/obj/machinery/light,/obj/effect/floor_decal/industrial/danger,/turf/simulated/floor,/area/submap/Rockybase)
"an" = (/obj/effect/decal/cleanable/blood,/obj/effect/floor_decal/industrial/danger,/turf/simulated/floor,/area/submap/Rockybase)
"ao" = (/turf/simulated/wall/r_wall,/area/submap/Rockybase)
"ap" = (/obj/structure/sign/securearea,/turf/simulated/wall/r_wall,/area/submap/Rockybase)
"aq" = (/obj/machinery/door/airlock/external,/turf/simulated/floor/tiled,/area/submap/Rockybase)
"ar" = (/obj/machinery/shower{dir = 4; icon_state = "shower"; pixel_x = 5; pixel_y = 0},/obj/structure/curtain/open/shower,/obj/machinery/light/small{dir = 8},/turf/simulated/floor/tiled/hydro,/area/submap/Rockybase)
"as" = (/turf/simulated/floor/tiled/hydro,/area/submap/Rockybase)
"at" = (/obj/machinery/shower{dir = 8; icon_state = "shower"; pixel_x = -5; pixel_y = 0},/obj/structure/curtain/open/shower,/obj/item/weapon/soap,/turf/simulated/floor/tiled/hydro,/area/submap/Rockybase)
"au" = (/obj/structure/table/woodentable,/obj/effect/decal/cleanable/cobweb,/turf/simulated/floor/holofloor/lino,/area/submap/Rockybase)
"av" = (/obj/structure/table/woodentable,/turf/simulated/floor/holofloor/lino,/area/submap/Rockybase)
"aw" = (/obj/structure/table/woodentable,/obj/item/device/flashlight/lamp,/turf/simulated/floor/holofloor/lino,/area/submap/Rockybase)
"ax" = (/obj/structure/closet{icon_closed = "cabinet_closed"; icon_opened = "cabinet_open"; icon_state = "cabinet_closed"},/turf/simulated/floor/holofloor/lino,/area/submap/Rockybase)
"ay" = (/turf/simulated/floor/holofloor/lino,/area/submap/Rockybase)
"az" = (/obj/structure/bed,/obj/item/weapon/bedsheet,/turf/simulated/floor/holofloor/lino,/area/submap/Rockybase)
"aA" = (/obj/structure/table/woodentable,/obj/machinery/light{dir = 1},/turf/simulated/floor/holofloor/lino,/area/submap/Rockybase)
"aB" = (/obj/structure/bed,/obj/item/weapon/bedsheet,/mob/living/simple_animal/hostile/viscerator{returns_home = 1},/turf/simulated/floor/holofloor/lino,/area/submap/Rockybase)
"aC" = (/obj/structure/bed,/obj/item/weapon/bedsheet,/obj/item/toy/plushie/spider,/turf/simulated/floor/holofloor/lino,/area/submap/Rockybase)
"aD" = (/obj/structure/closet/l3closet/janitor,/turf/simulated/floor/tiled,/area/submap/Rockybase)
"aE" = (/mob/living/bot/cleanbot{faction = "malf_drone"},/turf/simulated/floor/tiled,/area/submap/Rockybase)
"aF" = (/obj/item/weapon/stool,/turf/simulated/floor/tiled,/area/submap/Rockybase)
"aG" = (/obj/item/weapon/storage/belt/janitor,/obj/structure/table/standard,/turf/simulated/floor/tiled,/area/submap/Rockybase)
"aH" = (/turf/simulated/floor/tiled,/area/submap/Rockybase)
"aI" = (/obj/structure/table/standard,/obj/item/device/laptop,/obj/effect/floor_decal/corner/red/border{tag = "icon-bordercolor (NORTHWEST)"; icon_state = "bordercolor"; dir = 9},/turf/simulated/floor/tiled,/area/submap/Rockybase)
"aJ" = (/obj/structure/table/standard,/obj/effect/floor_decal/corner/red/border{tag = "icon-bordercolor (NORTH)"; icon_state = "bordercolor"; dir = 1},/turf/simulated/floor/tiled,/area/submap/Rockybase)
"aK" = (/obj/structure/table/rack,/obj/item/weapon/gun/projectile/pistol,/obj/effect/floor_decal/corner/red/border{tag = "icon-bordercolor (NORTH)"; icon_state = "bordercolor"; dir = 1},/turf/simulated/floor/tiled,/area/submap/Rockybase)
"aL" = (/obj/structure/table/rack,/obj/item/weapon/gun/energy/gun/taser,/obj/effect/floor_decal/corner/red/border{tag = "icon-bordercolor (NORTH)"; icon_state = "bordercolor"; dir = 1},/turf/simulated/floor/tiled,/area/submap/Rockybase)
"aM" = (/obj/machinery/light{dir = 1},/obj/effect/floor_decal/corner/red/border{tag = "icon-bordercolor (NORTH)"; icon_state = "bordercolor"; dir = 1},/turf/simulated/floor/tiled,/area/submap/Rockybase)
"aN" = (/obj/machinery/vending/coffee,/obj/effect/floor_decal/corner/red/border{tag = "icon-bordercolor (NORTHEAST)"; icon_state = "bordercolor"; dir = 5},/turf/simulated/floor/tiled,/area/submap/Rockybase)
"aO" = (/turf/simulated/floor/tiled/techfloor,/area/submap/Rockybase)
"aP" = (/obj/structure/table/rack,/obj/item/weapon/gun/projectile/shotgun/pump/combat,/obj/item/weapon/gun/projectile/shotgun/pump/combat,/turf/simulated/floor/tiled/techfloor,/area/submap/Rockybase)
"aQ" = (/obj/machinery/vending/hydronutrients,/obj/effect/floor_decal/corner/lime/border{tag = "icon-bordercolor (NORTHWEST)"; icon_state = "bordercolor"; dir = 9},/turf/simulated/floor/tiled,/area/submap/Rockybase)
"aR" = (/obj/structure/closet/crate/hydroponics,/obj/effect/floor_decal/corner/lime/border{tag = "icon-bordercolor (NORTHEAST)"; icon_state = "bordercolor"; dir = 5},/turf/simulated/floor/tiled,/area/submap/Rockybase)
"aS" = (/obj/machinery/shower{dir = 4; icon_state = "shower"; pixel_x = 5; pixel_y = 0},/obj/structure/curtain/open/shower,/turf/simulated/floor/tiled/hydro,/area/submap/Rockybase)
"aT" = (/obj/machinery/shower{dir = 8; icon_state = "shower"; pixel_x = -5; pixel_y = 0},/obj/structure/curtain/open/shower,/turf/simulated/floor/tiled/hydro,/area/submap/Rockybase)
"aU" = (/obj/structure/janitorialcart,/turf/simulated/floor/tiled,/area/submap/Rockybase)
"aV" = (/obj/structure/table/standard,/obj/item/weapon/grenade/chem_grenade/cleaner,/obj/item/weapon/grenade/chem_grenade/cleaner,/obj/item/weapon/grenade/chem_grenade/cleaner,/obj/machinery/light{icon_state = "tube1"; dir = 4},/turf/simulated/floor/tiled,/area/submap/Rockybase)
"aW" = (/obj/machinery/light/small{dir = 8},/turf/simulated/floor/tiled,/area/submap/Rockybase)
"aX" = (/obj/structure/table/standard,/obj/item/weapon/paper{info = "Carl's absolutly fucked in the head. He's trying to squeeze as much drone production out as he can since he's worried we're gonna get found out but he's getting sloppier with each batch. Now's he's telling us he can speed the time on the IFF encoding. I already have a hard enough time getting these damn things not to stare at walls and now he's gonna shortchange the only part of these tincans that tells em not to turn us into paste on a wall. I told Richter to get out while he can, We're counting days before either some Sif task force shows up at our door or these things decide we aren't there friends anymore."; name = "Note"},/obj/effect/floor_decal/corner/red/border{tag = "icon-bordercolor (WEST)"; icon_state = "bordercolor"; dir = 8},/turf/simulated/floor/tiled,/area/submap/Rockybase)
"aY" = (/obj/structure/bed/chair{dir = 8},/turf/simulated/floor/tiled,/area/submap/Rockybase)
"aZ" = (/mob/living/simple_animal/hostile/viscerator{returns_home = 1},/turf/simulated/floor/tiled,/area/submap/Rockybase)
"ba" = (/obj/machinery/vending/security,/obj/effect/floor_decal/corner/red/border{tag = "icon-bordercolor (EAST)"; icon_state = "bordercolor"; dir = 4},/turf/simulated/floor/tiled,/area/submap/Rockybase)
"bb" = (/obj/structure/table/rack,/obj/item/weapon/storage/box/shotgunshells,/obj/item/weapon/storage/box/shotgunshells,/obj/item/weapon/storage/box/shotgunshells,/obj/item/ammo_magazine/m10mm,/obj/item/ammo_magazine/m10mm,/obj/item/ammo_magazine/m10mm,/turf/simulated/floor/tiled/techfloor,/area/submap/Rockybase)
"bc" = (/obj/effect/floor_decal/corner/lime/border{tag = "icon-bordercolor (WEST)"; icon_state = "bordercolor"; dir = 8},/turf/simulated/floor/tiled,/area/submap/Rockybase)
"bd" = (/obj/structure/sink{dir = 4; icon_state = "sink"; pixel_x = 11; pixel_y = 0},/obj/effect/floor_decal/corner/lime/border{tag = "icon-bordercolor (EAST)"; icon_state = "bordercolor"; dir = 4},/turf/simulated/floor/tiled,/area/submap/Rockybase)
"be" = (/obj/machinery/shower{dir = 8; icon_state = "shower"; pixel_x = -5; pixel_y = 0},/obj/structure/curtain/open/shower,/obj/machinery/light/small{dir = 4; pixel_y = 0},/turf/simulated/floor/tiled/hydro,/area/submap/Rockybase)
"bf" = (/obj/item/mecha_parts/part/gygax_left_leg,/turf/simulated/floor/holofloor/lino,/area/submap/Rockybase)
"bg" = (/obj/machinery/light,/turf/simulated/floor/holofloor/lino,/area/submap/Rockybase)
"bh" = (/obj/structure/bed,/obj/item/weapon/bedsheet,/obj/item/weapon/gun/projectile/pistol,/turf/simulated/floor/holofloor/lino,/area/submap/Rockybase)
"bi" = (/obj/structure/closet/crate/trashcart,/turf/simulated/floor/tiled,/area/submap/Rockybase)
"bj" = (/obj/structure/loot_pile/maint/trash,/turf/simulated/floor/tiled,/area/submap/Rockybase)
"bk" = (/obj/structure/table/standard,/obj/item/weapon/storage/bag/trash,/obj/item/weapon/storage/bag/trash,/turf/simulated/floor/tiled,/area/submap/Rockybase)
"bl" = (/obj/structure/table/standard,/obj/item/weapon/paper_bin,/obj/effect/floor_decal/corner/red/border{tag = "icon-bordercolor (SOUTHWEST)"; icon_state = "bordercolor"; dir = 10},/turf/simulated/floor/tiled,/area/submap/Rockybase)
"bm" = (/obj/machinery/light,/obj/structure/table/standard,/obj/item/weapon/pen,/obj/effect/floor_decal/corner/red/border,/turf/simulated/floor/tiled,/area/submap/Rockybase)
"bn" = (/obj/effect/floor_decal/corner/red/border,/turf/simulated/floor/tiled,/area/submap/Rockybase)
"bo" = (/obj/effect/floor_decal/corner/red/border,/mob/living/simple_animal/hostile/viscerator{returns_home = 1},/turf/simulated/floor/tiled,/area/submap/Rockybase)
"bp" = (/obj/machinery/door/airlock/security{icon_state = "door_locked"; locked = 1},/turf/simulated/floor/tiled/techfloor,/area/submap/Rockybase)
"bq" = (/obj/machinery/light,/turf/simulated/floor/tiled/techfloor,/area/submap/Rockybase)
"br" = (/obj/structure/table/rack,/obj/item/weapon/gun/projectile/automatic/c20r,/obj/item/weapon/gun/projectile/automatic/c20r,/turf/simulated/floor/tiled/techfloor,/area/submap/Rockybase)
"bs" = (/obj/machinery/portable_atmospherics/hydroponics,/obj/effect/floor_decal/corner/lime/border{tag = "icon-bordercolor (EAST)"; icon_state = "bordercolor"; dir = 4},/turf/simulated/floor/tiled,/area/submap/Rockybase)
"bt" = (/obj/machinery/door/airlock,/turf/simulated/floor/tiled,/area/submap/Rockybase)
"bu" = (/obj/effect/floor_decal/corner/lime/border{tag = "icon-bordercolor (WEST)"; icon_state = "bordercolor"; dir = 8},/mob/living/bot/farmbot{faction = "malf_drone"; name = "Mr. Weddleton"},/turf/simulated/floor/tiled,/area/submap/Rockybase)
"bv" = (/obj/machinery/portable_atmospherics/hydroponics,/obj/machinery/light{icon_state = "tube1"; dir = 4},/obj/effect/floor_decal/corner/lime/border{tag = "icon-bordercolor (EAST)"; icon_state = "bordercolor"; dir = 4},/turf/simulated/floor/tiled,/area/submap/Rockybase)
"bw" = (/obj/machinery/vending/cola,/obj/effect/floor_decal/borderfloor{dir = 1},/turf/simulated/floor/tiled,/area/submap/Rockybase)
"bx" = (/obj/effect/floor_decal/borderfloor{dir = 1},/turf/simulated/floor/tiled,/area/submap/Rockybase)
"by" = (/obj/machinery/light{dir = 1},/obj/effect/floor_decal/borderfloor{dir = 1},/turf/simulated/floor/tiled,/area/submap/Rockybase)
"bz" = (/obj/structure/door_assembly,/obj/effect/floor_decal/borderfloor{dir = 1},/turf/simulated/floor/tiled,/area/submap/Rockybase)
"bA" = (/obj/effect/decal/cleanable/dirt,/obj/effect/floor_decal/borderfloor{dir = 1},/turf/simulated/floor/tiled,/area/submap/Rockybase)
"bB" = (/obj/effect/decal/cleanable/dirt,/obj/effect/decal/cleanable/cobweb2,/obj/effect/floor_decal/borderfloor{dir = 1},/turf/simulated/floor/tiled,/area/submap/Rockybase)
"bC" = (/mob/living/simple_animal/hostile/malf_drone/lesser,/turf/simulated/floor/tiled,/area/submap/Rockybase)
"bD" = (/obj/effect/decal/cleanable/dirt,/turf/simulated/floor/tiled,/area/submap/Rockybase)
"bE" = (/obj/effect/decal/cleanable/blood,/turf/simulated/floor/tiled,/area/submap/Rockybase)
"bF" = (/obj/effect/decal/remains,/turf/simulated/floor/tiled,/area/submap/Rockybase)
"bG" = (/obj/machinery/door/airlock,/turf/simulated/floor/tiled/hydro,/area/submap/Rockybase)
"bH" = (/obj/machinery/vending/snack,/obj/effect/floor_decal/borderfloor,/turf/simulated/floor/tiled,/area/submap/Rockybase)
"bI" = (/obj/effect/floor_decal/borderfloor,/turf/simulated/floor/tiled,/area/submap/Rockybase)
"bJ" = (/obj/effect/decal/cleanable/dirt,/obj/effect/floor_decal/borderfloor,/turf/simulated/floor/tiled,/area/submap/Rockybase)
"bK" = (/obj/item/stack/rods,/obj/structure/girder,/turf/simulated/floor/tiled,/area/submap/Rockybase)
"bL" = (/obj/effect/decal/remains,/obj/effect/floor_decal/borderfloor,/turf/simulated/floor/tiled,/area/submap/Rockybase)
"bM" = (/obj/machinery/light,/obj/effect/floor_decal/borderfloor,/turf/simulated/floor/tiled,/area/submap/Rockybase)
"bN" = (/obj/effect/decal/cleanable/blood,/obj/effect/floor_decal/borderfloor,/turf/simulated/floor/tiled,/area/submap/Rockybase)
"bO" = (/obj/item/mecha_parts/part/gygax_right_arm,/obj/effect/floor_decal/borderfloor,/turf/simulated/floor/tiled,/area/submap/Rockybase)
"bP" = (/obj/machinery/light/small{dir = 8},/turf/simulated/floor/tiled/hydro,/area/submap/Rockybase)
"bQ" = (/mob/living/simple_animal/hostile/viscerator{returns_home = 1},/turf/simulated/floor/tiled/hydro,/area/submap/Rockybase)
"bR" = (/obj/machinery/door/airlock/engineering,/turf/simulated/floor/tiled,/area/submap/Rockybase)
"bS" = (/obj/effect/floor_decal/rust,/turf/simulated/floor/tiled,/area/submap/Rockybase)
"bT" = (/turf/simulated/wall,/area/submap/Rockybase)
"bU" = (/obj/structure/table/standard,/obj/item/device/kit/paint/gygax/darkgygax,/turf/simulated/floor/tiled,/area/submap/Rockybase)
"bV" = (/obj/structure/table/standard,/obj/item/weapon/paper{info = "I've decided to go forward and start some small scale tests of the Vicerator delivery grenades, Might as wall make sure they work like the real ones. There are a few Fauna areas nearbye and we're working to make sure the kinks in the code are worked out. Once we've made sure they stay flying we'll work on the IFF signals."; name = "V-Grenade Notice 2"},/turf/simulated/floor/tiled,/area/submap/Rockybase)
"bW" = (/obj/structure/table/standard,/obj/random/toolbox,/obj/machinery/light{dir = 1},/turf/simulated/floor/tiled,/area/submap/Rockybase)
"bX" = (/obj/structure/table/standard,/obj/random/toolbox,/turf/simulated/floor/tiled,/area/submap/Rockybase)
"bY" = (/obj/structure/table/standard,/obj/item/weapon/paper{info = "We've finally been able to get the Vicerator delivery grenades working, Took awhile to make sure the latching mechanism didn't fail but we're sure we've got it this time. Vel'Shem's worried about the miners having there own drone fab now but I say it's a small price to pay to keep the metal flowing, Especially since there telling us NT's starting to monopolize the metal rich parts."; name = "V-Grenade Notice 1"},/turf/simulated/floor/tiled,/area/submap/Rockybase)
"bZ" = (/obj/structure/table/standard,/obj/item/stack/material/diamond,/obj/item/stack/material/diamond,/obj/item/stack/material/diamond,/obj/item/stack/material/diamond,/obj/item/stack/material/diamond,/obj/item/stack/material/diamond,/obj/item/stack/material/diamond,/obj/item/stack/material/diamond,/turf/simulated/floor/tiled,/area/submap/Rockybase)
"ca" = (/obj/structure/table/standard,/obj/item/weapon/grenade/spawnergrenade/manhacks,/turf/simulated/floor/tiled,/area/submap/Rockybase)
"cb" = (/obj/structure/table/standard,/obj/item/stack/material/steel,/turf/simulated/floor/tiled,/area/submap/Rockybase)
"cc" = (/obj/structure/table/standard,/obj/machinery/light{dir = 1},/obj/item/weapon/circuitboard/mecha/gygax/main,/obj/item/weapon/circuitboard/mecha/gygax/peripherals,/obj/item/weapon/circuitboard/mecha/gygax/targeting,/turf/simulated/floor/tiled,/area/submap/Rockybase)
"cd" = (/obj/structure/door_assembly,/obj/effect/floor_decal/rust,/turf/simulated/floor/tiled,/area/submap/Rockybase)
"ce" = (/obj/item/weapon/material/shard,/turf/simulated/floor,/area/submap/Rockybase)
"cf" = (/obj/structure/table/standard,/obj/fiftyspawner/rods,/turf/simulated/floor/tiled,/area/submap/Rockybase)
"cg" = (/obj/machinery/vending/engivend,/turf/simulated/floor/tiled,/area/submap/Rockybase)
"ch" = (/obj/machinery/vending/tool,/turf/simulated/floor/tiled,/area/submap/Rockybase)
"ci" = (/obj/structure/table/standard,/obj/item/weapon/storage/toolbox,/turf/simulated/floor/tiled,/area/submap/Rockybase)
"cj" = (/obj/structure/table/standard,/obj/item/weapon/storage/toolbox/mechanical,/turf/simulated/floor/tiled,/area/submap/Rockybase)
"ck" = (/obj/item/mecha_parts/part/gygax_torso,/turf/simulated/floor/tiled,/area/submap/Rockybase)
"cl" = (/obj/machinery/light{dir = 1},/obj/structure/closet/crate/medical,/turf/simulated/floor/tiled,/area/submap/Rockybase)
"cm" = (/obj/structure/table/standard,/obj/structure/table/standard,/obj/effect/decal/cleanable/dirt,/obj/item/weapon/reagent_containers/hypospray/autoinjector/biginjector/burn,/turf/simulated/floor/tiled,/area/submap/Rockybase)
"cn" = (/obj/structure/table/standard,/obj/item/clothing/mask/breath/medical,/obj/effect/decal/cleanable/dirt,/turf/simulated/floor/tiled,/area/submap/Rockybase)
"co" = (/obj/structure/closet/secure_closet/medical2,/turf/simulated/floor/tiled,/area/submap/Rockybase)
"cp" = (/obj/structure/toilet{dir = 4},/obj/machinery/light/small{dir = 8},/turf/simulated/floor/tiled/hydro,/area/submap/Rockybase)
"cq" = (/obj/structure/sink{dir = 4; icon_state = "sink"; pixel_x = 11; pixel_y = 0},/turf/simulated/floor/tiled/hydro,/area/submap/Rockybase)
"cr" = (/obj/structure/table/standard,/obj/item/device/mmi/digital/robot,/obj/item/weapon/stock_parts/capacitor/adv,/obj/item/weapon/stock_parts/scanning_module/adv,/turf/simulated/floor/tiled,/area/submap/Rockybase)
"cs" = (/obj/structure/cable{d1 = 2; d2 = 4; icon_state = "2-4"},/turf/simulated/floor/tiled,/area/submap/Rockybase)
"ct" = (/obj/structure/cable{d1 = 4; d2 = 8; icon_state = "4-8"; pixel_x = 0},/turf/simulated/floor/tiled,/area/submap/Rockybase)
"cu" = (/obj/structure/cable{d2 = 8; icon_state = "0-8"},/obj/machinery/power/port_gen/pacman,/turf/simulated/floor,/area/submap/Rockybase)
"cv" = (/obj/structure/door_assembly,/turf/simulated/floor/tiled,/area/submap/Rockybase)
"cw" = (/obj/item/stack/rods,/obj/effect/decal/cleanable/dirt,/obj/effect/decal/cleanable/dirt,/turf/simulated/floor/tiled,/area/submap/Rockybase)
"cx" = (/obj/effect/decal/cleanable/dirt,/obj/structure/girder,/turf/simulated/floor,/area/submap/Rockybase)
"cy" = (/obj/effect/decal/cleanable/dirt,/turf/simulated/floor,/area/submap/Rockybase)
"cz" = (/obj/effect/decal/cleanable/dirt,/obj/structure/table,/turf/simulated/floor,/area/submap/Rockybase)
"cA" = (/obj/structure/girder,/turf/simulated/floor,/area/submap/Rockybase)
"cB" = (/obj/structure/closet/secure_closet/medical1,/turf/simulated/floor/tiled,/area/submap/Rockybase)
"cC" = (/obj/machinery/light/small{dir = 4; pixel_y = 0},/turf/simulated/floor/tiled/hydro,/area/submap/Rockybase)
"cD" = (/obj/machinery/drone_fabricator,/turf/simulated/floor/tiled,/area/submap/Rockybase)
"cE" = (/obj/machinery/mecha_part_fabricator,/turf/simulated/floor/tiled,/area/submap/Rockybase)
"cF" = (/obj/machinery/pros_fabricator,/turf/simulated/floor/tiled,/area/submap/Rockybase)
"cG" = (/obj/structure/table/standard,/obj/item/mecha_parts/mecha_equipment/repair_droid,/obj/item/mecha_parts/mecha_equipment/weapon/ballistic/missile_rack/explosive,/turf/simulated/floor/tiled,/area/submap/Rockybase)
"cH" = (/obj/machinery/light{dir = 8},/turf/simulated/floor/tiled,/area/submap/Rockybase)
"cI" = (/obj/effect/decal/cleanable/dirt,/obj/structure/cable{d1 = 1; d2 = 2; icon_state = "1-2"; pixel_y = 0},/obj/structure/cable{d1 = 1; d2 = 4; icon_state = "1-4"},/mob/living/simple_animal/hostile/malf_drone/lesser,/turf/simulated/floor/tiled,/area/submap/Rockybase)
"cJ" = (/obj/machinery/power/terminal{dir = 4},/obj/structure/cable{d2 = 8; icon_state = "0-8"},/turf/simulated/floor/tiled,/area/submap/Rockybase)
"cK" = (/obj/machinery/power/smes/buildable/point_of_interest,/obj/structure/cable/green{d2 = 2; icon_state = "0-2"},/turf/simulated/floor,/area/submap/Rockybase)
"cL" = (/obj/machinery/vending/medical,/turf/simulated/floor/tiled,/area/submap/Rockybase)
"cM" = (/obj/effect/decal/cleanable/dirt,/obj/effect/decal/cleanable/dirt,/turf/simulated/floor/tiled,/area/submap/Rockybase)
"cN" = (/obj/effect/decal/cleanable/dirt,/obj/effect/decal/cleanable/dirt,/turf/simulated/floor,/area/submap/Rockybase)
"cO" = (/obj/effect/decal/cleanable/dirt,/obj/effect/decal/cleanable/dirt,/obj/item/weapon/material/shard,/turf/simulated/floor,/area/submap/Rockybase)
"cP" = (/obj/effect/decal/cleanable/dirt,/obj/effect/decal/cleanable/dirt,/obj/effect/decal/cleanable/dirt,/turf/simulated/floor,/area/submap/Rockybase)
"cQ" = (/obj/item/mecha_parts/part/gygax_armour,/turf/simulated/floor,/area/submap/Rockybase)
"cR" = (/obj/item/mecha_parts/chassis/gygax,/turf/simulated/floor/tiled,/area/submap/Rockybase)
"cS" = (/mob/living/simple_animal/hostile/mecha/malf_drone{name = "Autonomous Mechanized Drone"},/turf/simulated/floor/tiled,/area/submap/Rockybase)
"cT" = (/obj/effect/floor_decal/industrial/hatch/yellow,/turf/simulated/floor/tiled,/area/submap/Rockybase)
"cU" = (/obj/machinery/vending/robotics,/obj/machinery/light{icon_state = "tube1"; dir = 4},/turf/simulated/floor/tiled,/area/submap/Rockybase)
"cV" = (/obj/machinery/power/apc{cell_type = /obj/item/weapon/cell/super; dir = 8; name = "Unknown APC"; pixel_x = -24},/obj/structure/cable/green{d2 = 4; icon_state = "0-4"},/turf/simulated/floor/tiled,/area/submap/Rockybase)
"cW" = (/obj/structure/cable/green{d1 = 4; d2 = 8; icon_state = "4-8"},/turf/simulated/floor/tiled,/area/submap/Rockybase)
"cX" = (/obj/effect/decal/cleanable/dirt,/obj/structure/cable{d1 = 1; d2 = 2; icon_state = "1-2"; pixel_y = 0},/obj/structure/cable/green{d1 = 4; d2 = 8; icon_state = "4-8"},/turf/simulated/floor/tiled,/area/submap/Rockybase)
"cY" = (/obj/machinery/light{icon_state = "tube1"; dir = 4},/obj/structure/cable/green{d1 = 1; d2 = 8; icon_state = "1-8"},/obj/structure/cable/green{d1 = 2; d2 = 8; icon_state = "2-8"},/turf/simulated/floor/tiled,/area/submap/Rockybase)
"cZ" = (/obj/effect/decal/cleanable/dirt,/obj/effect/decal/cleanable/dirt,/obj/effect/decal/cleanable/dirt,/obj/effect/decal/cleanable/blood,/turf/simulated/floor,/area/submap/Rockybase)
"da" = (/obj/item/mecha_parts/part/gygax_right_leg,/obj/effect/floor_decal/corner/lime/border{tag = "icon-bordercolor (EAST)"; icon_state = "bordercolor"; dir = 4},/turf/simulated/floor/tiled,/area/submap/Rockybase)
"db" = (/obj/structure/sink{dir = 4; icon_state = "sink"; pixel_x = 11; pixel_y = 0},/obj/item/mecha_parts/part/gygax_left_arm,/turf/simulated/floor/tiled/hydro,/area/submap/Rockybase)
"dc" = (/obj/machinery/vending,/turf/simulated/floor/tiled,/area/submap/Rockybase)
"dd" = (/obj/structure/cable{d1 = 1; d2 = 4; icon_state = "1-4"},/turf/simulated/floor/tiled,/area/submap/Rockybase)
"de" = (/obj/machinery/power/smes/buildable/point_of_interest,/obj/structure/cable/green,/turf/simulated/floor,/area/submap/Rockybase)
"df" = (/obj/machinery/light{dir = 8},/obj/structure/closet/secure_closet/medical3,/turf/simulated/floor/tiled,/area/submap/Rockybase)
"dg" = (/obj/effect/decal/cleanable/dirt,/obj/effect/decal/cleanable/dirt,/mob/living/simple_animal/hostile/malf_drone/lesser,/turf/simulated/floor/tiled,/area/submap/Rockybase)
"dh" = (/obj/structure/closet/secure_closet/hydroponics,/obj/effect/floor_decal/corner/lime/border{tag = "icon-bordercolor (EAST)"; icon_state = "bordercolor"; dir = 4},/turf/simulated/floor/tiled,/area/submap/Rockybase)
"di" = (/obj/machinery/light,/turf/simulated/floor/tiled,/area/submap/Rockybase)
"dj" = (/obj/machinery/mech_recharger,/turf/simulated/floor/tiled,/area/submap/Rockybase)
"dk" = (/obj/structure/table/standard,/obj/item/stack/material/plasteel,/obj/item/stack/material/glass/reinforced,/obj/item/stack/material/phoron{amount = 25},/turf/simulated/floor/tiled,/area/submap/Rockybase)
"dl" = (/obj/structure/table/standard,/obj/item/stack/material/glass,/obj/item/stack/material/steel,/turf/simulated/floor/tiled,/area/submap/Rockybase)
"dm" = (/obj/structure/table/standard,/obj/item/mecha_parts/part/gygax_head,/turf/simulated/floor/tiled,/area/submap/Rockybase)
"dn" = (/obj/structure/closet/toolcloset,/turf/simulated/floor/tiled,/area/submap/Rockybase)
"do" = (/obj/structure/closet/secure_closet/medical3,/turf/simulated/floor/tiled,/area/submap/Rockybase)
"dp" = (/obj/item/weapon/surgical/surgicaldrill,/obj/effect/decal/cleanable/dirt,/turf/simulated/floor/tiled,/area/submap/Rockybase)
"dq" = (/obj/structure/loot_pile/maint/technical,/turf/simulated/floor/tiled,/area/submap/Rockybase)
"dr" = (/obj/item/clothing/suit/space/void/medical,/obj/effect/decal/cleanable/dirt,/turf/simulated/floor/tiled,/area/submap/Rockybase)
"ds" = (/obj/effect/decal/cleanable/dirt,/mob/living/bot/medbot{faction = "malf_drone"},/turf/simulated/floor/tiled,/area/submap/Rockybase)
"dt" = (/obj/machinery/vending/hydroseeds,/obj/effect/floor_decal/corner/lime/border{tag = "icon-bordercolor (SOUTHWEST)"; icon_state = "bordercolor"; dir = 10},/turf/simulated/floor/tiled,/area/submap/Rockybase)
"du" = (/obj/structure/closet/crate/secure/hydrosec,/obj/effect/floor_decal/corner/lime/border{tag = "icon-bordercolor (SOUTHEAST)"; icon_state = "bordercolor"; dir = 6},/turf/simulated/floor/tiled,/area/submap/Rockybase)
"dv" = (/obj/effect/decal/remains,/turf/template_noop,/area/template_noop)

(1,1,1) = {"
aaabababababababababababababababababababaaababababababababababababababababababababababababababababaa
abacadadadaeadadadadaeadadadadadadadadadadadadadadadadadadadaeadadadadadadadadadadadadacadadadadadab
abadadadadadadadadadadadadadadadadadadadadadadadadadadadadadadadadadadadadadadadadadadadadadadadadab
abadadadadadadadadadadadadadadadadadadadadadadadadadadadadadadadadadadadadadadadadadadadadadadadadab
abadadadadadadadadadadadadadadadaeadadadadadadadadadadadadadadadadadadadadadadadadadadadadadadaeadab
abadadafafafafafadadadadadadadadadadadadadadadadadadadadadadadadadadadadadadaeadadadadadadadadadadab
abadadafafafafafafagadadadafafafafafadadadadadadadadahahahahahahadadadadadadadadadafafafagadadadadab
abadafafafafafafafafafafafafafafafafafadadadadadaiahahajahahahahahaiadadadadadafafafafafafafafafadab
akadafafafafafafafafafafafafafafafafafafafafafalalamalalalalalanamalalafafafafafafafafafafafafafadab
abadafafaoaoaoaoaoaoaoaoaoaoaoaoaoaoaoaoaoaoaoaoaoaoaoapaqaqapaoaoaoaoaoaoaoaoaoaoaoaoaoafafafafadab
abadafaoaoarasataoauavawaxayayavazaAaBavaCaoaoaDaEaFaGaoaHaHaoaIaJaKaLaMaNaoaOaPaoaQaRaoaoafafafadab
abafafaoaoaSasaTaoayayayayayayayayayayayayaoaoaUaHaHaVaoaWaHaoaXaYaZaHaHbaaoaObbaobcbdaoaoafafafadab
abafafaoaoaSasbeaoaybfayaybgayavbhavaBavazaoaobiaHbjbkaoaHaHaoblbmbnbnbobnbpbqbraobcbsaoaoafafafadab
abafafaoaoasasasaoaoaobtaoaoaoaoaoaoaoaoaoaoaoaobtaoaoaoaqaqaoaoaoaoaobtaoaoaoaoaobubvaoaoafafafadab
abafafaoaoaobtaoaobwbxbxbxbxbybxbxbxbxbzbxbybxbxbxbxbxbxbxbxbxbxbybxbxbxbxbAbAbBaobcbsaoaoafafafadab
abafafaoaoaWaHaHaHaHaHaHbCbDbDaHbEbFaHaHaHaHaHaHaHaHaHaHbDaHaHaHaHaHaHaHaHbCbDbDbtbcbsaoaoafafafadab
abadafaoaoaobGaoaobHbIbIbJbJbJbIbIbIbKaHahbLbMbIbNbIbJbJbJbIbIbIbIbIbMbIbIbIbIbOaobcbvaoaoafafafadab
abadafaoaobPasbQaoaoaoaoaoaoaoaoaoaoaoahahaoaoaoaobRaoaoaoaobSaoaoaoaoaoaoaoaoaoaobcbsaoaoafafafadab
abadafaoaobTbTasaobUbVbWbXbYbZcacbcccdahcecfaocgchaHcicjaockbSaHclcmcnbDaHaHaHcoaobcbsaoaoafafafadab
abadafaoaocpbGcqaoaHaHaHaHaHaHaHaHaHbSbSahcraoaHaHcsctcuaocvaHbDbDcwcxcyczcAaHcBaobcbvaoaoafafafaeab
abadafaoaobTbTcCaoaHcDaHaHcDaHaHcEaHcFbSahcGaocHbDcIcJcKaocLaHbDcMcNcOcPcNcQahaHaobcbsaoaoafafadadab
abadafaoaocpbGasaocHaHaHcRaHcSaHcTbDcTbSbScUaocVcWcXcWcYaoaHaHbDcZcPcPcNczahceaHaobcdaaoaoafafadadab
abadafaoaobTbTdbaoaHcDaHaHahahbDbDbDbDaHaHdcaoaHaHddcJdeaodfaHaHdgcNcycycycyahbDaobcdhaoaoafagadadab
abadafaoaocpbGasaoaHaHaHaHaHaHdidjaHdjaHaHchaodkdldmaHdnaodoaHdpaHaHdqcAdqdrbDdsaodtduaoaoafafadadab
abadafafaoaoaoaoaoaoaoaoaoaoaoaoaoaoaoaoaoaoaoaoaoaoaoaoaoaoaoaoaoaoaoaoaoaoaoaoaoaoaoaoafafadadadab
abadafafafafafafafafafafafafafafafafafafafafafafafafafafafafafafafafafafafafafafafafafafafafadadadab
abadafafafafafafafafafafafafafafafafafafafafafafafafafafafafafadafafafadadadafafafafafafafadadadadab
abadadafafafafafafafafafafafafagadadadafafafafafafadadadadadadadadadadadadadadadadadadadadadadadadab
abadaeadadadadadadafafafafafadadadadadadadadadadadadadadadadadadadadadadadadadadadadadadadadadadadab
aaabdvababababababababababababababababababaaababababababababababababababababakababababababdvabakabab
"}
