//MAP CONVERTED BY dmm2tgm.py THIS HEADER COMMENT PREVENTS RECONVERSION, DO NOT REMOVE
"a" = (
/turf/template_noop,
/area/template_noop)
"b" = (
/turf/template_noop,
/area/submap/Rocky3)
"c" = (
/obj/structure/flora/tree/sif,
/turf/template_noop,
/area/submap/Rocky3)
"d" = (
/turf/simulated/mineral/ignore_mapgen,
/area/submap/Rocky3)
"e" = (
/obj/structure/flora/tree/pine,
/turf/template_noop,
/area/submap/Rocky3)

(1,1,1) = {"
a
a
a
a
a
a
a
a
a
a
a
a
a
a
a
"}
(2,1,1) = {"
a
b
b
b
a
a
a
a
a
b
b
b
b
a
a
"}
(3,1,1) = {"
a
b
e
b
b
a
a
a
b
b
c
d
b
a
a
"}
(4,1,1) = {"
a
b
b
b
b
b
b
b
b
b
b
d
b
b
a
"}
(5,1,1) = {"
a
a
b
b
d
b
b
b
b
d
d
d
b
c
a
"}
(6,1,1) = {"
a
a
b
b
d
b
c
b
d
d
d
d
b
b
a
"}
(7,1,1) = {"
a
b
b
d
d
b
b
b
d
d
d
d
b
b
a
"}
(8,1,1) = {"
a
c
d
d
d
b
b
b
d
d
d
d
b
b
a
"}
(9,1,1) = {"
a
b
d
d
b
b
b
b
b
d
d
d
d
b
a
"}
(10,1,1) = {"
a
b
d
d
b
b
b
b
d
d
d
d
b
a
a
"}
(11,1,1) = {"
a
d
d
d
d
b
b
b
b
d
d
d
b
a
a
"}
(12,1,1) = {"
a
d
d
d
d
b
b
b
e
b
d
d
d
b
a
"}
(13,1,1) = {"
a
d
d
d
d
d
b
b
b
b
d
d
d
b
a
"}
(14,1,1) = {"
a
b
d
d
d
d
d
b
b
b
b
d
b
a
a
"}
(15,1,1) = {"
a
b
b
d
d
d
d
b
b
b
b
b
a
a
a
"}
(16,1,1) = {"
a
b
b
d
d
d
d
c
b
b
b
b
b
a
a
"}
(17,1,1) = {"
a
b
b
e
d
d
d
b
b
b
b
b
b
e
a
"}
(18,1,1) = {"
a
a
b
b
d
d
d
b
b
a
a
a
b
b
a
"}
(19,1,1) = {"
a
a
a
b
b
b
d
d
a
a
a
a
a
a
a
"}
(20,1,1) = {"
a
a
a
a
a
a
a
a
a
a
a
a
a
a
a
"}
