"a" = (/turf/template_noop,/area/template_noop)
"b" = (/turf/simulated/wall/log_sif,/area/submap/Shack1)
"c" = (/turf/template_noop,/area/submap/Shack1)
"d" = (/turf/simulated/floor/outdoors/dirt,/area/submap/Shack1)
"e" = (/obj/effect/decal/cleanable/cobweb,/turf/simulated/floor/holofloor/wood{icon_state = "wood_broken1"},/area/submap/Shack1)
"f" = (/obj/structure/table/wooden_reinforced,/obj/item/storage/fancy/candle_box,/obj/item/storage/box/matches,/turf/simulated/floor/wood,/area/submap/Shack1)
"g" = (/obj/structure/closet/cabinet,/obj/item/clothing/suit/storage/apron/overalls,/obj/item/clothing/under/overalls,/obj/random/mre,/turf/simulated/floor/wood,/area/submap/Shack1)
"h" = (/obj/effect/decal/cleanable/dirt,/turf/simulated/floor/wood,/area/submap/Shack1)
"i" = (/turf/simulated/floor/wood,/area/submap/Shack1)
"j" = (/turf/simulated/floor/holofloor/wood{icon_state = "wood_broken0"},/area/submap/Shack1)
"k" = (/obj/effect/decal/cleanable/dirt,/turf/simulated/floor/holofloor/wood{icon_state = "wood_broken5"},/area/submap/Shack1)
"l" = (/obj/structure/flora/tree/sif,/turf/template_noop,/area/submap/Shack1)
"m" = (/obj/structure/simple_door/wood,/turf/simulated/floor/wood,/area/submap/Shack1)
"n" = (/turf/simulated/floor/holofloor/wood{icon_state = "wood_broken3"},/area/submap/Shack1)
"o" = (/obj/structure/table/bench/wooden,/turf/simulated/floor/wood,/area/submap/Shack1)
"p" = (/obj/effect/decal/cleanable/dirt,/obj/structure/table/wooden_reinforced,/obj/item/storage/toolbox,/turf/simulated/floor/wood,/area/submap/Shack1)
"q" = (/obj/effect/decal/cleanable/dirt,/obj/structure/table/wooden_reinforced,/obj/item/material/twohanded/fireaxe/scythe,/turf/simulated/floor/wood,/area/submap/Shack1)
"r" = (/obj/effect/decal/cleanable/spiderling_remains,/turf/simulated/floor/wood,/area/submap/Shack1)
"s" = (/turf/simulated/floor/holofloor/wood{icon_state = "wood_broken6"},/area/submap/Shack1)
"t" = (/obj/effect/decal/cleanable/dirt,/obj/structure/table/wooden_reinforced,/obj/item/flashlight/lamp,/turf/simulated/floor/wood,/area/submap/Shack1)
"u" = (/obj/structure/flora/tree/dead,/turf/template_noop,/area/submap/Shack1)

(1,1,1) = {"
aaaaaaaaaaaaaaa
abbbbbbbccccdca
abefghhbcccddca
abhijhkbclcddca
abiiiiimdddddla
abniiiimdddddca
abhoiiibcccddca
abpqrstbcucdcca
abbbbbbbcccccca
aaaaaaaaaaaaaaa
"}
