//MAP CONVERTED BY dmm2tgm.py THIS HEADER COMMENT PREVENTS RECONVERSION, DO NOT REMOVE
"a" = (
/turf/template_noop,
/area/template_noop)
"b" = (
/turf/template_noop,
/area/submap/SnowR1)
"c" = (
/turf/simulated/mineral/ignore_mapgen,
/area/submap/SnowR1)
"d" = (
/obj/structure/flora/tree/sif,
/turf/template_noop,
/area/submap/SnowR1)
"e" = (
/obj/structure/loot_pile/maint/trash,
/turf/simulated/mineral/floor/ignore_mapgen,
/area/submap/SnowR1)
"f" = (
/obj/structure/closet/crate/trashcart,
/turf/simulated/mineral/floor/ignore_mapgen,
/area/submap/SnowR1)
"g" = (
/turf/simulated/mineral/floor/ignore_mapgen,
/area/submap/SnowR1)
"h" = (
/obj/random/trash,
/turf/simulated/mineral/floor/ignore_mapgen,
/area/submap/SnowR1)

(1,1,1) = {"
a
a
a
a
a
a
a
a
a
a
a
a
a
a
a
a
a
a
a
a
"}
(2,1,1) = {"
a
b
b
b
b
b
b
b
b
b
b
b
b
b
b
b
b
b
b
a
"}
(3,1,1) = {"
a
b
b
d
b
b
b
b
b
b
b
b
b
b
b
b
b
b
d
a
"}
(4,1,1) = {"
a
b
b
b
b
b
c
c
c
c
b
b
b
b
b
b
b
b
b
a
"}
(5,1,1) = {"
a
b
b
b
b
b
c
c
c
b
b
b
d
b
b
c
b
b
b
a
"}
(6,1,1) = {"
a
b
b
b
b
c
c
c
b
b
b
b
b
b
b
c
b
b
b
a
"}
(7,1,1) = {"
a
b
b
c
c
c
c
c
b
b
b
b
b
b
b
c
c
b
b
a
"}
(8,1,1) = {"
a
b
c
c
c
c
c
c
b
b
b
b
b
b
b
c
c
b
b
a
"}
(9,1,1) = {"
a
b
c
c
c
e
h
g
b
b
b
b
b
b
c
c
c
b
b
a
"}
(10,1,1) = {"
a
b
c
c
c
f
g
g
b
b
b
b
b
b
c
c
c
b
b
a
"}
(11,1,1) = {"
a
b
c
c
c
g
g
g
b
b
b
d
b
b
c
c
c
b
b
a
"}
(12,1,1) = {"
a
b
c
c
c
h
g
g
b
b
b
b
b
c
c
c
c
b
b
a
"}
(13,1,1) = {"
a
b
c
c
c
h
g
b
b
b
b
b
b
c
c
c
c
b
b
a
"}
(14,1,1) = {"
a
b
b
c
c
c
c
b
b
b
b
b
b
c
c
c
b
b
b
a
"}
(15,1,1) = {"
a
b
b
b
c
c
c
b
b
b
b
b
b
c
c
c
c
b
b
a
"}
(16,1,1) = {"
a
b
b
b
b
c
c
b
d
b
b
b
b
c
c
c
b
b
b
a
"}
(17,1,1) = {"
a
b
d
b
b
b
b
b
b
b
b
b
b
b
b
b
b
b
b
a
"}
(18,1,1) = {"
a
b
b
b
b
b
b
b
b
b
b
b
b
b
b
b
b
d
b
a
"}
(19,1,1) = {"
a
b
b
b
b
b
b
b
b
b
b
b
b
b
b
b
b
b
b
a
"}
(20,1,1) = {"
a
a
a
a
a
a
a
a
a
a
a
a
a
a
a
a
a
a
a
a
"}
