"a" = (/turf/simulated/floor/outdoors/dirt,/area/submap/WolfDen)
"b" = (/mob/living/simple_mob/animal/sif/shantak,/turf/template_noop,/area/submap/WolfDen)
"c" = (/obj/item/bone,/obj/effect/decal/cleanable/dirt,/obj/effect/gibspawner/human,/obj/random/maintenance/engineering,/turf/simulated/floor/outdoors/dirt{outdoors = 0},/area/submap/WolfDen)
"e" = (/obj/effect/decal/cleanable/dirt,/obj/effect/decal/cleanable/dirt,/obj/random/junk,/obj/random/maintenance/cargo,/turf/simulated/floor/outdoors/dirt{outdoors = 0},/area/submap/WolfDen)
"i" = (/obj/random/maintenance/security,/turf/simulated/floor/outdoors/dirt{outdoors = 0},/area/submap/WolfDen)
"j" = (/obj/random/gun/random,/obj/random/junk,/turf/simulated/floor/outdoors/rocks{outdoors = 0},/area/submap/WolfDen)
"m" = (/obj/item/bone/ribs,/turf/simulated/floor/outdoors/dirt{outdoors = 0},/area/submap/WolfDen)
"o" = (/turf/simulated/mineral/ignore_mapgen,/area/submap/WolfDen)
"p" = (/turf/simulated/floor/outdoors/dirt{outdoors = 0},/area/submap/WolfDen)
"q" = (/obj/structure/loot_pile/surface/bones,/obj/random/maintenance/cargo,/turf/simulated/floor/outdoors/rocks{outdoors = 0},/area/submap/WolfDen)
"r" = (/obj/random/humanoidremains,/turf/simulated/floor/outdoors/dirt{outdoors = 0},/area/submap/WolfDen)
"u" = (/obj/effect/decal/cleanable/dirt,/obj/effect/decal/cleanable/dirt,/obj/structure/ledge/ledge_stairs{dir = 4},/turf/simulated/floor/outdoors/dirt{outdoors = 0},/area/submap/WolfDen)
"v" = (/obj/effect/decal/cleanable/dirt,/obj/effect/decal/cleanable/dirt,/turf/simulated/floor/outdoors/dirt{outdoors = 0},/area/submap/WolfDen)
"w" = (/obj/effect/decal/cleanable/dirt,/obj/effect/decal/cleanable/dirt,/obj/random/junk,/turf/simulated/floor/outdoors/dirt{outdoors = 0},/area/submap/WolfDen)
"y" = (/obj/random/maintenance/security,/turf/simulated/floor/outdoors/rocks{outdoors = 0},/area/submap/WolfDen)
"z" = (/obj/effect/decal/cleanable/dirt,/turf/simulated/floor/outdoors/dirt,/area/submap/WolfDen)
"A" = (/obj/effect/decal/cleanable/dirt,/obj/random/maintenance/security,/turf/simulated/floor/outdoors/dirt{outdoors = 0},/area/submap/WolfDen)
"C" = (/mob/living/simple_mob/animal/sif/shantak,/turf/simulated/floor/outdoors/dirt,/area/submap/WolfDen)
"D" = (/obj/effect/decal/cleanable/dirt,/obj/random/junk,/turf/simulated/floor/outdoors/rocks{outdoors = 0},/area/submap/WolfDen)
"G" = (/obj/item/bone/arm,/obj/effect/decal/cleanable/dirt,/turf/simulated/floor/outdoors/dirt{outdoors = 0},/area/submap/WolfDen)
"I" = (/obj/effect/decal/cleanable/dirt,/turf/simulated/floor/outdoors/dirt{outdoors = 0},/area/submap/WolfDen)
"J" = (/obj/effect/decal/cleanable/dirt,/obj/random/junk,/turf/simulated/floor/outdoors/dirt{outdoors = 0},/area/submap/WolfDen)
"K" = (/obj/effect/decal/cleanable/dirt,/obj/effect/decal/cleanable/dirt,/obj/effect/decal/cleanable/dirt,/turf/simulated/floor/outdoors/dirt{outdoors = 0},/area/submap/WolfDen)
"M" = (/obj/random/maintenance/cargo,/turf/simulated/floor/outdoors/rocks{outdoors = 0},/area/submap/WolfDen)
"O" = (/obj/random/gun/random,/turf/simulated/floor/outdoors/dirt{outdoors = 0},/area/submap/WolfDen)
"R" = (/obj/effect/decal/cleanable/dirt,/obj/effect/decal/cleanable/dirt,/obj/effect/decal/cleanable/dirt,/turf/simulated/floor/outdoors/dirt,/area/submap/WolfDen)
"S" = (/obj/item/bone,/obj/effect/decal/cleanable/dirt,/obj/effect/decal/cleanable/dirt,/turf/simulated/floor/outdoors/rocks{outdoors = 0},/area/submap/WolfDen)
"T" = (/obj/effect/decal/cleanable/dirt,/obj/random/maintenance/engineering,/turf/simulated/floor/outdoors/rocks{outdoors = 0},/area/submap/WolfDen)
"U" = (/obj/effect/decal/cleanable/dirt,/obj/random/maintenance/engineering,/obj/item/clothing/head/fedora,/turf/simulated/floor/outdoors/rocks{outdoors = 0},/area/submap/WolfDen)
"V" = (/obj/random/outcrop,/turf/simulated/floor/outdoors/dirt,/area/submap/WolfDen)
"W" = (/obj/structure/loot_pile/surface/bones,/obj/effect/decal/cleanable/dirt,/obj/random/maintenance/cargo,/turf/simulated/floor/outdoors/dirt{outdoors = 0},/area/submap/WolfDen)
"X" = (/mob/living/simple_mob/animal/sif/shantak,/turf/simulated/floor/outdoors/dirt{outdoors = 0},/area/submap/WolfDen)
"Y" = (/obj/effect/decal/cleanable/dirt,/mob/living/simple_mob/animal/sif/shantak/leader,/turf/simulated/floor/outdoors/rocks{outdoors = 0},/area/submap/WolfDen)
"Z" = (/turf/template_noop,/area/submap/WolfDen)

(1,1,1) = {"
bZZZZZoZaZ
VoooooozRo
ooovuKuvzo
ooiAoooIoo
oXSwrooooo
oOWeTpoooC
oXDJGMmooo
ooyIqcjXoo
ooorYUpooV
CoooooooaZ
"}
