//MAP CONVERTED BY dmm2tgm.py THIS HEADER COMMENT PREVENTS RECONVERSION, DO NOT REMOVE
"aa" = (
/turf/template_noop,
/area/template_noop)
"ab" = (
/turf/unsimulated/wall,
/area/ninja_dojo/dojo)
"ac" = (
/turf/unsimulated/mineral,
/area/ninja_dojo/dojo)
"ad" = (
/turf/simulated/mineral,
/area/ninja_dojo/dojo)
"ae" = (
/turf/unsimulated/floor{
	dir = 2;
	icon = 'icons/turf/snow_new.dmi';
	icon_state = "snow";
	name = "snow"
	},
/area/ninja_dojo/dojo)
"af" = (
/obj/effect/floor_decal/asteroid,
/turf/unsimulated/floor{
	dir = 2;
	icon = 'icons/turf/snow_new.dmi';
	icon_state = "snow";
	name = "snow"
	},
/area/ninja_dojo/dojo)
"ag" = (
/turf/simulated/shuttle/wall/voidcraft/green,
/area/shuttle/ninja)
"ah" = (
/obj/item/target/alien,
/turf/unsimulated/floor{
	icon = 'icons/turf/flooring/wood.dmi';
	icon_state = "wood_broken2"
	},
/area/ninja_dojo/dojo)
"ai" = (
/turf/unsimulated/floor{
	dir = 8;
	icon_state = "wood"
	},
/area/ninja_dojo/dojo)
"aj" = (
/obj/structure/table/wooden_reinforced,
/obj/item/weapon/flame/candle,
/turf/unsimulated/floor{
	dir = 8;
	icon_state = "wood"
	},
/area/ninja_dojo/dojo)
"ak" = (
/obj/structure/table/wooden_reinforced,
/obj/item/weapon/material/sword/katana,
/turf/unsimulated/floor{
	dir = 8;
	icon_state = "wood"
	},
/area/ninja_dojo/dojo)
"al" = (
/obj/machinery/space_heater,
/turf/unsimulated/floor{
	dir = 8;
	icon_state = "wood"
	},
/area/ninja_dojo/dojo)
"am" = (
/obj/item/target,
/turf/unsimulated/floor{
	dir = 8;
	icon_state = "wood"
	},
/area/ninja_dojo/dojo)
"an" = (
/obj/structure/shuttle/engine/propulsion{
	icon_state = "propulsion";
	dir = 1
	},
/turf/simulated/shuttle/plating/airless/carry,
/area/shuttle/ninja)
"ao" = (
/turf/simulated/shuttle/wall/voidcraft/blue,
/area/shuttle/ninja)
"ap" = (
/obj/item/target/syndicate,
/turf/unsimulated/floor{
	dir = 8;
	icon_state = "wood"
	},
/area/ninja_dojo/dojo)
"aq" = (
/obj/effect/floor_decal/carpet{
	dir = 1
	},
/obj/effect/floor_decal/carpet{
	dir = 8
	},
/obj/effect/floor_decal/carpet{
	dir = 9
	},
/turf/unsimulated/floor{
	dir = 2;
	icon_state = "carpet"
	},
/area/ninja_dojo/dojo)
"ar" = (
/obj/effect/floor_decal/carpet{
	dir = 1
	},
/turf/unsimulated/floor{
	dir = 2;
	icon_state = "carpet"
	},
/area/ninja_dojo/dojo)
"as" = (
/obj/effect/floor_decal/carpet{
	dir = 1
	},
/obj/effect/floor_decal/carpet{
	dir = 4
	},
/obj/effect/floor_decal/carpet{
	dir = 5
	},
/turf/unsimulated/floor{
	dir = 2;
	icon_state = "carpet"
	},
/area/ninja_dojo/dojo)
"at" = (
/obj/effect/wingrille_spawn/reinforced,
/turf/unsimulated/floor{
	icon_state = "plating";
	name = "plating"
	},
/area/ninja_dojo/dojo)
"au" = (
/obj/machinery/teleport/hub,
/obj/effect/floor_decal/industrial/hatch/yellow,
/turf/unsimulated/floor{
	icon_state = "plating";
	name = "plating"
	},
/area/ninja_dojo/dojo)
"av" = (
/obj/machinery/teleport/station,
/turf/unsimulated/floor{
	icon_state = "plating";
	name = "plating"
	},
/area/ninja_dojo/dojo)
"aw" = (
/obj/machinery/computer/teleporter,
/turf/unsimulated/floor{
	icon_state = "plating";
	name = "plating"
	},
/area/ninja_dojo/dojo)
"ax" = (
/obj/effect/floor_decal/carpet{
	dir = 8
	},
/turf/unsimulated/floor{
	dir = 2;
	icon_state = "carpet"
	},
/area/ninja_dojo/dojo)
"ay" = (
/turf/unsimulated/floor{
	dir = 2;
	icon_state = "carpet"
	},
/area/ninja_dojo/dojo)
"az" = (
/obj/effect/floor_decal/carpet{
	dir = 4
	},
/turf/unsimulated/floor{
	dir = 2;
	icon_state = "carpet"
	},
/area/ninja_dojo/dojo)
"aA" = (
/turf/unsimulated/floor{
	icon_state = "plating";
	name = "plating"
	},
/area/ninja_dojo/dojo)
"aB" = (
/turf/simulated/shuttle/wall/voidcraft/hard_corner,
/area/shuttle/ninja)
"aC" = (
/obj/effect/floor_decal/industrial/warning{
	dir = 4
	},
/obj/machinery/atmospherics/pipe/tank/air{
	dir = 2;
	start_pressure = 740.5
	},
/turf/simulated/shuttle/floor/voidcraft/light,
/area/shuttle/ninja)
"aD" = (
/obj/machinery/computer/teleporter,
/turf/simulated/shuttle/plating,
/area/shuttle/ninja)
"aE" = (
/obj/machinery/teleport/station,
/turf/simulated/shuttle/plating,
/area/shuttle/ninja)
"aF" = (
/obj/machinery/teleport/hub,
/obj/effect/floor_decal/industrial/hatch/yellow,
/turf/simulated/shuttle/plating,
/area/shuttle/ninja)
"aG" = (
/obj/effect/floor_decal/industrial/warning{
	dir = 8
	},
/obj/structure/table/steel_reinforced,
/obj/machinery/cell_charger,
/turf/simulated/shuttle/floor/voidcraft/light,
/area/shuttle/ninja)
"aH" = (
/obj/effect/floor_decal/industrial/warning{
	icon_state = "warning";
	dir = 1
	},
/turf/unsimulated/floor{
	icon_state = "dark"
	},
/area/ninja_dojo/dojo)
"aI" = (
/obj/machinery/door/airlock{
	icon = 'icons/obj/doors/Dooruranium.dmi'
	},
/turf/unsimulated/floor{
	icon_state = "dark"
	},
/area/ninja_dojo/dojo)
"aJ" = (
/obj/machinery/door/airlock{
	icon = 'icons/obj/doors/Dooruranium.dmi'
	},
/turf/unsimulated/floor{
	icon_state = "plating";
	name = "plating"
	},
/area/ninja_dojo/dojo)
"aK" = (
/obj/machinery/door/airlock/voidcraft/vertical{
	frequency = 1331;
	id_tag = "ninja_shuttle_outer";
	name = "Ship External Hatch";
	req_access = list(150)
	},
/obj/machinery/door/blast/regular{
	density = 0;
	dir = 8;
	icon_state = "pdoor0";
	id = "blastninja";
	name = "Outer Airlock";
	opacity = 0
	},
/turf/simulated/shuttle/floor/voidcraft/dark,
/area/shuttle/ninja)
"aL" = (
/obj/machinery/airlock_sensor{
	frequency = 1331;
	id_tag = "ninja_shuttle_sensor";
	pixel_x = 0;
	pixel_y = 28
	},
/obj/effect/shuttle_landmark/shuttle_initializer{
	base_area = /area/ninja_dojo/dojo;
	base_turf = /turf/unsimulated/floor;
	landmark_tag = "ninja_base";
	name = "The Dojo";
	shuttle_type = /datum/shuttle/autodock/multi/ninja
	},
/turf/simulated/shuttle/floor/voidcraft/dark,
/area/shuttle/ninja)
"aM" = (
/obj/effect/floor_decal/industrial/warning/corner{
	dir = 4
	},
/obj/machinery/atmospherics/pipe/simple/visible,
/obj/machinery/meter,
/turf/simulated/shuttle/floor/voidcraft/light,
/area/shuttle/ninja)
"aN" = (
/obj/effect/floor_decal/industrial/warning{
	icon_state = "warning";
	dir = 1
	},
/turf/simulated/shuttle/floor/voidcraft/dark,
/area/shuttle/ninja)
"aO" = (
/obj/effect/floor_decal/industrial/warning/corner{
	dir = 1
	},
/turf/simulated/shuttle/floor/voidcraft/light,
/area/shuttle/ninja)
"aP" = (
/turf/simulated/shuttle/floor/voidcraft/dark,
/area/shuttle/ninja)
"aQ" = (
/obj/structure/table/steel_reinforced,
/obj/item/weapon/storage/firstaid/adv{
	pixel_x = 5;
	pixel_y = 5
	},
/obj/item/weapon/storage/firstaid/combat,
/turf/simulated/shuttle/floor/voidcraft/dark,
/area/shuttle/ninja)
"aR" = (
/turf/unsimulated/floor{
	icon_state = "dark"
	},
/area/ninja_dojo/dojo)
"aS" = (
/obj/machinery/embedded_controller/radio/airlock/docking_port{
	frequency = 1331;
	id_tag = "ninja_shuttle";
	pixel_x = 0;
	pixel_y = -25;
	req_access = list(150)
	},
/obj/machinery/atmospherics/unary/vent_pump/high_volume{
	dir = 4;
	frequency = 1331;
	id_tag = "ninja_shuttle_pump"
	},
/obj/machinery/button/remote/blast_door{
	id = "blastninja";
	name = "ship lockdown control";
	pixel_x = -25
	},
/turf/simulated/shuttle/floor/voidcraft/dark,
/area/shuttle/ninja)
"aT" = (
/obj/machinery/atmospherics/pipe/simple/visible{
	dir = 4
	},
/obj/machinery/door/airlock/voidcraft/vertical{
	frequency = 1331;
	id_tag = "ninja_shuttle_inner";
	name = "Ship Internal Hatch";
	req_access = list(150)
	},
/turf/simulated/shuttle/floor/voidcraft/dark,
/area/shuttle/ninja)
"aU" = (
/obj/machinery/atmospherics/pipe/simple/visible{
	icon_state = "intact";
	dir = 9
	},
/obj/machinery/access_button{
	command = "cycle_interior";
	frequency = 1331;
	master_tag = "ninja_shuttle";
	name = "interior access button";
	pixel_x = -25;
	pixel_y = 25;
	req_access = list(150)
	},
/turf/simulated/shuttle/floor/voidcraft/dark,
/area/shuttle/ninja)
"aV" = (
/obj/structure/table/steel_reinforced,
/obj/machinery/recharger{
	pixel_y = 0
	},
/turf/simulated/shuttle/floor/voidcraft/dark,
/area/shuttle/ninja)
"aW" = (
/obj/effect/floor_decal/carpet,
/obj/effect/floor_decal/carpet{
	dir = 8
	},
/obj/effect/floor_decal/carpet{
	dir = 10
	},
/turf/unsimulated/floor{
	dir = 2;
	icon_state = "carpet"
	},
/area/ninja_dojo/dojo)
"aX" = (
/obj/effect/floor_decal/carpet,
/turf/unsimulated/floor{
	dir = 2;
	icon_state = "carpet"
	},
/area/ninja_dojo/dojo)
"aY" = (
/obj/effect/floor_decal/carpet{
	dir = 4
	},
/obj/effect/floor_decal/carpet,
/obj/effect/floor_decal/carpet{
	dir = 6
	},
/turf/unsimulated/floor{
	dir = 2;
	icon_state = "carpet"
	},
/area/ninja_dojo/dojo)
"aZ" = (
/obj/machinery/light{
	dir = 8;
	icon_state = "tube1";
	pixel_y = 0
	},
/turf/simulated/shuttle/floor/voidcraft/light,
/area/shuttle/ninja)
"ba" = (
/obj/machinery/light{
	dir = 4;
	icon_state = "tube1";
	pixel_x = 0
	},
/turf/simulated/shuttle/floor/voidcraft/light,
/area/shuttle/ninja)
"bb" = (
/turf/unsimulated/floor{
	icon = 'icons/turf/flooring/wood.dmi';
	icon_state = "wood_broken1"
	},
/area/ninja_dojo/dojo)
"bc" = (
/obj/structure/table/steel_reinforced,
/obj/random/paicard,
/obj/item/device/pda/syndicate,
/turf/simulated/shuttle/floor/voidcraft/light,
/area/shuttle/ninja)
"bd" = (
/obj/structure/bed/chair/comfy/black,
/turf/simulated/shuttle/floor/voidcraft/dark,
/area/shuttle/ninja)
"be" = (
/obj/structure/table/steel_reinforced,
/obj/item/weapon/storage/toolbox/syndicate{
	pixel_x = -1;
	pixel_y = 3
	},
/obj/machinery/button/remote/blast_door{
	id = "ninjawindow";
	name = "remote shutter control";
	pixel_x = 0;
	pixel_y = -25;
	req_access = list(150)
	},
/turf/simulated/shuttle/floor/voidcraft/light,
/area/shuttle/ninja)
"bf" = (
/obj/structure/table/bench/wooden,
/turf/unsimulated/floor{
	dir = 8;
	icon_state = "wood"
	},
/area/ninja_dojo/dojo)
"bg" = (
/obj/machinery/computer/station_alert{
	dir = 1
	},
/turf/simulated/shuttle/floor/voidcraft/light,
/area/shuttle/ninja)
"bh" = (
/obj/machinery/computer/shuttle_control/multi/ninja{
	dir = 1
	},
/turf/simulated/shuttle/floor/voidcraft/light,
/area/shuttle/ninja)
"bi" = (
/obj/machinery/computer/security{
	dir = 1
	},
/turf/simulated/shuttle/floor/voidcraft/light,
/area/shuttle/ninja)
"bj" = (
/obj/machinery/door/airlock{
	icon = 'icons/obj/doors/Dooruranium.dmi'
	},
/turf/unsimulated/floor{
	dir = 8;
	icon_state = "wood"
	},
/area/ninja_dojo/dojo)
"bk" = (
/obj/structure/grille,
/obj/structure/window/reinforced{
	dir = 1
	},
/obj/structure/window/reinforced,
/obj/structure/window/reinforced{
	dir = 8
	},
/obj/machinery/door/blast/shutters{
	density = 0;
	dir = 2;
	icon_state = "shutter0";
	id = "ninjawindow";
	name = "Blast Shutters";
	opacity = 0
	},
/obj/structure/window/reinforced/full,
/turf/simulated/shuttle/plating,
/area/shuttle/ninja)
"bl" = (
/obj/structure/grille,
/obj/structure/window/reinforced{
	dir = 1
	},
/obj/structure/window/reinforced,
/obj/structure/window/reinforced/full,
/obj/machinery/door/blast/shutters{
	density = 0;
	dir = 2;
	icon_state = "shutter0";
	id = "ninjawindow";
	name = "Blast Shutters";
	opacity = 0
	},
/turf/simulated/shuttle/plating,
/area/shuttle/ninja)
"bm" = (
/obj/structure/grille,
/obj/structure/window/reinforced{
	dir = 1
	},
/obj/structure/window/reinforced{
	dir = 4
	},
/obj/structure/window/reinforced,
/obj/structure/window/reinforced/full,
/obj/machinery/door/blast/shutters{
	density = 0;
	dir = 2;
	icon_state = "shutter0";
	id = "ninjawindow";
	name = "Blast Shutters";
	opacity = 0
	},
/turf/simulated/shuttle/plating,
/area/shuttle/ninja)
"bn" = (
/obj/structure/flora/tree/pine,
/turf/unsimulated/floor{
	dir = 2;
	icon = 'icons/turf/snow_new.dmi';
	icon_state = "snow";
	name = "snow"
	},
/area/ninja_dojo/dojo)
"bo" = (
/obj/structure/flora/ausbushes/palebush,
/turf/unsimulated/floor{
	dir = 2;
	icon = 'icons/turf/snow_new.dmi';
	icon_state = "snow";
	name = "snow"
	},
/area/ninja_dojo/dojo)
"bp" = (
/obj/structure/window/reinforced{
	dir = 4;
	health = 1e+006
	},
/turf/unsimulated/floor{
	dir = 2;
	icon = 'icons/turf/snow_new.dmi';
	icon_state = "snow";
	name = "snow"
	},
/area/ninja_dojo/dojo)
"bq" = (
/obj/structure/window/reinforced{
	dir = 8
	},
/turf/unsimulated/floor{
	icon_state = "asteroid"
	},
/area/ninja_dojo/dojo)
"br" = (
/turf/unsimulated/floor{
	icon_state = "asteroid"
	},
/area/ninja_dojo/dojo)
"bs" = (
/obj/structure/window/reinforced{
	dir = 4;
	health = 1e+006
	},
/turf/unsimulated/floor{
	icon_state = "asteroid"
	},
/area/ninja_dojo/dojo)
"bt" = (
/obj/structure/window/reinforced{
	dir = 8
	},
/turf/unsimulated/floor{
	dir = 2;
	icon = 'icons/turf/snow_new.dmi';
	icon_state = "snow";
	name = "snow"
	},
/area/ninja_dojo/dojo)
"bu" = (
/obj/structure/table/wooden_reinforced,
/obj/machinery/recharger{
	pixel_y = 0
	},
/turf/unsimulated/floor{
	dir = 8;
	icon_state = "wood"
	},
/area/ninja_dojo/dojo)
"bv" = (
/obj/structure/table/wooden_reinforced,
/turf/unsimulated/floor{
	dir = 8;
	icon_state = "wood"
	},
/area/ninja_dojo/dojo)
"bw" = (
/turf/unsimulated/wall{
	icon = 'icons/obj/doors/Dooruranium.dmi';
	icon_state = "door_closed";
	name = "Sealed Door"
	},
/area/ninja_dojo/dojo)
"bx" = (
/obj/structure/table/glass,
/obj/item/clothing/mask/balaclava/tactical{
	pixel_x = 2;
	pixel_y = 2
	},
/obj/item/clothing/mask/balaclava,
/turf/unsimulated/floor{
	dir = 8;
	icon_state = "wood"
	},
/area/ninja_dojo/dojo)
"by" = (
/obj/structure/table/woodentable,
/obj/item/weapon/reagent_containers/food/snacks/fortunecookie,
/turf/unsimulated/floor{
	dir = 8;
	icon_state = "wood"
	},
/area/ninja_dojo/dojo)
"bz" = (
/obj/structure/table/glass,
/obj/item/clothing/mask/balaclava,
/turf/unsimulated/floor{
	dir = 8;
	icon_state = "wood"
	},
/area/ninja_dojo/dojo)
"bA" = (
/obj/structure/bed/padded,
/obj/item/weapon/bedsheet,
/turf/unsimulated/floor{
	dir = 8;
	icon_state = "wood"
	},
/area/ninja_dojo/dojo)
"bB" = (
/obj/structure/table/glass,
/turf/unsimulated/floor{
	dir = 8;
	icon_state = "wood"
	},
/area/ninja_dojo/dojo)
"bC" = (
/obj/structure/toilet{
	dir = 4
	},
/turf/unsimulated/floor{
	icon_state = "freezerfloor";
	dir = 2
	},
/area/ninja_dojo/dojo)
"bD" = (
/turf/unsimulated/floor{
	icon_state = "freezerfloor";
	dir = 2
	},
/area/ninja_dojo/dojo)
"bE" = (
/obj/machinery/recharge_station,
/turf/unsimulated/floor{
	icon_state = "freezerfloor";
	dir = 2
	},
/area/ninja_dojo/dojo)
"bF" = (
/obj/structure/table/bench/wooden,
/obj/effect/landmark/late_antag/ninja,
/turf/unsimulated/floor{
	dir = 8;
	icon_state = "wood"
	},
/area/ninja_dojo/dojo)
"bG" = (
/obj/effect/landmark/late_antag/ninja,
/turf/unsimulated/floor{
	dir = 8;
	icon_state = "wood"
	},
/area/ninja_dojo/dojo)
"bH" = (
/obj/structure/window/reinforced/tinted{
	dir = 1
	},
/obj/structure/table/glass,
/obj/item/weapon/towel{
	color = "#FF6666";
	name = "light red towel"
	},
/obj/item/weapon/towel{
	color = "#FF6666";
	name = "light red towel"
	},
/obj/random/soap,
/turf/unsimulated/floor{
	icon_state = "freezerfloor";
	dir = 2
	},
/area/ninja_dojo/dojo)
"bI" = (
/obj/machinery/recharger{
	pixel_y = 0
	},
/obj/structure/table/steel_reinforced,
/turf/unsimulated/floor{
	dir = 8;
	icon_state = "wood"
	},
/area/ninja_dojo/dojo)
"bJ" = (
/obj/structure/table/wooden_reinforced,
/obj/item/device/radio/uplink,
/turf/unsimulated/floor{
	dir = 8;
	icon_state = "wood"
	},
/area/ninja_dojo/dojo)
"bK" = (
/obj/structure/sink{
	icon_state = "sink";
	dir = 8;
	pixel_x = -12;
	pixel_y = 2
	},
/obj/structure/mirror{
	pixel_x = -28
	},
/turf/unsimulated/floor{
	icon_state = "freezerfloor";
	dir = 2
	},
/area/ninja_dojo/dojo)
"bL" = (
/obj/item/weapon/rig/light/stealth,
/obj/structure/table/rack,
/turf/unsimulated/floor{
	icon_state = "dark"
	},
/area/ninja_dojo/dojo)
"bM" = (
/obj/item/device/suit_cooling_unit,
/turf/unsimulated/floor{
	icon_state = "dark"
	},
/area/ninja_dojo/dojo)
"bN" = (
/obj/machinery/door/airlock{
	icon = 'icons/obj/doors/Dooruranium.dmi'
	},
/turf/unsimulated/floor{
	icon_state = "white"
	},
/area/ninja_dojo/dojo)
"bO" = (
/obj/machinery/door/morgue,
/turf/unsimulated/floor{
	dir = 8;
	icon_state = "wood"
	},
/area/ninja_dojo/dojo)
"bP" = (
/obj/structure/closet/crate,
/obj/random/tech_supply,
/obj/random/tech_supply,
/obj/random/tech_supply,
/obj/random/tech_supply,
/turf/unsimulated/floor{
	icon_state = "dark"
	},
/area/ninja_dojo/dojo)
"bQ" = (
/obj/item/broken_device,
/turf/unsimulated/floor{
	icon_state = "dark"
	},
/area/ninja_dojo/dojo)
"bR" = (
/turf/unsimulated/floor{
	icon_state = "white"
	},
/area/ninja_dojo/dojo)
"bS" = (
/obj/machinery/door/morgue,
/turf/unsimulated/floor{
	icon_state = "freezerfloor";
	dir = 2
	},
/area/ninja_dojo/dojo)
"bT" = (
/obj/structure/table/steel_reinforced,
/obj/item/rig_module/chem_dispenser/ninja,
/turf/unsimulated/floor{
	icon_state = "dark"
	},
/area/ninja_dojo/dojo)
"bU" = (
/obj/structure/bed/chair/office/dark,
/turf/unsimulated/floor{
	icon_state = "dark"
	},
/area/ninja_dojo/dojo)
"bV" = (
/obj/structure/table/steel_reinforced,
/obj/item/weapon/storage/toolbox/syndicate{
	pixel_x = -1;
	pixel_y = 3
	},
/obj/random/tech_supply,
/turf/unsimulated/floor{
	icon_state = "dark"
	},
/area/ninja_dojo/dojo)
"bW" = (
/obj/structure/undies_wardrobe,
/turf/unsimulated/floor{
	icon_state = "freezerfloor";
	dir = 2
	},
/area/ninja_dojo/dojo)
"bX" = (
/obj/machinery/shower{
	dir = 8;
	icon_state = "shower";
	pixel_x = -5;
	pixel_y = -1
	},
/obj/structure/curtain/open/shower/medical,
/turf/unsimulated/floor{
	icon_state = "freezerfloor";
	dir = 2
	},
/area/ninja_dojo/dojo)
"bY" = (
/obj/structure/table/steel_reinforced,
/obj/machinery/cell_charger,
/obj/random/powercell,
/turf/unsimulated/floor{
	icon_state = "dark"
	},
/area/ninja_dojo/dojo)
"bZ" = (
/obj/structure/table/steel_reinforced,
/obj/item/rig_module/mounted/energy_blade,
/turf/unsimulated/floor{
	icon_state = "dark"
	},
/area/ninja_dojo/dojo)
"ca" = (
/obj/structure/table/steel_reinforced,
/obj/item/rig_module/fabricator/energy_net,
/obj/item/rig_module/vision/multi,
/turf/unsimulated/floor{
	icon_state = "dark"
	},
/area/ninja_dojo/dojo)
"cb" = (
/obj/machinery/sleeper{
	dir = 8
	},
/turf/unsimulated/floor{
	icon_state = "white"
	},
/area/ninja_dojo/dojo)
"cc" = (
/obj/machinery/sleep_console,
/turf/unsimulated/floor{
	icon_state = "white"
	},
/area/ninja_dojo/dojo)
"cd" = (
/obj/structure/table/standard,
/obj/item/weapon/storage/firstaid/adv{
	pixel_x = 5;
	pixel_y = 5
	},
/obj/item/weapon/storage/firstaid/adv,
/turf/unsimulated/floor{
	icon_state = "white"
	},
/area/ninja_dojo/dojo)
"ce" = (
/obj/machinery/space_heater,
/turf/unsimulated/floor{
	icon = 'icons/turf/flooring/wood.dmi';
	icon_state = "wood_broken3"
	},
/area/ninja_dojo/dojo)

(1,1,1) = {"
aa
aa
aa
aa
aa
aa
aa
aa
ab
ab
ab
ab
ab
ab
ab
ab
ab
ab
ab
ab
ab
ab
ab
ab
ab
ab
ab
bw
bw
ab
ab
ab
ab
ab
ab
"}
(2,1,1) = {"
aa
aa
aa
aa
aa
aa
aa
aa
ab
au
aH
aR
ab
ae
ae
ae
ae
ae
ae
ae
ae
ae
ae
ae
ae
ae
ab
ai
ai
at
bL
bP
bT
bY
ab
"}
(3,1,1) = {"
aa
aa
aa
aa
aa
aa
aa
aa
ab
av
aH
aR
ab
ae
ae
ae
bn
ae
ae
af
ae
ae
ae
ae
ae
ae
ab
ai
ai
aI
aR
aR
bU
bZ
ab
"}
(4,1,1) = {"
aa
aa
aa
aa
aa
aa
aa
aa
ab
aw
aH
aR
ab
ae
ae
ae
ae
ae
ae
ae
ae
ae
ae
ae
ae
ae
ab
ai
ai
at
bM
bQ
bV
ca
ab
"}
(5,1,1) = {"
aa
aa
aa
aa
aa
aa
aa
aa
ab
ab
aI
ab
ab
ae
ae
ae
ae
ae
ae
ae
ae
ae
ae
bn
ae
ae
at
ai
ai
ab
ab
ab
ab
ab
ab
"}
(6,1,1) = {"
aa
aa
aa
aa
aa
ab
ab
ab
ab
ai
ai
ai
ab
ab
ab
ab
ae
ae
ae
ae
ae
ae
ae
ae
ae
ae
at
ai
ai
bI
at
bR
bR
cb
ab
"}
(7,1,1) = {"
aa
aa
aa
aa
aa
ab
ah
am
ap
ai
ai
ai
ai
ai
bf
ab
ae
ae
ae
ae
ae
ae
ae
ae
ae
ae
at
ai
ai
ai
bN
bR
bR
cc
ab
"}
(8,1,1) = {"
aa
aa
aa
aa
aa
ab
ai
ai
ai
ai
ai
ai
ai
ai
bf
ab
bo
ae
ae
ae
ae
ae
ae
ae
ae
ae
at
ai
ai
ai
at
bR
bR
cd
ab
"}
(9,1,1) = {"
aa
aa
aa
aa
aa
ab
ai
ai
aq
ax
ax
ax
aW
ai
bf
ab
bp
bp
bp
bp
bp
bp
bp
bp
bp
bp
ab
ai
ai
ai
ab
ab
ab
ab
ab
"}
(10,1,1) = {"
aa
aa
aa
aa
aa
ab
aj
ai
ar
ay
ay
ay
aX
ai
ai
at
bq
bq
bq
bq
bq
bq
bq
bq
bq
bq
at
ai
ai
ai
ai
ai
ai
bw
ab
"}
(11,1,1) = {"
aa
aa
aa
aa
aa
ab
ak
ai
ar
ay
ay
ay
aX
ai
ai
bj
br
br
br
br
br
br
br
br
br
br
bj
ai
ai
ai
ai
ai
ai
ab
ab
"}
(12,1,1) = {"
aa
aa
aa
aa
aa
ab
aj
ai
ar
ay
ay
ay
aX
ai
ai
at
bs
bs
bs
bs
bs
bs
bs
bs
br
br
at
bx
ai
ai
ai
ai
ai
bw
ab
"}
(13,1,1) = {"
aa
aa
aa
aa
aa
ab
ai
ai
as
az
az
az
aY
ai
bf
ab
bt
bt
bt
bt
bt
bt
bt
bt
ab
ab
ab
ab
ab
ab
ab
ai
ai
ab
ab
"}
(14,1,1) = {"
aa
aa
aa
aa
aa
ab
ai
ai
ai
ai
ai
ai
ai
bb
bf
ab
bo
ae
ae
ae
ae
ae
ae
ae
ab
bu
ai
ai
ai
bJ
at
ai
ai
ab
aa
"}
(15,1,1) = {"
aa
aa
aa
aa
aa
ab
al
ai
ai
ai
ai
ai
ai
ai
bf
ab
ae
ae
ae
ae
ae
bn
ae
ae
at
ai
ai
bf
ai
ai
ab
ai
ai
ab
aa
"}
(16,1,1) = {"
aa
ab
ab
ab
ab
ab
ab
ab
ab
ai
ai
ai
ab
ab
ab
ab
ae
ae
ae
ae
ae
ae
ae
ae
at
ai
bf
by
bF
ai
bO
ai
ai
ab
aa
"}
(17,1,1) = {"
aa
ab
ac
ac
ac
ad
ae
ae
ab
ab
aJ
ab
ab
ae
ae
ae
ae
ae
ae
ae
ae
ae
ae
ae
at
ai
ai
bf
ai
ai
ab
ai
ai
ab
aa
"}
(18,1,1) = {"
aa
ab
ac
ad
ad
ae
af
ae
at
aA
aA
aA
at
ae
ae
ae
ae
ae
ae
ae
ae
ae
ae
ae
ab
bv
ai
ai
ai
bv
at
ai
ai
ab
aa
"}
(19,1,1) = {"
aa
ab
ac
ad
ae
ae
ae
ae
at
aA
aA
aA
at
ae
af
ae
ae
ae
ae
ae
ae
ae
ae
ae
ab
ab
ab
ab
ab
ab
ab
ai
ai
ab
aa
"}
(20,1,1) = {"
aa
ab
ac
ad
ae
af
ae
ae
ab
ab
aJ
ab
ab
ae
ae
ae
ae
ae
ae
ae
ae
ae
ae
ae
ae
ae
at
bz
ai
ai
ab
ai
ai
ab
aa
"}
(21,1,1) = {"
aa
ab
ac
ae
ae
ae
ae
ae
ae
ag
aK
ag
ag
ae
ae
ae
ae
ae
ae
ae
ae
ae
ae
ae
ae
ae
ab
bA
bG
ai
bO
ai
ai
ab
ab
"}
(22,1,1) = {"
aa
ab
ac
af
ae
ae
ae
ae
ag
ag
aL
aS
aB
ag
ae
ae
ae
ae
ae
ae
ae
ae
ae
ae
ae
ae
ab
ab
ab
ab
ab
ai
ai
ai
ab
"}
(23,1,1) = {"
aa
ab
ac
ae
ae
ae
ae
ae
an
aB
ag
aT
aB
aB
ag
ae
ae
ae
ae
ae
ae
ae
ae
ae
ae
ae
ab
bA
bG
ai
bO
ai
ai
ai
ab
"}
(24,1,1) = {"
aa
ab
ac
ae
ag
ag
ag
ag
ag
aC
aM
aU
aZ
bc
ag
ag
ae
ae
ae
ae
ae
ae
ae
af
ae
ae
at
bB
ai
ai
ab
ai
ai
al
ab
"}
(25,1,1) = {"
aa
ab
ac
ae
ae
ae
ae
an
ag
aD
aN
aP
aP
aP
bg
bk
ae
ae
ae
ae
ae
ae
ae
ae
ae
ae
ab
ab
ab
ab
ab
ai
ai
ce
ab
"}
(26,1,1) = {"
aa
ab
ac
ae
ae
ae
ae
ao
ag
aE
aN
aP
aP
bd
bh
bl
ae
ae
ae
ae
ae
ae
ae
ae
ae
ae
ab
bC
bH
bK
ab
bS
ab
ab
ab
"}
(27,1,1) = {"
aa
ab
ac
ae
ae
ae
ae
an
ag
aF
aN
aP
aP
aP
bi
bm
ae
ae
ae
ae
ae
ae
ae
ae
ae
ae
ab
bD
bD
bD
bD
bD
bW
ab
aa
"}
(28,1,1) = {"
aa
ab
ac
ae
ag
ag
ag
ag
ag
aG
aO
aP
ba
be
ag
ag
ae
ae
ae
ae
ae
ae
ae
ae
ae
ae
ab
bE
bD
bD
bD
bD
bX
ab
aa
"}
(29,1,1) = {"
aa
ab
ac
ae
ae
ae
ae
ae
an
aB
aP
aP
aB
aB
ag
ae
ae
ae
ae
ab
ab
ab
ab
ab
ab
ab
ab
ab
ab
ab
ab
ab
ab
ab
aa
"}
(30,1,1) = {"
aa
ab
ac
ae
ae
ae
ae
ae
ag
ag
aQ
aV
aB
ag
ae
ae
ae
ae
ae
ab
aa
aa
aa
aa
aa
aa
aa
aa
aa
aa
aa
aa
aa
aa
aa
"}
(31,1,1) = {"
aa
ab
ac
ad
ad
ae
ae
ae
ae
ag
ag
ag
ag
ae
ae
ae
ae
ae
ae
ab
aa
aa
aa
aa
aa
aa
aa
aa
aa
aa
aa
aa
aa
aa
aa
"}
(32,1,1) = {"
aa
ab
ac
ad
ad
ad
ae
ae
af
ae
ae
ae
ae
ae
ae
ae
ae
ae
ae
ab
aa
aa
aa
aa
aa
aa
aa
aa
aa
aa
aa
aa
aa
aa
aa
"}
(33,1,1) = {"
aa
ab
ac
ad
ad
ad
ad
ae
ae
ae
ae
ae
ae
ae
ae
ae
ae
ae
ae
ab
aa
aa
aa
aa
aa
aa
aa
aa
aa
aa
aa
aa
aa
aa
aa
"}
(34,1,1) = {"
aa
ab
ac
ad
ad
ad
ad
ad
ae
ae
ae
ae
af
ae
ae
ae
ae
ae
ae
ab
aa
aa
aa
aa
aa
aa
aa
aa
aa
aa
aa
aa
aa
aa
aa
"}
(35,1,1) = {"
aa
ab
ab
ab
ab
ab
ab
ab
ab
ab
ab
ab
ab
ab
ab
ab
ab
ab
ab
ab
aa
aa
aa
aa
aa
aa
aa
aa
aa
aa
aa
aa
aa
aa
aa
"}
