//MAP CONVERTED BY dmm2tgm.py THIS HEADER COMMENT PREVENTS RECONVERSION, DO NOT REMOVE
"a" = (
/turf/template_noop,
/area/submap/bonfire)
"b" = (
/obj/item/stack/material/log/sif,
/turf/template_noop,
/area/submap/bonfire)
"c" = (
/turf/simulated/floor/outdoors/dirt/virgo3b,
/area/submap/bonfire)
"d" = (
/obj/item/flame/lighter/random,
/turf/template_noop,
/area/submap/bonfire)
"e" = (
/obj/item/reagent_containers/food/drinks/bottle/orangejuice,
/turf/simulated/floor/outdoors/dirt/virgo3b,
/area/submap/bonfire)
"f" = (
/obj/item/stool/padded,
/turf/simulated/floor/outdoors/dirt/virgo3b,
/area/submap/bonfire)
"g" = (
/obj/structure/bonfire/sifwood,
/turf/simulated/floor/outdoors/dirt/virgo3b,
/area/submap/bonfire)
"h" = (
/obj/item/material/knife/machete,
/turf/simulated/floor/outdoors/dirt/virgo3b,
/area/submap/bonfire)
"i" = (
/obj/item/clothing/head/helmet/material/makeshift,
/turf/simulated/floor/outdoors/dirt/virgo3b,
/area/submap/bonfire)
"j" = (
/obj/item/stack/material/log/sif,
/turf/simulated/floor/outdoors/dirt/virgo3b,
/area/submap/bonfire)

(1,1,1) = {"
a
a
a
a
a
a
a
a
a
a
"}
(2,1,1) = {"
a
a
a
a
a
a
a
a
a
a
"}
(3,1,1) = {"
a
a
b
a
a
c
a
b
a
a
"}
(4,1,1) = {"
a
a
a
a
e
c
i
c
a
a
"}
(5,1,1) = {"
a
a
a
c
f
g
c
a
a
a
"}
(6,1,1) = {"
a
a
a
d
c
h
j
a
a
a
"}
(7,1,1) = {"
a
a
a
a
a
a
c
a
a
a
"}
(8,1,1) = {"
a
a
a
a
a
a
a
a
a
a
"}
(9,1,1) = {"
a
a
a
a
a
a
a
a
a
a
"}
(10,1,1) = {"
a
a
a
a
a
a
a
a
a
a
"}
