"a" = (/turf/template_noop,/area/template_noop)
"b" = (/turf/simulated/wall/log_sif,/area/submap/camp1)
"c" = (/obj/structure/grille/rustic,/obj/structure/window/reinforced/full,/turf/simulated/floor/plating,/area/submap/camp1)
"d" = (/obj/structure/bed/padded,/turf/simulated/floor/outdoors/dirt{outdoors = 0},/area/submap/camp1)
"e" = (/obj/item/device/flashlight/lantern,/turf/simulated/floor/outdoors/dirt{outdoors = 0},/area/submap/camp1)
"f" = (/turf/simulated/floor/outdoors/dirt{outdoors = 0},/area/submap/camp1)
"g" = (/obj/machinery/space_heater,/turf/simulated/floor/outdoors/dirt{outdoors = 0},/area/submap/camp1)
"h" = (/obj/structure/simple_door/sifwood,/turf/simulated/floor/outdoors/dirt{outdoors = 0},/area/submap/camp1)
"i" = (/obj/structure/table/rack,/obj/item/weapon/gun/launcher/crossbow,/obj/item/stack/rods{amount = 17},/turf/simulated/floor/outdoors/dirt{outdoors = 0},/area/submap/camp1)
"j" = (/obj/item/stack/material/log/sif{amount = 25},/turf/template_noop,/area/template_noop)
"k" = (/obj/structure/table/bench/wooden,/turf/simulated/floor/outdoors/dirt,/area/submap/camp1)
"l" = (/turf/simulated/floor/outdoors/dirt,/area/submap/camp1)
"m" = (/obj/item/weapon/material/knife/machete/hatchet,/turf/template_noop,/area/template_noop)
"n" = (/obj/structure/bonfire/sifwood,/turf/simulated/floor/outdoors/dirt,/area/submap/camp1)
"o" = (/obj/item/weapon/flame/lighter,/turf/simulated/floor/outdoors/dirt,/area/submap/camp1)

(1,1,1) = {"
abbbcbbbaa
abddeddbaa
acfffffcaa
abgbhbibaa
abbbfbbbaa
aaabhbjaaa
aaklllkmaa
aaklnlkaaa
aaklllkaaa
aaaollaaaa
"}
