//MAP CONVERTED BY dmm2tgm.py THIS HEADER COMMENT PREVENTS RECONVERSION, DO NOT REMOVE
"ag" = (
/obj/structure/outcrop/gold,
/turf/simulated/floor/outdoors/dirt/virgo3b,
/area/submap/drgnplateu)
"be" = (
/mob/living/simple_mob/vore/bigdragon,
/turf/simulated/floor/outdoors/dirt/virgo3b,
/area/submap/drgnplateu)
"bN" = (
/turf/simulated/floor/outdoors/grass/sif/forest,
/area/submap/drgnplateu)
"cq" = (
/obj/structure/cliff/automatic{
	dir = 10
	},
/turf/simulated/floor/outdoors/dirt/virgo3b,
/area/submap/drgnplateu)
"cV" = (
/obj/item/weapon/digestion_remains/skull/tajaran,
/obj/item/weapon/digestion_remains{
	pixel_x = 19;
	pixel_y = 1
	},
/obj/item/weapon/digestion_remains{
	pixel_x = 8;
	pixel_y = 1
	},
/obj/item/weapon/digestion_remains,
/obj/item/clothing/accessory/collar/holo/indigestible,
/turf/simulated/floor/outdoors/dirt/virgo3b,
/area/submap/drgnplateu)
"dO" = (
/obj/structure/flora/grass/brown{
	pixel_x = -10;
	pixel_y = 5
	},
/obj/structure/flora/grass/green{
	pixel_y = -11
	},
/obj/structure/flora/grass/green{
	pixel_x = -8
	},
/obj/item/clothing/gloves/ring/material/gold,
/obj/item/clothing/ears/earring/stud/gold,
/obj/item/weapon/gun/projectile/deagle/gold{
	pixel_x = -11;
	pixel_y = -22
	},
/turf/simulated/floor/outdoors/grass/sif/forest,
/area/submap/drgnplateu)
"ez" = (
/obj/item/weapon/digestion_remains/ribcage,
/obj/item/weapon/digestion_remains{
	pixel_x = 19;
	pixel_y = 1
	},
/obj/effect/decal/cleanable/filth,
/turf/simulated/floor/outdoors/dirt/virgo3b,
/area/submap/drgnplateu)
"fj" = (
/obj/item/weapon/digestion_remains/ribcage,
/obj/item/weapon/digestion_remains{
	pixel_x = 8;
	pixel_y = 7
	},
/obj/effect/decal/cleanable/filth,
/turf/simulated/floor/outdoors/dirt/virgo3b,
/area/submap/drgnplateu)
"fk" = (
/obj/structure/cliff/automatic/corner{
	dir = 9
	},
/turf/simulated/floor/outdoors/dirt/virgo3b,
/area/submap/drgnplateu)
"ga" = (
/obj/structure/cliff/automatic{
	dir = 6
	},
/turf/simulated/floor/outdoors/dirt/virgo3b,
/area/submap/drgnplateu)
"gy" = (
/obj/structure/flora/grass/brown{
	pixel_x = -8;
	pixel_y = 9
	},
/obj/structure/flora/grass/green,
/obj/item/clothing/accessory/medal/solgov/gold/sun,
/obj/item/weapon/pickaxe/gold{
	pixel_x = -12;
	pixel_y = 9
	},
/obj/item/weapon/reagent_containers/food/drinks/golden_cup{
	pixel_x = -10;
	pixel_y = -5
	},
/turf/simulated/floor/outdoors/grass/sif/forest,
/area/submap/drgnplateu)
"hI" = (
/obj/effect/decal/remains,
/obj/effect/decal/cleanable/blood,
/obj/effect/gibspawner/human,
/turf/template_noop,
/area/template_noop)
"iy" = (
/obj/structure/cliff/automatic/corner{
	dir = 10
	},
/turf/simulated/floor/outdoors/dirt/virgo3b,
/area/submap/drgnplateu)
"js" = (
/obj/effect/decal/cleanable/molten_item,
/obj/effect/decal/cleanable/filth,
/turf/simulated/floor/outdoors/dirt/virgo3b,
/area/submap/drgnplateu)
"mn" = (
/obj/structure/flora/grass/brown{
	pixel_y = 13
	},
/obj/structure/flora/grass/green,
/obj/item/clothing/accessory/bracelet/material/gold{
	pixel_x = -7;
	pixel_y = 20
	},
/obj/item/clothing/ears/earring/dangle/gold,
/obj/item/instrument/violin/golden{
	pixel_x = 7
	},
/obj/item/weapon/flame/lighter/zippo/gold,
/turf/simulated/floor/outdoors/grass/sif/forest,
/area/submap/drgnplateu)
"mw" = (
/obj/effect/decal/cleanable/blood,
/turf/simulated/floor/outdoors/dirt/virgo3b,
/area/submap/drgnplateu)
"mB" = (
/obj/item/weapon/material/twohanded/baseballbat/gold,
/turf/simulated/floor/outdoors/grass/sif/forest,
/area/submap/drgnplateu)
"mX" = (
/obj/item/weapon/digestion_remains/skull/unknown/anthro,
/obj/item/weapon/digestion_remains{
	pixel_x = 8;
	pixel_y = 7
	},
/obj/item/weapon/digestion_remains{
	pixel_x = 19;
	pixel_y = -2
	},
/obj/item/weapon/digestion_remains{
	pixel_x = 19;
	pixel_y = -11
	},
/obj/item/weapon/digestion_remains{
	pixel_x = 19;
	pixel_y = 1
	},
/obj/effect/decal/cleanable/blood,
/turf/simulated/floor/outdoors/dirt/virgo3b,
/area/submap/drgnplateu)
"nh" = (
/obj/item/clothing/accessory/collar/fluff/goldenstring,
/obj/effect/decal/cleanable/liquid_fuel,
/turf/simulated/floor/outdoors/dirt/virgo3b,
/area/submap/drgnplateu)
"ni" = (
/obj/item/weapon/digestion_remains/skull/unknown/anthro,
/obj/item/weapon/digestion_remains/ribcage,
/obj/effect/decal/cleanable/liquid_fuel,
/turf/simulated/floor/outdoors/dirt/virgo3b,
/area/submap/drgnplateu)
"no" = (
/obj/effect/decal/cleanable/ash,
/turf/simulated/floor/outdoors/dirt/virgo3b,
/area/submap/drgnplateu)
"oy" = (
/turf/simulated/floor/outdoors/dirt/virgo3b,
/area/template_noop)
"pk" = (
/obj/structure/cliff/automatic/corner{
	dir = 6
	},
/turf/simulated/floor/outdoors/dirt/virgo3b,
/area/submap/drgnplateu)
"rV" = (
/obj/structure/cliff/automatic,
/turf/simulated/floor/outdoors/dirt/virgo3b,
/area/submap/drgnplateu)
"vx" = (
/obj/effect/gibspawner/human,
/obj/effect/decal/remains,
/turf/template_noop,
/area/template_noop)
"xd" = (
/obj/item/weapon/digestion_remains/skull/nevrean,
/obj/effect/decal/cleanable/filth,
/turf/simulated/floor/outdoors/dirt/virgo3b,
/area/submap/drgnplateu)
"yx" = (
/obj/structure/cliff/automatic{
	dir = 2
	},
/turf/simulated/floor/outdoors/dirt/virgo3b,
/area/submap/drgnplateu)
"zl" = (
/obj/item/weapon/digestion_remains/skull/akula,
/obj/effect/decal/cleanable/liquid_fuel,
/turf/simulated/floor/outdoors/dirt/virgo3b,
/area/submap/drgnplateu)
"zm" = (
/obj/item/weapon/digestion_remains,
/obj/effect/decal/cleanable/filth,
/turf/simulated/floor/outdoors/dirt/virgo3b,
/area/submap/drgnplateu)
"Ab" = (
/obj/structure/cliff/automatic/ramp{
	dir = 9
	},
/turf/simulated/floor/outdoors/dirt/virgo3b,
/area/submap/drgnplateu)
"BA" = (
/obj/effect/decal/remains,
/obj/effect/decal/cleanable/blood,
/obj/effect/decal/cleanable/ash,
/turf/simulated/floor/outdoors/dirt/virgo3b,
/area/submap/drgnplateu)
"Cu" = (
/obj/item/weapon/digestion_remains{
	pixel_x = 8
	},
/obj/item/weapon/digestion_remains{
	pixel_x = 8;
	pixel_y = 7
	},
/obj/item/weapon/digestion_remains{
	pixel_x = 19;
	pixel_y = 1
	},
/obj/effect/decal/cleanable/filth,
/turf/simulated/floor/outdoors/dirt/virgo3b,
/area/submap/drgnplateu)
"FT" = (
/obj/item/weapon/digestion_remains/ribcage,
/obj/item/weapon/digestion_remains/ribcage{
	pixel_x = 9;
	pixel_y = 14
	},
/turf/simulated/floor/outdoors/dirt/virgo3b,
/area/submap/drgnplateu)
"Gp" = (
/obj/effect/landmark/loot_spawn,
/obj/effect/decal/cleanable/blood,
/turf/simulated/floor/outdoors/dirt/virgo3b,
/area/submap/drgnplateu)
"IL" = (
/obj/effect/decal/remains,
/obj/effect/decal/cleanable/blood,
/obj/effect/decal/cleanable/filth,
/turf/simulated/floor/outdoors/dirt/virgo3b,
/area/submap/drgnplateu)
"IS" = (
/obj/effect/decal/cleanable/filth,
/turf/simulated/floor/outdoors/dirt/virgo3b,
/area/submap/drgnplateu)
"Jz" = (
/obj/item/weapon/digestion_remains/skull/unknown/anthro,
/turf/simulated/floor/outdoors/dirt/virgo3b,
/area/submap/drgnplateu)
"JJ" = (
/obj/structure/flora/grass/brown{
	pixel_x = 11;
	pixel_y = -9
	},
/obj/structure/flora/grass/green,
/obj/fiftyspawner/gold,
/obj/item/slime_extract/gold,
/obj/item/toy/plushie/carp/gold{
	pixel_x = 18;
	pixel_y = -6
	},
/turf/simulated/floor/outdoors/grass/sif/forest,
/area/submap/drgnplateu)
"LN" = (
/obj/effect/decal/cleanable/liquid_fuel,
/turf/simulated/floor/outdoors/dirt/virgo3b,
/area/submap/drgnplateu)
"Mf" = (
/obj/effect/landmark/loot_spawn,
/turf/simulated/floor/outdoors/dirt/virgo3b,
/area/submap/drgnplateu)
"MU" = (
/obj/structure/cliff/automatic/ramp,
/turf/simulated/floor/outdoors/dirt/virgo3b,
/area/submap/drgnplateu)
"Na" = (
/obj/structure/cliff/automatic{
	dir = 4
	},
/turf/simulated/floor/outdoors/dirt/virgo3b,
/area/submap/drgnplateu)
"Nj" = (
/obj/item/weapon/digestion_remains/skull/unathi,
/obj/item/weapon/digestion_remains,
/obj/item/weapon/digestion_remains{
	pixel_x = 8;
	pixel_y = 7
	},
/obj/effect/decal/cleanable/filth,
/turf/simulated/floor/outdoors/dirt/virgo3b,
/area/submap/drgnplateu)
"Of" = (
/obj/structure/cliff/automatic{
	dir = 9
	},
/turf/simulated/floor/outdoors/dirt/virgo3b,
/area/submap/drgnplateu)
"Ok" = (
/obj/effect/landmark/loot_spawn/low,
/turf/simulated/floor/outdoors/dirt/virgo3b,
/area/submap/drgnplateu)
"Qc" = (
/obj/structure/cliff/automatic/corner,
/turf/simulated/floor/outdoors/dirt/virgo3b,
/area/submap/drgnplateu)
"Ra" = (
/obj/item/weapon/digestion_remains/skull/zorren,
/obj/item/clothing/accessory/collar/holo/indigestible,
/turf/simulated/floor/outdoors/dirt/virgo3b,
/area/submap/drgnplateu)
"Rl" = (
/obj/structure/cliff/automatic{
	dir = 8
	},
/turf/simulated/floor/outdoors/dirt/virgo3b,
/area/submap/drgnplateu)
"SC" = (
/obj/structure/table/gold,
/turf/simulated/floor/outdoors/dirt/virgo3b,
/area/submap/drgnplateu)
"SI" = (
/obj/structure/cliff/automatic{
	dir = 5
	},
/turf/simulated/floor/outdoors/dirt/virgo3b,
/area/submap/drgnplateu)
"Vj" = (
/turf/template_noop,
/area/template_noop)
"We" = (
/obj/effect/decal/remains,
/obj/effect/decal/cleanable/blood/tracks{
	color = "red";
	desc = "Your instincts say you shouldn't be following these.";
	dir = 4;
	icon = 'icons/effects/blood.dmi';
	icon_state = "tracks"
	},
/turf/simulated/floor/outdoors/dirt/virgo3b,
/area/submap/drgnplateu)
"Wr" = (
/obj/effect/decal/cleanable/blood,
/turf/template_noop,
/area/template_noop)
"YH" = (
/turf/simulated/mineral/ignore_mapgen,
/area/submap/drgnplateu)
"Ze" = (
/obj/effect/gibspawner/human,
/turf/simulated/floor/outdoors/dirt/virgo3b,
/area/submap/drgnplateu)
"ZD" = (
/turf/simulated/floor/outdoors/dirt/virgo3b,
/area/submap/drgnplateu)

(1,1,1) = {"
Vj
Vj
Vj
Vj
Vj
Vj
Vj
Vj
Vj
Vj
Vj
Vj
Vj
Vj
Vj
Vj
Vj
Vj
Vj
Vj
Vj
Vj
Vj
Vj
Vj
Vj
Vj
Vj
Vj
hI
Vj
Vj
Vj
Vj
Vj
Vj
Vj
Vj
Vj
Vj
Vj
Vj
Vj
Vj
Vj
Vj
Vj
"}
(2,1,1) = {"
Vj
Vj
Vj
Vj
Vj
Vj
Vj
Vj
Vj
Vj
Vj
Vj
Vj
Vj
Vj
Vj
Vj
Vj
Vj
Vj
Vj
Vj
Vj
Vj
Vj
Vj
Vj
Vj
Vj
Wr
Wr
Vj
Vj
Vj
Vj
Vj
Vj
Vj
Vj
Vj
Vj
Vj
Vj
Vj
Vj
Vj
Vj
"}
(3,1,1) = {"
Vj
Vj
Vj
Vj
Vj
Vj
Vj
Vj
Vj
Vj
Vj
Vj
Vj
Vj
Vj
Vj
Vj
Vj
Vj
Vj
Vj
Vj
Vj
Vj
Vj
Vj
Vj
Vj
Wr
Wr
Wr
Vj
Vj
Vj
Vj
Vj
Vj
Vj
Vj
Vj
Vj
Vj
Vj
Vj
Vj
Vj
Vj
"}
(4,1,1) = {"
Vj
Vj
Vj
Vj
Vj
Vj
Vj
Vj
Vj
Vj
Vj
Vj
Vj
pk
Na
Na
Na
Na
Na
Na
Na
Na
Na
Na
Na
Na
Na
Na
Na
Na
Na
Na
Na
Na
Na
Na
Na
Na
Na
Na
Qc
Vj
Vj
Vj
Vj
Vj
Vj
"}
(5,1,1) = {"
Vj
Vj
Vj
Vj
Vj
Vj
Vj
Vj
Vj
pk
Na
Na
Na
ga
ZD
ZD
ZD
ZD
ZD
ZD
ZD
ZD
ZD
ZD
ZD
ZD
ZD
ZD
ZD
ZD
ZD
ZD
ZD
ZD
ZD
ZD
ZD
ZD
ZD
ZD
SI
Qc
Vj
Vj
Vj
Vj
Vj
"}
(6,1,1) = {"
Vj
Vj
Vj
Vj
Vj
Vj
Vj
Vj
Vj
yx
ZD
ZD
ZD
ZD
ZD
pk
Na
Na
Na
Na
Na
Na
Na
Na
Na
Na
Na
Na
Na
Na
Na
Na
Na
Na
Na
Na
Na
Na
Qc
ZD
ZD
SI
Na
Na
Na
Na
Qc
"}
(7,1,1) = {"
Vj
Vj
Vj
Vj
Vj
Vj
Vj
Vj
Vj
yx
ZD
pk
Na
Na
Na
ga
ZD
ZD
ZD
ZD
ZD
ZD
ZD
ZD
ZD
ZD
ZD
ZD
ZD
ZD
ZD
ZD
ZD
ZD
ZD
ZD
ZD
ZD
SI
Qc
ZD
ZD
ZD
ZD
ZD
ZD
rV
"}
(8,1,1) = {"
Vj
Vj
Vj
Vj
Vj
Vj
Vj
Vj
Vj
yx
ZD
yx
ZD
ZD
ZD
ZD
ZD
ZD
ZD
ZD
ZD
ZD
ZD
ZD
ZD
ZD
ZD
ZD
ZD
ZD
ZD
ZD
ZD
ZD
ZD
ZD
ZD
ZD
ZD
SI
Na
Na
Na
Na
Qc
ZD
rV
"}
(9,1,1) = {"
Vj
Vj
Vj
Vj
Vj
Vj
Vj
Vj
Vj
yx
ZD
yx
ZD
ZD
ZD
ZD
YH
ZD
ZD
ZD
ZD
ZD
YH
ZD
ZD
ZD
ZD
ZD
ZD
ZD
ZD
ZD
ZD
ZD
ZD
ZD
ZD
ZD
ZD
ZD
ZD
ZD
ZD
ZD
rV
ZD
rV
"}
(10,1,1) = {"
Vj
Vj
Vj
Vj
Vj
Vj
pk
Na
Na
ga
ZD
yx
ZD
ZD
ZD
ZD
ZD
ZD
ZD
ZD
ZD
ZD
ZD
ZD
ZD
ZD
ZD
ZD
ZD
ZD
ZD
ZD
ZD
ZD
ZD
ZD
ZD
ZD
ZD
ZD
ZD
ZD
ZD
ZD
rV
ZD
rV
"}
(11,1,1) = {"
Vj
Vj
Vj
Vj
Vj
Vj
yx
ZD
ZD
ZD
ZD
yx
ZD
ZD
ZD
ZD
ZD
ZD
ZD
ZD
ZD
ZD
ZD
ZD
ZD
ZD
ZD
ZD
ZD
ZD
ZD
ZD
ZD
ZD
ZD
ZD
ZD
ZD
ZD
ZD
ZD
ZD
ZD
ZD
rV
ZD
rV
"}
(12,1,1) = {"
Vj
Vj
Vj
Vj
Vj
Vj
yx
ZD
pk
Na
Na
ga
ZD
ZD
ZD
ZD
ZD
ZD
ZD
ZD
ZD
no
ZD
ZD
ZD
ZD
ZD
ZD
ZD
ZD
YH
YH
Mf
ZD
ZD
ZD
ZD
ZD
ZD
ZD
ZD
ZD
ZD
ZD
rV
ZD
rV
"}
(13,1,1) = {"
Vj
Vj
Vj
Vj
Vj
ZD
yx
ZD
yx
ZD
ZD
ZD
ZD
ZD
YH
ZD
ZD
ZD
ZD
ZD
cV
ZD
Ok
ZD
ZD
ZD
no
ZD
ZD
ZD
YH
YH
YH
ZD
ZD
ZD
ZD
ZD
ZD
ZD
ZD
ZD
ZD
ZD
rV
ZD
rV
"}
(14,1,1) = {"
Vj
Vj
Vj
Vj
ZD
ZD
yx
ZD
yx
ZD
ZD
ZD
ZD
ZD
ZD
ZD
ZD
YH
ZD
ZD
ZD
ZD
ZD
nh
ZD
ZD
ZD
ZD
ZD
ZD
ZD
ZD
ZD
ZD
ZD
ZD
ZD
ZD
ZD
ZD
ZD
ZD
ZD
ZD
rV
ZD
rV
"}
(15,1,1) = {"
Vj
Vj
Vj
ZD
ZD
ZD
yx
ZD
yx
ZD
ZD
ZD
ZD
ZD
ZD
FT
ZD
YH
js
no
ZD
LN
IL
ZD
no
ag
IS
ZD
no
ZD
ZD
ZD
ZD
ZD
ZD
ZD
ZD
ZD
ZD
YH
YH
ZD
ZD
ZD
rV
ZD
rV
"}
(16,1,1) = {"
oy
oy
MU
Na
Na
Na
ga
ZD
ga
ZD
ZD
ZD
ZD
ZD
Jz
ZD
ZD
ZD
ZD
zl
ZD
ZD
ZD
ZD
ZD
ZD
ZD
ZD
ZD
ag
ZD
ZD
ZD
ZD
ZD
ZD
ZD
ZD
YH
YH
YH
ZD
ZD
ZD
rV
ZD
rV
"}
(17,1,1) = {"
Vj
oy
ZD
ZD
ZD
ZD
ZD
ZD
ZD
ZD
ZD
ZD
ZD
ZD
ZD
ZD
mX
ZD
zm
LN
ni
ZD
ZD
ag
ZD
Of
Rl
Rl
cq
ZD
ZD
ZD
ZD
ZD
ZD
ZD
ZD
ZD
ZD
YH
ZD
ZD
ZD
ZD
rV
ZD
rV
"}
(18,1,1) = {"
Vj
oy
ZD
ZD
ZD
ZD
ZD
ZD
ZD
ZD
ZD
ZD
ZD
ZD
ZD
ZD
ZD
LN
ZD
ZD
be
IL
LN
Ab
Rl
fk
JJ
mn
yx
ZD
Ok
ZD
ag
ZD
ZD
ZD
ZD
ZD
ZD
ZD
ZD
ZD
ZD
ZD
rV
ZD
rV
"}
(19,1,1) = {"
Vj
oy
Ab
Rl
Rl
Rl
cq
ZD
cq
ZD
ZD
ZD
ZD
ZD
ZD
ZD
ZD
ZD
ZD
LN
ZD
Cu
ZD
ZD
bN
mB
dO
gy
yx
ZD
ZD
ag
ZD
ZD
ZD
ZD
ZD
YH
ZD
ZD
ZD
ZD
ZD
ZD
rV
ZD
rV
"}
(20,1,1) = {"
Vj
oy
Vj
ZD
ZD
ZD
yx
ZD
yx
ZD
ZD
ZD
ZD
ZD
ZD
ZD
ZD
Nj
ZD
Ze
ZD
ZD
ZD
MU
Na
Na
Na
Na
ga
ZD
ZD
ZD
ZD
ZD
ZD
ZD
ZD
ZD
ZD
ZD
ZD
ZD
ZD
ZD
rV
ZD
rV
"}
(21,1,1) = {"
Vj
Vj
Vj
Vj
ZD
ZD
yx
ZD
yx
ZD
ZD
YH
ZD
ZD
ZD
ZD
ZD
ZD
ZD
ZD
Jz
LN
ZD
ZD
ag
ag
ZD
ZD
ZD
ZD
ZD
Ok
ZD
ZD
ZD
ZD
ZD
ZD
ZD
ZD
ZD
ZD
ZD
ZD
rV
ZD
rV
"}
(22,1,1) = {"
Vj
Vj
Vj
Vj
ZD
ZD
yx
ZD
yx
ZD
ZD
ZD
ZD
ZD
ZD
ZD
xd
ZD
ZD
ZD
ZD
ZD
LN
ZD
ZD
ZD
ag
ag
ZD
mw
ZD
ag
ZD
ZD
ZD
ZD
ZD
ZD
ZD
ZD
ZD
ZD
ZD
ZD
rV
ZD
rV
"}
(23,1,1) = {"
Vj
Vj
Vj
Vj
Vj
Vj
yx
ZD
yx
ZD
ZD
ZD
ZD
ZD
ZD
mw
ZD
ZD
Ra
IS
ZD
ZD
ez
ZD
ZD
ZD
BA
ZD
ZD
We
ZD
ZD
ZD
ZD
ZD
ZD
ZD
ZD
ZD
YH
ZD
ZD
Of
Rl
fk
ZD
rV
"}
(24,1,1) = {"
Vj
Vj
Vj
Vj
Vj
Vj
yx
ZD
yx
ZD
ZD
ZD
ZD
ZD
ZD
ZD
YH
YH
YH
ZD
Gp
ZD
ZD
ZD
fj
ZD
no
BA
ZD
ZD
ZD
ZD
ZD
ZD
ZD
ZD
ZD
ZD
ZD
ZD
ZD
Of
fk
ZD
ZD
ZD
rV
"}
(25,1,1) = {"
Vj
Vj
Vj
Vj
Vj
Vj
yx
ZD
yx
ZD
ZD
ZD
ZD
ZD
ZD
ZD
ZD
YH
YH
YH
ZD
ZD
ZD
IS
ZD
ZD
ZD
no
ZD
ZD
no
ZD
Mf
ZD
ZD
ZD
ZD
ZD
ZD
ZD
ZD
rV
ZD
ZD
Of
Rl
fk
"}
(26,1,1) = {"
Vj
Vj
Vj
Vj
Vj
Vj
yx
ZD
iy
Rl
Rl
cq
ZD
ZD
ZD
ZD
ZD
ZD
YH
YH
ZD
ZD
ZD
ZD
ZD
ZD
IS
ZD
SC
ZD
ZD
ZD
YH
ZD
ZD
ZD
ZD
ZD
ZD
ZD
ZD
rV
ZD
Of
fk
Vj
Vj
"}
(27,1,1) = {"
Vj
Vj
Vj
Vj
Vj
Vj
yx
ZD
ZD
ZD
ZD
yx
ZD
ZD
ZD
ZD
ZD
ZD
YH
YH
YH
YH
YH
YH
ZD
ZD
ZD
mw
ZD
ZD
YH
YH
YH
ZD
ZD
ZD
ZD
Of
Rl
Rl
Rl
fk
ZD
rV
Vj
Vj
Vj
"}
(28,1,1) = {"
Vj
Vj
Vj
Vj
Vj
Vj
iy
Rl
Rl
cq
ZD
yx
ZD
ZD
ZD
ZD
ZD
ZD
ZD
YH
YH
YH
YH
YH
YH
YH
YH
YH
YH
YH
YH
YH
ZD
ZD
ZD
ZD
ZD
rV
ZD
ZD
ZD
ZD
ZD
rV
Vj
Vj
Vj
"}
(29,1,1) = {"
Vj
Vj
Vj
Vj
Vj
Vj
Vj
Vj
Vj
yx
ZD
yx
ZD
ZD
ZD
ZD
ZD
ZD
ZD
ZD
ZD
ZD
ZD
YH
YH
YH
YH
YH
YH
YH
YH
ZD
ZD
ZD
ZD
ZD
ZD
rV
ZD
Of
Rl
Rl
Rl
fk
Vj
Vj
Vj
"}
(30,1,1) = {"
Vj
Vj
Vj
Vj
Vj
Vj
Vj
Vj
Vj
yx
ZD
yx
ZD
ZD
ZD
ZD
ZD
ZD
ZD
ZD
ZD
ZD
ZD
ZD
ZD
ZD
ZD
ZD
ZD
ZD
ZD
ZD
ZD
ZD
ZD
ZD
ZD
rV
ZD
rV
Vj
Vj
Vj
Vj
Vj
Vj
Vj
"}
(31,1,1) = {"
Vj
Vj
Vj
Vj
Vj
Vj
Vj
Vj
Vj
yx
ZD
yx
ZD
ZD
ZD
ZD
ZD
ZD
ZD
ZD
ZD
ZD
ZD
ZD
ZD
ZD
ZD
ZD
ZD
ZD
ZD
ZD
ZD
ZD
ZD
ZD
ZD
rV
ZD
rV
Vj
Vj
Vj
Vj
Vj
Vj
Vj
"}
(32,1,1) = {"
Vj
Vj
Vj
Vj
Vj
Vj
Vj
Vj
Vj
yx
ZD
iy
Rl
Rl
cq
ZD
ZD
ZD
ZD
ZD
ZD
ZD
ZD
ZD
ZD
ZD
ZD
ZD
ZD
ZD
ZD
ZD
ZD
ZD
ZD
ZD
ZD
rV
ZD
rV
Vj
Vj
Vj
vx
Vj
Vj
Vj
"}
(33,1,1) = {"
Vj
Vj
Vj
Vj
Vj
Vj
Vj
Vj
Vj
yx
ZD
ZD
ZD
ZD
yx
ZD
ZD
ZD
ZD
ZD
ZD
ZD
ZD
ZD
ZD
ZD
ZD
ZD
ZD
Of
Rl
Rl
Rl
Rl
Rl
Rl
Rl
fk
ZD
rV
Vj
Vj
Vj
Vj
Vj
Vj
Vj
"}
(34,1,1) = {"
Vj
Vj
Vj
Vj
Vj
Vj
Vj
Vj
Vj
iy
Rl
Rl
cq
ZD
yx
ZD
ZD
YH
YH
ZD
ZD
ZD
ZD
ZD
ZD
ZD
ZD
ZD
ZD
rV
ZD
ZD
ZD
ZD
ZD
ZD
ZD
ZD
ZD
rV
Vj
Vj
Vj
Vj
Vj
Vj
Vj
"}
(35,1,1) = {"
Vj
Vj
Vj
Vj
Vj
Vj
Vj
Vj
Vj
Vj
Vj
Vj
yx
ZD
yx
ZD
ZD
YH
YH
ZD
ZD
ZD
ZD
ZD
ZD
ZD
ZD
ZD
ZD
rV
ZD
Of
Rl
Rl
Rl
Rl
Rl
Rl
Rl
fk
Vj
Vj
Vj
Vj
Vj
Vj
Vj
"}
(36,1,1) = {"
Vj
Vj
Vj
Vj
Vj
Vj
Vj
Vj
Vj
Vj
Vj
Vj
yx
ZD
iy
Rl
Rl
Rl
Rl
Rl
Rl
Rl
Rl
Rl
Rl
Rl
Rl
Rl
Rl
fk
ZD
rV
Vj
Vj
Vj
Vj
Vj
Vj
Vj
Vj
Vj
Vj
Vj
Vj
Vj
Vj
Vj
"}
(37,1,1) = {"
Vj
Vj
Vj
Vj
Vj
Vj
Vj
Vj
Vj
Vj
Vj
Vj
yx
ZD
ZD
ZD
ZD
ZD
ZD
ZD
ZD
ZD
ZD
ZD
ZD
ZD
ZD
ZD
ZD
ZD
ZD
rV
Vj
Vj
Vj
Vj
Vj
Vj
Vj
Vj
Vj
Vj
Vj
Vj
Vj
Vj
Vj
"}
(38,1,1) = {"
Vj
Vj
Vj
Vj
Vj
Vj
Vj
Vj
Vj
Vj
Vj
Vj
iy
Rl
Rl
Rl
Rl
Rl
Rl
Rl
Rl
Rl
Rl
Rl
Rl
Rl
Rl
Rl
Rl
Rl
Rl
fk
Vj
Vj
Vj
Vj
Vj
Vj
Vj
Vj
Vj
Vj
Vj
Vj
Vj
Vj
Vj
"}
