"a" = (/turf/template_noop,/area/template_noop)
"b" = (/turf/template_noop,/area/submap/Epod2)
"c" = (/turf/simulated/floor/outdoors/rocks,/area/submap/Epod2)
"d" = (/turf/simulated/floor/outdoors/dirt,/area/submap/Epod2)
"e" = (/obj/structure/boulder{icon_state = "boulder3"},/turf/simulated/floor/outdoors/dirt,/area/submap/Epod2)
"f" = (/obj/structure/boulder{icon_state = "boulder2"},/turf/simulated/floor/outdoors/dirt,/area/submap/Epod2)
"g" = (/obj/structure/boulder{icon_state = "boulder3"},/turf/simulated/floor/outdoors/rocks,/area/submap/Epod2)
"h" = (/turf/simulated/shuttle/wall,/area/submap/Epod2)
"i" = (/obj/structure/shuttle/engine/propulsion/burst{icon_state = "propulsion"; dir = 4},/turf/simulated/shuttle/wall,/area/submap/Epod2)
"j" = (/obj/structure/boulder,/turf/simulated/floor/outdoors/rocks,/area/submap/Epod2)
"k" = (/obj/structure/grille{density = 0; icon_state = "brokengrille"},/obj/structure/window/reinforced{dir = 1; health = 1e+006},/obj/structure/window/reinforced,/obj/item/stack/rods,/obj/item/weapon/material/shard,/obj/item/weapon/material/shard{icon_state = "medium"},/turf/simulated/shuttle/plating,/area/submap/Epod2)
"l" = (/obj/structure/bed/chair{icon_state = "chair_preview"; dir = 8},/obj/structure/loot_pile/surface/bones,/obj/effect/decal/cleanable/blood,/obj/effect/decal/cleanable/dirt,/obj/machinery/status_display{pixel_y = -32},/obj/item/device/radio/intercom{dir = 1; name = "Station Intercom (General)"; pixel_y = 21},/turf/simulated/shuttle/floor,/area/submap/Epod2)
"m" = (/obj/structure/bed/chair{icon_state = "chair_preview"; dir = 8},/obj/structure/loot_pile/surface/medicine_cabinet{pixel_y = 28},/obj/machinery/light,/obj/effect/decal/cleanable/vomit,/obj/effect/decal/cleanable/blood/drip,/obj/effect/decal/cleanable/dirt,/obj/effect/decal/cleanable/blood/drip,/obj/item/weapon/reagent_containers/hypospray/autoinjector/empty,/turf/simulated/shuttle/floor,/area/submap/Epod2)
"n" = (/obj/structure/bed/chair{icon_state = "chair_preview"; dir = 8},/obj/structure/closet/walllocker/emerglocker{pixel_y = 28},/obj/effect/decal/cleanable/dirt,/obj/effect/decal/cleanable/blood/drip,/turf/simulated/shuttle/floor,/area/submap/Epod2)
"o" = (/obj/effect/decal/cleanable/blood/drip,/obj/machinery/door/airlock/external{icon_state = "door_locked"; locked = 1; name = "Escape Pod Hatch"},/turf/simulated/shuttle/floor,/area/submap/Epod2)
"p" = (/obj/structure/boulder{icon_state = "boulder4"},/turf/simulated/floor/outdoors/dirt,/area/submap/Epod2)
"q" = (/obj/structure/boulder{icon_state = "boulder2"},/turf/simulated/floor/outdoors/rocks,/area/submap/Epod2)

(1,1,1) = {"
aaaaaaaaaaaaaaa
abbcdbbbbbbbbba
abdefdcddbbbbba
adghhhhicdddbba
afjklmnoccccdda
apbhhhhicccdcca
abqdpddcddcccca
abbbbbcdbcddcda
abbbbbbbbbdbdda
aaaaaaaaaaaaaaa
"}
