//MAP CONVERTED BY dmm2tgm.py THIS HEADER COMMENT PREVENTS RECONVERSION, DO NOT REMOVE
"a" = (
/turf/template_noop,
/area/submap/hotspring)
"c" = (
/obj/structure/bonfire/sifwood,
/turf/simulated/floor/outdoors/dirt/virgo3b,
/area/submap/hotspring)
"e" = (
/obj/structure/window/reinforced{
	dir = 8;
	health = 1e+006
	},
/obj/structure/loot_pile/maint/trash,
/turf/simulated/floor/outdoors/grass/sif/virgo3b,
/area/submap/hotspring)
"g" = (
/turf/simulated/floor/outdoors/mud/virgo3b,
/area/submap/hotspring)
"h" = (
/obj/structure/window/reinforced{
	dir = 8;
	health = 1e+006
	},
/turf/simulated/floor/outdoors/grass/sif/virgo3b,
/area/submap/hotspring)
"i" = (
/obj/random/trash,
/turf/simulated/floor/outdoors/grass/sif/virgo3b,
/area/submap/hotspring)
"j" = (
/obj/structure/table/rack,
/obj/item/weapon/storage/fancy/candle_box,
/obj/item/weapon/flame/lighter/random{
	pixel_x = 7
	},
/obj/item/weapon/storage/fancy/candle_box{
	pixel_x = -6
	},
/obj/item/weapon/storage/firstaid{
	pixel_x = 4;
	pixel_y = -6
	},
/obj/item/weapon/wrapping_paper,
/turf/simulated/floor/wood/sif/virgo3b,
/area/submap/hotspring)
"k" = (
/obj/effect/effect/steam,
/obj/effect/map_effect/interval/effect_emitter/steam,
/turf/simulated/floor/water/virgo3b,
/area/submap/hotspring)
"o" = (
/obj/structure/table/woodentable,
/obj/item/weapon/material/harpoon,
/obj/item/pizzabox/vegetable,
/turf/simulated/floor/wood/sif/virgo3b,
/area/submap/hotspring)
"r" = (
/obj/item/weapon/material/shard,
/obj/structure/bed/chair{
	dir = 1
	},
/turf/simulated/floor/wood/sif/virgo3b,
/area/submap/hotspring)
"s" = (
/obj/random/junk,
/turf/simulated/floor/outdoors/dirt/virgo3b,
/area/submap/hotspring)
"t" = (
/obj/structure/table/bench/wooden,
/turf/simulated/floor/outdoors/dirt/virgo3b,
/area/submap/hotspring)
"u" = (
/obj/random/junk,
/turf/simulated/floor/outdoors/mud/virgo3b,
/area/submap/hotspring)
"w" = (
/obj/structure/closet/crate/bin,
/turf/simulated/floor/wood/sif/virgo3b,
/area/submap/hotspring)
"x" = (
/obj/structure/table/woodentable,
/obj/item/trash/candle,
/turf/simulated/floor/wood/sif/virgo3b,
/area/submap/hotspring)
"D" = (
/obj/structure/window/reinforced{
	dir = 4;
	health = 1e+006
	},
/turf/template_noop,
/area/submap/hotspring)
"F" = (
/turf/simulated/floor/outdoors/dirt/virgo3b,
/area/submap/hotspring)
"H" = (
/obj/random/trash,
/turf/simulated/floor/outdoors/mud/virgo3b,
/area/submap/hotspring)
"J" = (
/obj/structure/simple_door/sifwood,
/turf/simulated/floor/wood/sif/virgo3b,
/area/submap/hotspring)
"K" = (
/turf/simulated/floor/outdoors/grass/sif/virgo3b,
/area/submap/hotspring)
"L" = (
/obj/item/weapon/inflatable_duck,
/obj/effect/effect/steam,
/turf/simulated/floor/water/virgo3b,
/area/submap/hotspring)
"M" = (
/obj/random/junk,
/obj/random/junk,
/turf/simulated/floor/wood/sif/virgo3b,
/area/submap/hotspring)
"N" = (
/turf/simulated/floor/outdoors/rocks/virgo3b,
/area/submap/hotspring)
"O" = (
/obj/structure/loot_pile/maint/trash,
/turf/template_noop,
/area/submap/hotspring)
"R" = (
/obj/structure/window/reinforced{
	dir = 8;
	health = 1e+006
	},
/obj/item/weapon/material/shard,
/obj/structure/loot_pile/maint/trash,
/turf/template_noop,
/area/submap/hotspring)
"T" = (
/turf/simulated/floor/wood/sif/virgo3b,
/area/submap/hotspring)
"U" = (
/obj/structure/table/rack,
/obj/item/clothing/under/swimsuit/striped,
/obj/item/clothing/under/swimsuit/stripper/stripper_pink,
/turf/simulated/floor/wood/sif/virgo3b,
/area/submap/hotspring)
"V" = (
/obj/effect/effect/steam,
/turf/simulated/floor/water/virgo3b,
/area/submap/hotspring)
"X" = (
/obj/random/junk,
/obj/random/junk,
/turf/simulated/floor/outdoors/dirt/virgo3b,
/area/submap/hotspring)
"Y" = (
/turf/simulated/wall/log_sif,
/area/submap/hotspring)
"Z" = (
/obj/structure/window/reinforced{
	dir = 8;
	health = 1e+006
	},
/turf/template_noop,
/area/submap/hotspring)

(1,1,1) = {"
D
D
D
D
a
a
a
a
a
a
a
a
a
a
a
"}
(2,1,1) = {"
Y
o
r
Y
O
a
a
F
a
a
a
a
a
K
a
"}
(3,1,1) = {"
Y
x
M
Y
K
K
t
c
t
K
K
K
K
g
a
"}
(4,1,1) = {"
Y
w
T
Y
X
K
K
F
K
F
K
K
K
F
a
"}
(5,1,1) = {"
Y
j
T
J
g
F
s
g
F
u
F
i
F
a
a
"}
(6,1,1) = {"
Y
U
T
Y
g
g
g
g
g
g
t
K
K
a
a
"}
(7,1,1) = {"
R
Z
e
h
F
g
V
V
V
N
t
K
F
g
a
"}
(8,1,1) = {"
a
a
K
t
g
N
L
k
V
g
t
K
K
F
a
"}
(9,1,1) = {"
a
a
K
t
g
V
V
V
V
g
F
K
K
a
a
"}
(10,1,1) = {"
a
a
K
t
H
V
V
V
g
g
g
F
K
a
a
"}
(11,1,1) = {"
a
K
F
u
g
V
V
N
F
s
F
K
K
a
a
"}
(12,1,1) = {"
F
F
K
F
N
g
g
F
K
K
K
K
F
a
a
"}
(13,1,1) = {"
a
a
K
F
g
g
s
K
K
K
F
F
K
a
a
"}
(14,1,1) = {"
a
g
K
K
F
K
K
i
K
F
K
K
K
K
a
"}
(15,1,1) = {"
a
a
a
a
K
a
a
a
a
g
a
a
a
a
a
"}
