"aa" = (/turf/template_noop,/area/submap/house1)
"ab" = (/obj/structure/railing,/turf/template_noop,/area/submap/house1)
"ac" = (/obj/structure/railing{dir = 4},/turf/template_noop,/area/submap/house1)
"ad" = (/turf/simulated/floor/outdoors/grass/sif,/area/submap/house1)
"ae" = (/obj/structure/railing{dir = 8},/turf/template_noop,/area/submap/house1)
"af" = (/obj/structure/railing{dir = 4},/turf/simulated/floor/outdoors/grass/sif,/area/submap/house1)
"ag" = (/turf/simulated/floor/outdoors/dirt,/area/submap/house1)
"ah" = (/obj/structure/table/bench/wooden,/turf/simulated/floor/outdoors/dirt,/area/submap/house1)
"ai" = (/obj/structure/railing{dir = 8},/turf/simulated/floor/outdoors/grass/sif,/area/submap/house1)
"aj" = (/obj/structure/target_stake,/turf/simulated/floor/outdoors/dirt,/area/submap/house1)
"ak" = (/obj/structure/bonfire/sifwood,/turf/simulated/floor/outdoors/dirt,/area/submap/house1)
"al" = (/obj/item/target,/turf/simulated/floor/outdoors/grass/sif,/area/submap/house1)
"am" = (/obj/item/target/syndicate,/turf/simulated/floor/outdoors/grass/sif,/area/submap/house1)
"an" = (/turf/simulated/wall/wood,/area/submap/house1)
"ao" = (/obj/structure/simple_door/wood,/turf/simulated/floor/wood,/area/submap/house1)
"ap" = (/obj/structure/table/marble,/obj/item/weapon/material/kitchen/rollingpin,/turf/simulated/floor/tiled,/area/submap/house1)
"aq" = (/obj/structure/table/marble,/obj/item/weapon/material/knife,/turf/simulated/floor/tiled,/area/submap/house1)
"ar" = (/obj/structure/grille/rustic,/obj/structure/window/reinforced/full,/turf/simulated/floor/plating,/area/submap/house1)
"as" = (/turf/simulated/floor/wood,/area/submap/house1)
"at" = (/obj/structure/table/standard,/obj/item/weapon/reagent_containers/hypospray/autoinjector/biginjector/brute,/obj/item/weapon/reagent_containers/hypospray/autoinjector/biginjector/burn,/obj/item/weapon/reagent_containers/hypospray/autoinjector/biginjector/purity,/turf/simulated/floor/tiled/freezer,/area/submap/house1)
"au" = (/obj/structure/toilet,/turf/simulated/floor/tiled/freezer,/area/submap/house1)
"av" = (/obj/structure/table/marble,/obj/random/drinkbottle,/turf/simulated/floor/tiled,/area/submap/house1)
"aw" = (/obj/item/device/flashlight/lantern,/turf/simulated/floor/tiled,/area/submap/house1)
"ax" = (/obj/structure/table/glass,/obj/structure/window/reinforced,/obj/item/weapon/coin/phoron,/turf/simulated/floor/wood,/area/submap/house1)
"ay" = (/obj/item/clothing/head/bearpelt{pixel_y = 6},/obj/structure/table/glass,/obj/structure/window/reinforced,/turf/simulated/floor/wood,/area/submap/house1)
"az" = (/obj/item/weapon/material/harpoon,/obj/structure/table/glass,/obj/structure/window/reinforced,/turf/simulated/floor/wood,/area/submap/house1)
"aA" = (/obj/structure/table/glass,/obj/structure/window/reinforced,/obj/item/clothing/accessory/medal/conduct{pixel_y = 6},/turf/simulated/floor/wood,/area/submap/house1)
"aB" = (/obj/structure/sink{icon_state = "sink"; dir = 8; pixel_x = -12; pixel_y = 2},/obj/structure/mirror{dir = 4; pixel_x = -28; pixel_y = 0},/turf/simulated/floor/tiled/freezer,/area/submap/house1)
"aC" = (/obj/item/weapon/towel,/turf/simulated/floor/tiled/freezer,/area/submap/house1)
"aD" = (/obj/structure/closet/secure_closet/freezer/fridge,/turf/simulated/floor/tiled,/area/submap/house1)
"aE" = (/turf/simulated/floor/tiled,/area/submap/house1)
"aF" = (/obj/structure/simple_door/wood,/turf/simulated/floor/tiled,/area/submap/house1)
"aG" = (/obj/structure/simple_door/wood,/turf/simulated/floor/tiled/freezer,/area/submap/house1)
"aH" = (/obj/item/device/flashlight/lantern,/turf/simulated/floor/tiled/freezer,/area/submap/house1)
"aI" = (/obj/structure/window/reinforced/tinted{dir = 8; icon_state = "twindow"},/obj/machinery/shower{dir = 1},/obj/random/soap,/turf/simulated/floor/tiled/freezer,/area/submap/house1)
"aJ" = (/turf/simulated/floor/carpet/turcarpet,/area/submap/house1)
"aK" = (/obj/structure/bed/chair/wood,/turf/simulated/floor/carpet/turcarpet,/area/submap/house1)
"aL" = (/obj/structure/bed/chair/wood{dir = 4},/turf/simulated/floor/carpet/turcarpet,/area/submap/house1)
"aM" = (/obj/structure/table/wooden_reinforced,/obj/item/weapon/storage/fancy/candle_box,/turf/simulated/floor/carpet/turcarpet,/area/submap/house1)
"aN" = (/obj/structure/table/wooden_reinforced,/obj/item/device/binoculars/spyglass,/turf/simulated/floor/carpet/turcarpet,/area/submap/house1)
"aO" = (/obj/structure/table/wooden_reinforced,/obj/item/device/flashlight/lantern,/turf/simulated/floor/carpet/turcarpet,/area/submap/house1)
"aP" = (/obj/structure/bed/chair/wood{dir = 1},/turf/simulated/floor/carpet/turcarpet,/area/submap/house1)
"aQ" = (/obj/structure/table/rack,/obj/item/device/gps/explorer,/turf/simulated/floor/wood,/area/submap/house1)
"aR" = (/obj/structure/simple_door/wood,/turf/simulated/floor/carpet/sblucarpet,/area/submap/house1)
"aS" = (/turf/simulated/floor/carpet/sblucarpet,/area/submap/house1)
"aT" = (/obj/machinery/space_heater,/turf/simulated/floor/carpet/sblucarpet,/area/submap/house1)
"aU" = (/obj/structure/table/rack,/obj/item/clothing/under/explorer,/obj/item/weapon/cell/device,/obj/item/weapon/cell/device,/obj/item/weapon/cell/device,/turf/simulated/floor/wood,/area/submap/house1)
"aV" = (/obj/item/device/flashlight/lantern,/turf/simulated/floor/wood,/area/submap/house1)
"aW" = (/obj/machinery/space_heater,/turf/simulated/floor/wood,/area/submap/house1)
"aX" = (/obj/structure/coatrack,/turf/simulated/floor/wood,/area/submap/house1)
"aY" = (/obj/structure/table/rack,/obj/item/clothing/suit/storage/hooded/explorer,/obj/item/clothing/mask/gas/explorer,/obj/item/weapon/material/knife/tacknife/survival,/turf/simulated/floor/wood,/area/submap/house1)
"aZ" = (/obj/item/clothing/shoes/boots/winter/explorer,/turf/simulated/floor/wood,/area/submap/house1)
"ba" = (/obj/structure/table/woodentable,/obj/random/action_figure,/obj/item/device/flashlight/lantern,/turf/simulated/floor/carpet/sblucarpet,/area/submap/house1)
"bb" = (/obj/item/weapon/bedsheet/hopdouble,/obj/structure/bed/double/padded,/turf/simulated/floor/carpet/sblucarpet,/area/submap/house1)
"bc" = (/obj/structure/sign/kiddieplaque{desc = "To anyone reading this, you'll note that I'm not home right now, and unfortunately due to reassignment, I won't be for a very long time. Exploring somewhere really far and dangerous now. You can stay if you want, but please try to keep my home in good condition."; name = "read me visitors"},/turf/simulated/wall/wood,/area/submap/house1)
"bd" = (/obj/structure/loot_pile/maint/trash,/turf/simulated/floor/outdoors/grass/sif,/area/submap/house1)
"be" = (/obj/structure/loot_pile/maint/junk,/turf/simulated/floor/outdoors/grass/sif,/area/submap/house1)

(1,1,1) = {"
aaabababababababababababababababaa
acadadadadadadadadadadadadadadadae
afadagagagagagagagagagahahahagadai
afagajagagagagagagagagagakagagagai
afadagagagagagagagagagahahahagadai
afalamaladadadagagagadadadadadadai
adananananadadanaoanadadananananad
adanapaqanarananasananaranatauanad
adaravawanaxayanaoanazaAanaBaCanad
adanaDaEaFasasasasasasasaGaHaIanad
adananananasaJaKaKaKaJasananananad
adadadadanasaLaMaNaOaPasanadadadad
adananananasaJaPaPaPaJasananananad
adanaQasaoasasasasasasasaRaSaTanad
adaraUaVanasaWanaoanaXasanaSaSarad
adanaYaZanarananasananaranbabbanad
adananananadadanaobcadadananananad
adbdbdbdbeadadadagadadadadadadadad
adagagagagagagagagagagagagagagagad
adagagagagagagagagagagagagagagagad
"}
