"ai" = (/obj/structure/table/steel_reinforced,/obj/item/weapon/paper_bin,/obj/item/weapon/pen/fountain,/turf/simulated/floor/tiled/steel_dirty,/area/submap/methlab)
"as" = (/obj/machinery/door/airlock,/turf/simulated/floor/tiled/steel_grid,/area/submap/methlab)
"aY" = (/obj/item/weapon/material/shard{pixel_x = 5; pixel_y = 3},/obj/item/weapon/material/shard{pixel_x = 9},/turf/template_noop,/area/submap/methlab)
"bn" = (/obj/structure/fence/cut/medium,/turf/template_noop,/area/submap/methlab)
"bA" = (/obj/item/weapon/cell/hyper,/turf/simulated/floor/tiled/steel_dirty,/area/submap/methlab)
"bJ" = (/obj/effect/floor_decal/rust,/obj/random/maintenance,/turf/simulated/floor/tiled/steel_dirty,/area/submap/methlab)
"bQ" = (/obj/item/weapon/material/shard{icon_state = "medium"},/obj/item/weapon/material/shard{pixel_x = 9},/obj/item/weapon/material/shard{pixel_x = 5},/turf/template_noop,/area/submap/methlab)
"cg" = (/obj/structure/table/steel_reinforced,/obj/item/device/radio{anchored = 1; canhear_range = 1; frequency = 1487; icon = 'icons/obj/items.dmi'; icon_state = "red_phone"; name = "Reception Emergency Phone"},/turf/simulated/floor/tiled/steel_dirty,/area/submap/methlab)
"ck" = (/obj/machinery/portable_atmospherics/hydroponics,/obj/item/seeds/ambrosiadeusseed,/obj/effect/floor_decal/industrial/hatch/yellow,/turf/simulated/floor/tiled/old_tile/white,/area/submap/methlab)
"dy" = (/obj/effect/floor_decal/industrial/warning/corner,/obj/effect/floor_decal/rust,/obj/random/maintenance,/turf/simulated/floor/tiled/steel_dirty,/area/submap/methlab)
"fr" = (/obj/structure/fence,/turf/template_noop,/area/submap/methlab)
"fD" = (/obj/effect/floor_decal/industrial/warning{dir = 8},/turf/simulated/floor/tiled/techfloor,/area/submap/methlab)
"fY" = (/obj/item/stack/cable_coil,/obj/effect/decal/cleanable/dirt,/turf/simulated/floor,/area/submap/methlab)
"hf" = (/turf/simulated/floor,/area/submap/methlab)
"hj" = (/obj/machinery/power/port_gen/pacman,/turf/simulated/floor,/area/submap/methlab)
"hE" = (/obj/machinery/door/airlock/vault/bolted,/turf/simulated/floor/tiled/techfloor/grid,/area/submap/methlab)
"hQ" = (/turf/simulated/floor/tiled/steel_dirty,/area/submap/methlab)
"ic" = (/obj/machinery/portable_atmospherics/hydroponics,/obj/machinery/light{dir = 8},/obj/item/seeds/ambrosiavulgarisseed,/obj/effect/floor_decal/industrial/hatch/yellow,/turf/simulated/floor/tiled/old_tile/white,/area/submap/methlab)
"iz" = (/obj/effect/decal/cleanable/dirt,/turf/simulated/floor,/area/submap/methlab)
"iN" = (/obj/structure/table/steel_reinforced,/obj/item/weapon/reagent_containers/dropper,/turf/simulated/floor/tiled/steel_dirty,/area/submap/methlab)
"jm" = (/obj/structure/fence{dir = 4},/turf/simulated/floor/outdoors/dirt,/area/submap/methlab)
"jo" = (/obj/machinery/vending/hydronutrients,/turf/simulated/floor/tiled/old_tile/white,/area/submap/methlab)
"kp" = (/obj/effect/floor_decal/rust/mono_rusted3,/obj/effect/decal/cleanable/dirt,/turf/simulated/floor/tiled/old_tile/green,/area/submap/methlab)
"lb" = (/obj/machinery/biogenerator,/turf/simulated/floor/tiled/old_tile/white,/area/submap/methlab)
"lt" = (/obj/item/frame/apc,/obj/structure/table/steel,/obj/machinery/light_switch{pixel_x = 11; pixel_y = 22},/turf/simulated/floor,/area/submap/methlab)
"lx" = (/turf/simulated/floor/outdoors/dirt,/area/submap/methlab)
"lJ" = (/obj/structure/fence/corner,/turf/template_noop,/area/submap/methlab)
"lN" = (/obj/structure/barricade,/obj/effect/floor_decal/steeldecal/steel_decals_central5,/turf/simulated/floor/tiled/steel_dirty,/area/submap/methlab)
"me" = (/obj/structure/salvageable/data,/turf/simulated/floor/tiled/steel_dirty,/area/submap/methlab)
"mi" = (/obj/effect/floor_decal/sign,/turf/simulated/wall,/area/submap/methlab)
"mw" = (/obj/structure/table/steel_reinforced,/obj/item/weapon/storage/toolbox/syndicate,/turf/simulated/floor/tiled/steel_dirty,/area/submap/methlab)
"nq" = (/obj/random/junk,/turf/simulated/floor,/area/submap/methlab)
"oo" = (/obj/machinery/portable_atmospherics/hydroponics,/obj/item/seeds/ambrosiainfernusseed,/obj/effect/floor_decal/industrial/hatch/yellow,/turf/simulated/floor/tiled/old_tile/white,/area/submap/methlab)
"oF" = (/obj/structure/fence/cut/large,/turf/template_noop,/area/submap/methlab)
"oN" = (/turf/simulated/wall/r_wall,/area/submap/methlab)
"pq" = (/obj/structure/bed/chair{dir = 8},/obj/random/junk,/turf/simulated/floor/tiled/steel_dirty,/area/submap/methlab)
"ps" = (/turf/template_noop,/area/submap/methlab)
"rK" = (/obj/item/weapon/reagent_containers/glass/beaker/large,/obj/effect/decal/cleanable/dirt,/turf/simulated/floor,/area/submap/methlab)
"rU" = (/obj/item/clothing/under/suit_jacket,/obj/item/clothing/shoes/dress{pixel_y = -9},/obj/item/clothing/mask/demon,/obj/structure/curtain/black,/turf/simulated/floor/tiled/techfloor,/area/submap/methlab)
"sI" = (/obj/machinery/light,/obj/effect/floor_decal/rust,/obj/effect/decal/cleanable/dirt,/obj/random/maintenance,/turf/simulated/floor/tiled/steel_dirty,/area/submap/methlab)
"sW" = (/obj/item/weapon/material/shard{pixel_x = 9},/turf/template_noop,/area/submap/methlab)
"tt" = (/obj/structure/table/steel_reinforced,/obj/structure/salvageable/personal,/turf/simulated/floor/tiled/steel_dirty,/area/submap/methlab)
"tz" = (/obj/effect/wingrille_spawn/reinforced,/turf/simulated/floor/tiled/techfloor,/area/submap/methlab)
"tL" = (/obj/effect/floor_decal/rust,/obj/effect/decal/cleanable/dirt,/obj/effect/decal/cleanable/dirt,/turf/simulated/floor/tiled/steel_dirty,/area/submap/methlab)
"tQ" = (/obj/structure/girder,/turf/simulated/floor,/area/submap/methlab)
"uA" = (/obj/structure/fence/cut/large{dir = 8},/turf/template_noop,/area/submap/methlab)
"uY" = (/obj/random/trash,/turf/simulated/floor/tiled/steel_dirty,/area/submap/methlab)
"wd" = (/turf/simulated/floor/tiled/old_tile/green,/area/submap/methlab)
"wI" = (/obj/item/weapon/reagent_containers/dropper,/obj/random/junk,/obj/effect/decal/cleanable/dirt,/turf/simulated/floor/tiled/steel_dirty,/area/submap/methlab)
"wQ" = (/obj/machinery/light{dir = 8},/turf/template_noop,/area/submap/methlab)
"xM" = (/obj/machinery/door/airlock,/obj/effect/decal/cleanable/dirt,/turf/simulated/floor/tiled/steel_grid,/area/submap/methlab)
"xR" = (/obj/structure/loot_pile/maint/technical,/turf/template_noop,/area/submap/methlab)
"yr" = (/obj/random/trash,/turf/simulated/floor,/area/submap/methlab)
"yM" = (/obj/item/clothing/under/suit_jacket/really_black,/obj/item/clothing/shoes/dress{pixel_y = -9},/obj/item/clothing/mask/luchador,/obj/structure/curtain/black,/turf/simulated/floor/tiled/techfloor,/area/submap/methlab)
"yY" = (/obj/effect/floor_decal/rust,/obj/effect/decal/cleanable/dirt,/turf/simulated/floor/tiled/steel_dirty,/area/submap/methlab)
"zu" = (/obj/effect/decal/cleanable/dirt,/obj/effect/decal/cleanable/dirt,/turf/simulated/floor/tiled/old_tile/green,/area/submap/methlab)
"zG" = (/obj/random/junk,/turf/template_noop,/area/submap/methlab)
"zH" = (/obj/machinery/light{dir = 4},/turf/template_noop,/area/submap/methlab)
"zZ" = (/obj/structure/fence/corner{dir = 4},/turf/template_noop,/area/submap/methlab)
"AB" = (/obj/structure/table/steel_reinforced,/obj/item/weapon/reagent_containers/glass/beaker/large,/turf/simulated/floor/tiled/steel_dirty,/area/submap/methlab)
"AM" = (/mob/living/simple_mob/humanoid/merc/melee/poi,/obj/effect/decal/cleanable/dirt,/turf/simulated/floor/tiled/steel_dirty,/area/submap/methlab)
"AW" = (/obj/random/junk,/obj/effect/decal/cleanable/dirt,/turf/simulated/floor/tiled/steel_dirty,/area/submap/methlab)
"BP" = (/obj/effect/decal/cleanable/dirt,/obj/effect/decal/cleanable/dirt,/obj/effect/decal/cleanable/dirt,/turf/simulated/floor/tiled/steel_dirty,/area/submap/methlab)
"BR" = (/obj/structure/table/steel_reinforced,/obj/item/weapon/reagent_containers/glass/bucket,/obj/item/weapon/reagent_containers/glass/bucket,/turf/simulated/floor/tiled/steel_dirty,/area/submap/methlab)
"BT" = (/obj/structure/safe/floor,/obj/item/weapon/reagent_containers/food/snacks/grown/ambrosiavulgaris,/obj/item/weapon/reagent_containers/food/snacks/grown/ambrosiavulgaris,/obj/item/weapon/reagent_containers/food/snacks/grown/ambrosiavulgaris,/obj/item/weapon/reagent_containers/food/snacks/grown/ambrosiavulgaris,/obj/item/weapon/reagent_containers/food/snacks/grown/ambrosiavulgaris,/obj/item/weapon/reagent_containers/food/snacks/grown/ambrosiavulgaris,/obj/item/weapon/reagent_containers/food/snacks/grown/ambrosiavulgaris,/obj/item/weapon/reagent_containers/food/snacks/grown/ambrosiavulgaris,/obj/item/weapon/reagent_containers/food/snacks/grown/ambrosiavulgaris,/obj/item/weapon/reagent_containers/food/snacks/grown/ambrosiavulgaris,/obj/item/weapon/storage/bag/cash,/obj/item/weapon/storage/bag/cash,/turf/simulated/floor,/area/submap/methlab)
"CH" = (/obj/item/seeds/ambrosiavulgarisseed,/obj/item/seeds/ambrosiavulgarisseed,/obj/item/seeds/ambrosiavulgarisseed,/obj/item/seeds/ambrosiainfernusseed,/obj/item/seeds/ambrosiainfernusseed,/obj/item/seeds/ambrosiainfernusseed,/obj/item/seeds/ambrosiadeusseed,/obj/item/seeds/ambrosiadeusseed,/obj/item/seeds/ambrosiadeusseed,/obj/structure/table/rack,/turf/simulated/floor/tiled/old_tile/white,/area/submap/methlab)
"CL" = (/obj/structure/grille/rustic,/obj/item/weapon/material/shard{icon_state = "medium"},/turf/simulated/floor/tiled/old_tile/green,/area/submap/methlab)
"CW" = (/obj/machinery/light{dir = 4},/turf/simulated/floor/tiled/techfloor,/area/submap/methlab)
"DG" = (/obj/structure/fence,/turf/simulated/floor/outdoors/dirt,/area/submap/methlab)
"DP" = (/obj/item/weapon/reagent_containers/dropper,/obj/effect/decal/cleanable/dirt,/turf/simulated/floor/tiled/steel_dirty,/area/submap/methlab)
"Eb" = (/obj/machinery/portable_atmospherics/hydroponics,/obj/item/seeds/ambrosiadeusseed,/obj/effect/floor_decal/rust,/obj/effect/floor_decal/industrial/hatch/yellow,/turf/simulated/floor/tiled/old_tile/white,/area/submap/methlab)
"EW" = (/obj/item/weapon/stool,/obj/effect/decal/cleanable/dirt,/turf/simulated/floor,/area/submap/methlab)
"Fg" = (/obj/machinery/door/airlock,/turf/simulated/floor,/area/submap/methlab)
"Gs" = (/obj/structure/table/steel_reinforced,/obj/machinery/light{dir = 1},/turf/simulated/floor/tiled/steel_dirty,/area/submap/methlab)
"GP" = (/obj/structure/flora/tree/sif,/turf/template_noop,/area/submap/methlab)
"HA" = (/obj/structure/window/reinforced/full,/obj/structure/grille/rustic,/turf/simulated/floor/tiled/old_tile/green,/area/submap/methlab)
"HN" = (/obj/machinery/porta_turret/lasertag/red{name = "REAL turret"},/turf/simulated/floor,/area/submap/methlab)
"HX" = (/obj/machinery/light,/obj/effect/floor_decal/rust,/obj/effect/decal/cleanable/dirt,/obj/effect/decal/cleanable/dirt,/obj/effect/decal/cleanable/dirt,/obj/structure/barricade,/turf/simulated/floor/tiled/steel_dirty,/area/submap/methlab)
"Ih" = (/obj/structure/sign/warning/lethal_turrets,/turf/simulated/wall,/area/submap/methlab)
"IH" = (/obj/effect/decal/cleanable/dirt,/turf/simulated/floor/tiled/old_tile/green,/area/submap/methlab)
"IQ" = (/obj/item/clothing/accessory/stethoscope,/obj/effect/floor_decal/industrial/warning{dir = 4},/turf/simulated/floor,/area/submap/methlab)
"JQ" = (/obj/effect/floor_decal/industrial/warning/corner{dir = 4},/obj/effect/floor_decal/rust,/obj/effect/floor_decal/steeldecal/steel_decals3,/turf/simulated/floor/tiled/steel_dirty,/area/submap/methlab)
"Kg" = (/obj/structure/fence/cut/medium{dir = 4},/turf/simulated/floor/outdoors/dirt,/area/submap/methlab)
"KK" = (/obj/machinery/chem_master,/obj/effect/floor_decal/rust/color_rustedfull,/turf/simulated/floor/tiled/steel_dirty,/area/submap/methlab)
"Lh" = (/obj/effect/floor_decal/rust,/turf/simulated/floor/tiled/steel_dirty,/area/submap/methlab)
"LM" = (/obj/random/trash,/obj/effect/decal/cleanable/dirt,/obj/effect/decal/cleanable/dirt,/turf/simulated/floor/tiled/steel_dirty,/area/submap/methlab)
"LX" = (/obj/item/weapon/stool,/obj/effect/decal/cleanable/dirt,/obj/effect/decal/cleanable/dirt,/turf/simulated/floor/tiled/steel_dirty,/area/submap/methlab)
"Mn" = (/obj/structure/barricade,/turf/simulated/floor,/area/submap/methlab)
"Of" = (/obj/effect/wingrille_spawn/reinforced,/obj/structure/barricade,/turf/simulated/floor/tiled/techfloor,/area/submap/methlab)
"Ol" = (/obj/effect/floor_decal/rust,/obj/effect/decal/cleanable/dirt,/obj/effect/decal/cleanable/dirt,/turf/simulated/floor/tiled/old_tile/green,/area/submap/methlab)
"Oq" = (/obj/structure/fence{dir = 4},/turf/template_noop,/area/submap/methlab)
"Py" = (/obj/random/trash,/turf/simulated/floor/outdoors/dirt,/area/submap/methlab)
"PH" = (/obj/machinery/seed_extractor,/turf/simulated/floor/tiled/old_tile/white,/area/submap/methlab)
"PO" = (/obj/structure/table/steel_reinforced,/obj/item/weapon/module/power_control,/turf/simulated/floor/tiled/steel_dirty,/area/submap/methlab)
"PZ" = (/obj/effect/floor_decal/rust,/obj/effect/decal/cleanable/dirt,/turf/simulated/floor/tiled/old_tile/green,/area/submap/methlab)
"QP" = (/obj/structure/table/steel_reinforced,/turf/simulated/floor/tiled/steel_dirty,/area/submap/methlab)
"QW" = (/obj/effect/floor_decal/rust,/turf/simulated/floor/tiled/old_tile/green,/area/submap/methlab)
"Sn" = (/obj/structure/barricade,/obj/effect/floor_decal/steeldecal/steel_decals_central5,/obj/effect/decal/cleanable/dirt,/obj/effect/decal/cleanable/dirt,/obj/effect/decal/cleanable/dirt,/turf/simulated/floor/tiled/steel_dirty,/area/submap/methlab)
"St" = (/obj/structure/salvageable/implant_container,/turf/simulated/floor/tiled/steel_dirty,/area/submap/methlab)
"Ti" = (/obj/machinery/portable_atmospherics/hydroponics,/obj/machinery/light{dir = 4},/obj/item/seeds/ambrosiadeusseed,/obj/effect/floor_decal/industrial/hatch/yellow,/turf/simulated/floor/tiled/old_tile/white,/area/submap/methlab)
"Tr" = (/obj/item/weapon/stool,/obj/effect/floor_decal/rust,/obj/random/maintenance/engineering,/turf/simulated/floor/tiled/steel_dirty,/area/submap/methlab)
"Ts" = (/obj/random/maintenance,/turf/simulated/floor/tiled/steel_dirty,/area/submap/methlab)
"Ty" = (/obj/item/clothing/under/suit_jacket/burgundy,/obj/item/clothing/shoes/dress{pixel_y = -9},/obj/item/clothing/mask/dolphin,/obj/structure/curtain/black,/turf/simulated/floor/tiled/techfloor,/area/submap/methlab)
"TU" = (/obj/structure/safe/floor,/obj/item/weapon/reagent_containers/food/snacks/grown/ambrosiadeus,/obj/item/weapon/reagent_containers/food/snacks/grown/ambrosiadeus,/obj/item/weapon/reagent_containers/food/snacks/grown/ambrosiadeus,/obj/item/weapon/reagent_containers/food/snacks/grown/ambrosiadeus,/obj/item/weapon/reagent_containers/food/snacks/grown/ambrosiadeus,/obj/item/weapon/reagent_containers/food/snacks/grown/ambrosiadeus,/obj/item/weapon/reagent_containers/food/snacks/grown/ambrosiadeus,/obj/item/weapon/reagent_containers/food/snacks/grown/ambrosiadeus,/obj/item/weapon/reagent_containers/food/snacks/grown/ambrosiadeus,/obj/item/weapon/reagent_containers/food/snacks/grown/ambrosiadeus,/obj/item/weapon/storage/bag/cash,/obj/item/weapon/storage/bag/cash,/turf/simulated/floor,/area/submap/methlab)
"Uy" = (/obj/structure/fence/corner{dir = 8},/turf/template_noop,/area/submap/methlab)
"UD" = (/obj/item/clothing/under/suit_jacket/red,/obj/item/clothing/shoes/dress{pixel_y = -9},/obj/item/clothing/mask/goblin,/obj/structure/curtain/black,/turf/simulated/floor/tiled/techfloor,/area/submap/methlab)
"UO" = (/obj/item/weapon/material/shard{icon_state = "medium"},/turf/template_noop,/area/submap/methlab)
"Vf" = (/obj/effect/decal/cleanable/dirt,/obj/effect/decal/cleanable/dirt,/obj/random/maintenance/cargo,/turf/simulated/floor/tiled/old_tile/green,/area/submap/methlab)
"Vu" = (/obj/structure/fence/cut/medium{dir = 4},/turf/template_noop,/area/submap/methlab)
"Vw" = (/obj/effect/decal/cleanable/dirt,/obj/effect/decal/cleanable/dirt,/obj/random/maintenance,/turf/simulated/floor/tiled/steel_dirty,/area/submap/methlab)
"VV" = (/obj/structure/fence/corner{dir = 10},/turf/template_noop,/area/submap/methlab)
"Wp" = (/obj/structure/loot_pile/maint/trash,/turf/template_noop,/area/submap/methlab)
"Xi" = (/turf/simulated/wall,/area/submap/methlab)
"Xo" = (/obj/effect/floor_decal/rust,/obj/random/maintenance/engineering,/turf/simulated/floor/tiled/old_tile/green,/area/submap/methlab)
"Xr" = (/obj/item/stack/material/phoron{amount = 5},/obj/item/stack/material/phoron{amount = 5},/obj/item/weapon/extinguisher,/obj/item/weapon/storage/box/lights/mixed,/turf/simulated/floor,/area/submap/methlab)
"Yz" = (/obj/machinery/portable_atmospherics/hydroponics,/obj/item/seeds/ambrosiavulgarisseed,/obj/effect/floor_decal/industrial/hatch/yellow,/turf/simulated/floor/tiled/old_tile/white,/area/submap/methlab)
"Zp" = (/obj/structure/grille/rustic,/obj/item/weapon/material/shard{pixel_x = 5; pixel_y = 3},/turf/simulated/floor/tiled/old_tile/green,/area/submap/methlab)
"Zt" = (/obj/structure/salvageable/autolathe,/obj/effect/floor_decal/rust/color_rustedfull,/turf/simulated/floor/tiled/steel_dirty,/area/submap/methlab)

(1,1,1) = {"
UyOqOqVuOqOqOqVuOqOqOqjmjmOqOqOqVuOqOqzZ
frpspspspspspspspspsXitzOfOfIhpspspspsfr
frpspsHNpspsGPpspsXiXiKKGsQPXiXipsGPpsoF
oFpspshfpspslxpspsXibArKDPTrmetQWppspsps
pspspshfpszGPylxWptQKKABiNuYmeoNoNoNoNfr
pspspsIhXiOfOftzXiXibJEWyYfYdyoNBTBToNfr
frpsXiXiZtcgttaiStStKKPOABuYIQhEfDCWoNfr
frlxtzmwhfTsLhpqhQAMwItLLXAWJQoNTUTUoNoF
DGpsOfBRLhuYhfsIizLMVwBPHXSnlNoNoNoNoNfr
frWpXitQXixMXiXirUTyyMUDXiasasXihjltXifr
pspspspsHAkpHAXiXiXiXiXiXihfhfXiyrXrXifr
oFpsHAHAHAOlHAHAHAxRxRWpXiMnMnXiFgXiXifr
oFbQCLYzPZVfzuEbHApspspsXiasasXinqyrhfoF
pssWHAYzPZPHOlckHApspszHmiyrhfIhwQpspsps
pspsHAicwdjoVfTiHApspspspsPylxhfpspspsfr
bnpsHAooXolbIHckHAUOpszGpslxpsHNpspspsfr
frpsHAoowdCHQWckZpaYzGpspspslxpspsGPpsfr
pspsHAHAHAHAHAHAHApspspspslxpspspspspsfr
frpspspspspspspspspspspspspspspspspspsfr
VVOqOqOqOqOquApsOqVuOqOqOqOqKgpsuAOquAlJ
"}
