//MAP CONVERTED BY dmm2tgm.py THIS HEADER COMMENT PREVENTS RECONVERSION, DO NOT REMOVE
"ag" = (
/obj/machinery/light{
	dir = 8
	},
/obj/effect/decal/cleanable/blood/drip{
	icon_state = "5"
	},
/turf/simulated/floor/tiled,
/area/submap/OtieShelter)
"aj" = (
/obj/effect/decal/cleanable/blood/drip{
	icon_state = "5"
	},
/obj/effect/floor_decal/industrial/warning{
	dir = 1
	},
/turf/simulated/floor/plating,
/area/submap/OtieShelter)
"ar" = (
/obj/structure/closet/secure_closet/medical_wall/anesthetics,
/obj/effect/floor_decal/industrial/warning{
	dir = 8
	},
/turf/simulated/floor/tiled,
/area/submap/OtieShelter)
"cq" = (
/obj/structure/bed/chair/office/light{
	dir = 1
	},
/turf/simulated/floor/carpet/turcarpet,
/area/submap/OtieShelter)
"cU" = (
/obj/machinery/power/port_gen/pacman,
/obj/structure/cable{
	d2 = 4;
	icon_state = "0-4"
	},
/turf/simulated/floor/tiled/techfloor/grid,
/area/submap/OtieShelter)
"eI" = (
/obj/machinery/power/terminal{
	dir = 1
	},
/obj/structure/cable{
	d2 = 8;
	icon_state = "0-8"
	},
/turf/simulated/floor/tiled/techfloor/grid,
/area/submap/OtieShelter)
"fw" = (
/obj/machinery/door/airlock,
/turf/simulated/floor/tiled/techfloor/grid,
/area/submap/OtieShelter)
"gr" = (
/obj/machinery/porta_turret/poi,
/obj/effect/floor_decal/industrial/warning{
	dir = 1
	},
/turf/simulated/floor/plating,
/area/submap/OtieShelter)
"gN" = (
/obj/structure/undies_wardrobe,
/turf/simulated/floor/carpet/turcarpet,
/area/submap/OtieShelter)
"hh" = (
/obj/structure/window/phoronreinforced{
	dir = 4
	},
/obj/item/trash/bowl,
/obj/item/weapon/reagent_containers/food/snacks/meat/human,
/turf/simulated/floor/tiled,
/area/submap/OtieShelter)
"hk" = (
/obj/structure/grille/rustic,
/obj/structure/window/phoronreinforced{
	dir = 1
	},
/obj/structure/window/phoronreinforced{
	dir = 4
	},
/obj/structure/window/phoronreinforced,
/turf/simulated/floor/plating,
/area/submap/OtieShelter)
"hD" = (
/obj/effect/decal/cleanable/filth,
/turf/simulated/floor/tiled,
/area/submap/OtieShelter)
"iv" = (
/obj/structure/table/glass,
/obj/item/weapon/storage/firstaid/surgery,
/turf/simulated/floor/tiled,
/area/submap/OtieShelter)
"iC" = (
/obj/effect/decal/cleanable/blood,
/mob/living/simple_mob/otie/friendly{
	health = 0
	},
/turf/template_noop,
/area/template_noop)
"iY" = (
/obj/structure/window/phoronreinforced{
	dir = 1
	},
/obj/item/trash/bowl,
/turf/simulated/floor/tiled,
/area/submap/OtieShelter)
"jc" = (
/obj/machinery/optable,
/turf/simulated/floor/tiled,
/area/submap/OtieShelter)
"jo" = (
/obj/machinery/light{
	dir = 1
	},
/turf/simulated/floor/tiled,
/area/submap/OtieShelter)
"jy" = (
/obj/effect/decal/cleanable/blood/drip,
/turf/simulated/floor/carpet/turcarpet,
/area/submap/OtieShelter)
"jI" = (
/obj/item/weapon/material/shard{
	icon_state = "medium"
	},
/obj/effect/decal/cleanable/blood/tracks{
	color = "red";
	desc = "Your instincts say you shouldn't be following these.";
	dir = 4;
	icon = 'icons/effects/blood.dmi';
	icon_state = "tracks"
	},
/turf/simulated/floor/tiled,
/area/submap/OtieShelter)
"kF" = (
/obj/structure/window/phoronreinforced{
	dir = 1
	},
/obj/structure/dogbed,
/turf/simulated/floor/tiled,
/area/submap/OtieShelter)
"kX" = (
/obj/effect/floor_decal/industrial/warning/corner{
	dir = 4
	},
/turf/simulated/floor/tiled,
/area/submap/OtieShelter)
"lv" = (
/obj/structure/door_assembly,
/turf/simulated/floor/tiled/techfloor/grid,
/area/submap/OtieShelter)
"lP" = (
/obj/effect/decal/cleanable/blood/drip{
	icon_state = "4"
	},
/obj/effect/decal/cleanable/blood/drip{
	icon_state = "2"
	},
/obj/effect/decal/cleanable/blood,
/turf/simulated/floor/tiled,
/area/submap/OtieShelter)
"lQ" = (
/obj/structure/window/phoronreinforced{
	dir = 1
	},
/turf/simulated/floor/tiled,
/area/submap/OtieShelter)
"lY" = (
/obj/machinery/light,
/obj/effect/decal/cleanable/blood/drip{
	icon_state = "4"
	},
/turf/simulated/floor/tiled,
/area/submap/OtieShelter)
"mu" = (
/obj/structure/window/phoronreinforced{
	dir = 1
	},
/obj/structure/window/phoronreinforced{
	dir = 4
	},
/mob/living/simple_mob/otie/friendly/chubby,
/obj/item/trash/bowl,
/obj/item/weapon/reagent_containers/food/snacks/meat/human,
/turf/simulated/floor/tiled,
/area/submap/OtieShelter)
"mC" = (
/obj/structure/extinguisher_cabinet{
	pixel_x = -28
	},
/turf/simulated/floor/tiled,
/area/submap/OtieShelter)
"mJ" = (
/obj/structure/sign/warning/secure_area,
/turf/simulated/wall/r_wall,
/area/submap/OtieShelter)
"nK" = (
/obj/effect/decal/cleanable/blood/drip{
	icon_state = "3"
	},
/obj/effect/decal/cleanable/blood/drip{
	icon_state = "4"
	},
/turf/simulated/floor/tiled,
/area/submap/OtieShelter)
"nR" = (
/obj/structure/table/marble,
/obj/item/weapon/newspaper,
/obj/item/weapon/paper/card/heart,
/turf/simulated/floor/carpet/turcarpet,
/area/submap/OtieShelter)
"ob" = (
/obj/structure/grille/rustic,
/obj/structure/window/phoronreinforced{
	dir = 1
	},
/obj/structure/window/phoronreinforced,
/turf/simulated/floor/plating,
/area/submap/OtieShelter)
"od" = (
/obj/machinery/door/window,
/obj/item/weapon/bone,
/turf/simulated/floor/tiled,
/area/submap/OtieShelter)
"op" = (
/obj/effect/decal/cleanable/blood/drip{
	icon_state = "4"
	},
/turf/simulated/floor/plating,
/area/submap/OtieShelter)
"pa" = (
/obj/structure/loot_pile/surface/bones,
/obj/effect/decal/cleanable/blood,
/obj/effect/decal/cleanable/filth,
/obj/effect/decal/cleanable/filth,
/obj/random/handgun/sec,
/turf/simulated/floor/tiled,
/area/submap/OtieShelter)
"pd" = (
/obj/effect/decal/cleanable/blood/drip{
	icon_state = "5"
	},
/turf/simulated/floor/tiled,
/area/submap/OtieShelter)
"rb" = (
/obj/machinery/light{
	dir = 1
	},
/obj/effect/floor_decal/industrial/warning{
	dir = 1
	},
/turf/simulated/floor/plating,
/area/submap/OtieShelter)
"sJ" = (
/obj/structure/grille/rustic,
/obj/structure/window/phoronreinforced{
	dir = 1
	},
/obj/structure/window/phoronreinforced{
	dir = 8
	},
/obj/structure/window/phoronreinforced,
/turf/simulated/floor/plating,
/area/submap/OtieShelter)
"tt" = (
/obj/structure/window/phoronreinforced{
	dir = 1
	},
/mob/living/simple_mob/otie/cotie,
/turf/simulated/floor/tiled,
/area/submap/OtieShelter)
"tz" = (
/obj/effect/decal/cleanable/blood/drip{
	icon_state = "2"
	},
/turf/simulated/floor/carpet/turcarpet,
/area/submap/OtieShelter)
"tP" = (
/obj/structure/window/phoronreinforced{
	dir = 1
	},
/obj/structure/window/phoronreinforced{
	dir = 4
	},
/obj/item/trash/bowl,
/obj/item/weapon/reagent_containers/food/snacks/meat/human,
/turf/simulated/floor/tiled,
/area/submap/OtieShelter)
"uD" = (
/obj/machinery/light,
/turf/simulated/floor/tiled,
/area/submap/OtieShelter)
"uS" = (
/obj/machinery/light{
	dir = 4
	},
/turf/simulated/floor/tiled,
/area/submap/OtieShelter)
"vA" = (
/obj/item/weapon/bone,
/turf/simulated/floor/tiled,
/area/submap/OtieShelter)
"vB" = (
/obj/machinery/door/window{
	dir = 8
	},
/obj/item/weapon/bone,
/turf/simulated/floor/tiled,
/area/submap/OtieShelter)
"vV" = (
/obj/structure/table/woodentable,
/turf/simulated/floor/carpet/turcarpet,
/area/submap/OtieShelter)
"wO" = (
/obj/structure/dogbed,
/turf/simulated/floor/tiled,
/area/submap/OtieShelter)
"xf" = (
/obj/structure/window/phoronreinforced{
	dir = 1
	},
/obj/structure/reagent_dispensers,
/obj/effect/floor_decal/industrial/warning{
	dir = 1
	},
/turf/simulated/floor/tiled,
/area/submap/OtieShelter)
"xj" = (
/obj/structure/table/marble,
/obj/item/modular_computer/laptop/preset/custom_loadout/cheap,
/turf/simulated/floor/carpet/turcarpet,
/area/submap/OtieShelter)
"xI" = (
/obj/structure/window/phoronreinforced{
	dir = 1
	},
/mob/living/simple_mob/otie/friendly,
/obj/structure/dogbed,
/turf/simulated/floor/tiled,
/area/submap/OtieShelter)
"yD" = (
/obj/structure/table/glass,
/obj/item/weapon/storage/firstaid/adv,
/turf/simulated/floor/tiled,
/area/submap/OtieShelter)
"Aa" = (
/obj/structure/window/phoronreinforced{
	dir = 1
	},
/mob/living/simple_mob/otie/cotie/phoron,
/turf/simulated/floor/tiled,
/area/submap/OtieShelter)
"At" = (
/obj/structure/table/marble,
/obj/item/weapon/paper_bin,
/obj/item/weapon/pen,
/turf/simulated/floor/carpet/turcarpet,
/area/submap/OtieShelter)
"AO" = (
/obj/structure/table/glass,
/turf/simulated/floor/tiled,
/area/submap/OtieShelter)
"BM" = (
/obj/item/weapon/melee/baton/cattleprod,
/obj/effect/decal/cleanable/blood/tracks{
	color = "red";
	desc = "Your instincts say you shouldn't be following these.";
	dir = 4;
	icon = 'icons/effects/blood.dmi';
	icon_state = "tracks"
	},
/obj/effect/decal/cleanable/filth,
/obj/effect/floor_decal/industrial/warning{
	dir = 4
	},
/turf/simulated/floor/tiled,
/area/submap/OtieShelter)
"Cw" = (
/obj/structure/table/glass,
/obj/item/weapon/storage/firstaid,
/turf/simulated/floor/tiled,
/area/submap/OtieShelter)
"CM" = (
/obj/structure/closet/wardrobe,
/turf/simulated/floor/carpet/turcarpet,
/area/submap/OtieShelter)
"EE" = (
/obj/machinery/door/airlock/engineering,
/turf/simulated/floor/plating,
/area/submap/OtieShelter)
"EI" = (
/obj/effect/decal/cleanable/blood/drip{
	icon_state = "2"
	},
/obj/effect/decal/cleanable/blood/drip,
/turf/simulated/floor/tiled,
/area/submap/OtieShelter)
"Hk" = (
/obj/machinery/door/window,
/turf/simulated/floor/tiled,
/area/submap/OtieShelter)
"HV" = (
/obj/structure/extinguisher_cabinet{
	pixel_y = 30
	},
/turf/simulated/floor/tiled,
/area/submap/OtieShelter)
"Ih" = (
/obj/item/weapon/reagent_containers/food/snacks/meat/human,
/turf/simulated/floor/tiled,
/area/submap/OtieShelter)
"Ij" = (
/mob/living/simple_mob/otie/cotie{
	max_co2 = 0;
	max_tox = 0
	},
/turf/simulated/floor/tiled,
/area/submap/OtieShelter)
"IF" = (
/turf/simulated/floor/tiled,
/area/submap/OtieShelter)
"JY" = (
/turf/simulated/floor/plating,
/area/submap/OtieShelter)
"KJ" = (
/obj/structure/window/phoronreinforced{
	dir = 1
	},
/obj/effect/floor_decal/industrial/warning{
	dir = 1
	},
/obj/structure/closet/secure_closet/freezer/meat,
/turf/simulated/floor/tiled,
/area/submap/OtieShelter)
"Lr" = (
/obj/structure/door_assembly,
/turf/simulated/floor/plating,
/area/submap/OtieShelter)
"LF" = (
/obj/structure/ghost_pod/manual/lost_drone/dogborg,
/obj/effect/floor_decal/industrial/warning{
	dir = 4
	},
/turf/simulated/floor/tiled,
/area/submap/OtieShelter)
"Mc" = (
/obj/structure/fireaxecabinet{
	pixel_y = 29
	},
/turf/simulated/floor/tiled,
/area/submap/OtieShelter)
"Mg" = (
/obj/structure/window/phoronreinforced{
	dir = 1
	},
/obj/structure/window/phoronreinforced{
	dir = 8
	},
/turf/simulated/floor/tiled,
/area/submap/OtieShelter)
"Mn" = (
/mob/living/simple_mob/otie/red/chubby,
/turf/simulated/floor/tiled,
/area/submap/OtieShelter)
"Mz" = (
/turf/simulated/wall/r_wall,
/area/submap/OtieShelter)
"MK" = (
/obj/machinery/light{
	dir = 8
	},
/turf/simulated/floor/carpet/turcarpet,
/area/submap/OtieShelter)
"Nd" = (
/obj/structure/table/marble,
/obj/structure/table/marble,
/obj/item/device/radio/phone,
/turf/simulated/floor/carpet/turcarpet,
/area/submap/OtieShelter)
"Nh" = (
/obj/item/weapon/bedsheet/browndouble,
/obj/structure/bed/double/padded,
/turf/simulated/floor/carpet/turcarpet,
/area/submap/OtieShelter)
"Np" = (
/obj/structure/window/phoronreinforced{
	dir = 1
	},
/obj/structure/window/phoronreinforced{
	dir = 4
	},
/obj/item/trash/bowl,
/turf/simulated/floor/tiled,
/area/submap/OtieShelter)
"NJ" = (
/obj/machinery/door/window{
	dir = 8
	},
/turf/simulated/floor/tiled,
/area/submap/OtieShelter)
"Of" = (
/obj/machinery/light{
	dir = 8
	},
/turf/simulated/floor/tiled,
/area/submap/OtieShelter)
"OJ" = (
/obj/effect/decal/cleanable/blood/drip{
	icon_state = "2"
	},
/obj/effect/decal/cleanable/blood/drip{
	icon_state = "5"
	},
/obj/effect/decal/cleanable/blood/tracks/paw{
	icon_state = "paw1"
	},
/obj/item/ammo_casing/spent,
/turf/simulated/floor/tiled,
/area/submap/OtieShelter)
"Pn" = (
/obj/structure/window/phoronreinforced{
	dir = 1
	},
/obj/structure/window/phoronreinforced{
	dir = 8
	},
/obj/item/trash/bowl,
/obj/item/weapon/reagent_containers/food/snacks/meat/human,
/turf/simulated/floor/tiled,
/area/submap/OtieShelter)
"Px" = (
/obj/effect/floor_decal/industrial/warning{
	dir = 8
	},
/turf/simulated/floor/tiled,
/area/submap/OtieShelter)
"Qr" = (
/turf/template_noop,
/area/template_noop)
"Ro" = (
/turf/simulated/floor/carpet/turcarpet,
/area/submap/OtieShelter)
"RW" = (
/obj/machinery/power/apc{
	dir = 1;
	name = "PAPC";
	pixel_y = 24
	},
/obj/structure/cable/green{
	d2 = 4;
	icon_state = "0-4"
	},
/turf/simulated/floor/tiled/techfloor/grid,
/area/submap/OtieShelter)
"TP" = (
/obj/machinery/power/smes/buildable/point_of_interest,
/obj/structure/cable/green{
	d2 = 8;
	icon_state = "0-8"
	},
/turf/simulated/floor/tiled/techfloor/grid,
/area/submap/OtieShelter)
"UF" = (
/obj/effect/floor_decal/industrial/warning{
	dir = 4
	},
/turf/simulated/floor/tiled,
/area/submap/OtieShelter)
"UH" = (
/obj/structure/window/phoronreinforced{
	dir = 8
	},
/obj/item/trash/bowl,
/obj/item/weapon/reagent_containers/food/snacks/meat/human,
/turf/simulated/floor/tiled,
/area/submap/OtieShelter)
"VE" = (
/obj/effect/decal/cleanable/blood/drip{
	icon_state = "3"
	},
/obj/effect/decal/cleanable/blood/tracks/paw{
	icon_state = "paw1"
	},
/turf/simulated/floor/carpet/turcarpet,
/area/submap/OtieShelter)
"VL" = (
/obj/structure/extinguisher_cabinet{
	pixel_y = 30
	},
/obj/effect/decal/cleanable/blood/drip{
	icon_state = "2"
	},
/obj/effect/decal/cleanable/blood/drip,
/turf/simulated/floor/carpet/turcarpet,
/area/submap/OtieShelter)
"VY" = (
/mob/living/simple_mob/otie/cotie/chubby,
/turf/simulated/floor/tiled,
/area/submap/OtieShelter)
"Wl" = (
/obj/effect/decal/cleanable/blood,
/obj/structure/windoor_assembly,
/obj/structure/windoor_assembly{
	dir = 2
	},
/turf/simulated/floor/tiled/techfloor/grid,
/area/submap/OtieShelter)
"WY" = (
/obj/machinery/oxygen_pump/mobile/anesthetic,
/turf/simulated/floor/tiled,
/area/submap/OtieShelter)
"XB" = (
/obj/structure/window/phoronreinforced{
	dir = 1
	},
/obj/structure/table/rack/shelf/steel,
/obj/item/weapon/storage/toolbox/mechanical,
/obj/effect/floor_decal/industrial/warning{
	dir = 1
	},
/turf/simulated/floor/tiled,
/area/submap/OtieShelter)
"XG" = (
/obj/structure/window/phoronreinforced{
	dir = 1
	},
/mob/living/simple_mob/otie/red/friendly,
/turf/simulated/floor/tiled,
/area/submap/OtieShelter)

(1,1,1) = {"
Qr
Qr
Qr
Qr
Qr
Qr
Qr
Qr
Qr
Qr
Qr
Qr
Qr
Qr
Qr
Qr
Qr
Qr
Qr
Qr
"}
(2,1,1) = {"
Qr
Qr
Qr
Qr
Qr
Qr
Qr
Qr
Qr
Qr
Qr
Qr
Qr
Qr
Qr
Qr
Qr
Qr
Qr
Qr
"}
(3,1,1) = {"
Qr
Mz
Mz
Mz
Mz
Mz
Mz
Mz
Mz
Mz
Mz
Mz
Mz
Mz
Mz
Mz
Mz
Qr
Qr
Qr
"}
(4,1,1) = {"
Qr
Mz
wO
Of
kF
Of
kF
Of
xI
Of
kF
Of
Mz
Nh
MK
gN
Mz
Qr
Qr
Qr
"}
(5,1,1) = {"
Qr
Mz
IF
VY
tt
IF
Aa
Ih
lQ
IF
lQ
IF
Mz
vV
Ro
Ro
Mz
Qr
Qr
Qr
"}
(6,1,1) = {"
Qr
Mz
hh
Hk
tP
Hk
Np
od
Np
Hk
mu
Hk
Mz
CM
Ro
Ro
Mz
gr
Qr
Qr
"}
(7,1,1) = {"
Qr
Mz
ar
Px
Px
Px
Px
Px
Px
Px
Px
Px
Mz
Mz
fw
Mz
mJ
rb
Lr
Qr
"}
(8,1,1) = {"
Qr
Mz
jo
IF
IF
IF
IF
IF
IF
IF
IF
IF
fw
mC
nK
ag
IF
aj
op
iC
"}
(9,1,1) = {"
Qr
Mz
Mc
IF
IF
AO
Cw
yD
AO
IF
IF
uD
Mz
Mz
lv
Mz
mJ
rb
JY
Qr
"}
(10,1,1) = {"
Qr
Mz
HV
WY
jc
AO
iv
AO
AO
vA
hD
IF
sJ
MK
tz
Ro
Mz
gr
Qr
Qr
"}
(11,1,1) = {"
Qr
Mz
jo
IF
IF
IF
IF
IF
hD
pa
OJ
IF
ob
jy
Nd
nR
Mz
Qr
Qr
Qr
"}
(12,1,1) = {"
Qr
Mz
LF
UF
UF
UF
UF
UF
UF
BM
kX
EI
hk
Ro
xj
cq
Mz
Qr
Qr
Qr
"}
(13,1,1) = {"
Qr
Mz
UH
NJ
Pn
vB
Pn
NJ
Mg
jI
xf
lY
Mz
VL
At
Ro
Mz
Qr
Qr
Qr
"}
(14,1,1) = {"
Qr
Mz
IF
Ij
XG
IF
lQ
Mn
iY
lP
XB
pd
Wl
VE
Ro
Ro
Mz
Qr
Qr
Qr
"}
(15,1,1) = {"
Qr
Mz
wO
uS
kF
uS
kF
uS
kF
uS
KJ
IF
Mz
Ro
Ro
Ro
Mz
Qr
Qr
Qr
"}
(16,1,1) = {"
Qr
Mz
Mz
Mz
Mz
Mz
Mz
Mz
Mz
Mz
Mz
EE
Mz
Mz
Mz
Mz
Mz
Qr
Qr
Qr
"}
(17,1,1) = {"
Qr
Qr
Qr
Qr
Qr
Qr
Qr
Qr
Qr
Qr
Mz
RW
cU
Mz
Qr
Qr
Qr
Qr
Qr
Qr
"}
(18,1,1) = {"
Qr
Qr
Qr
Qr
Qr
Qr
Qr
Qr
Qr
Qr
Mz
TP
eI
Mz
Qr
Qr
Qr
Qr
Qr
Qr
"}
(19,1,1) = {"
Qr
Qr
Qr
Qr
Qr
Qr
Qr
Qr
Qr
Qr
Mz
Mz
Mz
Mz
Qr
Qr
Qr
Qr
Qr
Qr
"}
(20,1,1) = {"
Qr
Qr
Qr
Qr
Qr
Qr
Qr
Qr
Qr
Qr
Qr
Qr
Qr
Qr
Qr
Qr
Qr
Qr
Qr
Qr
"}
