//MAP CONVERTED BY dmm2tgm.py THIS HEADER COMMENT PREVENTS RECONVERSION, DO NOT REMOVE
"ag" = (
/obj/machinery/light{
	dir = 8
	},
/obj/effect/decal/cleanable/blood/drip{
	icon_state = "5"
	},
/turf/simulated/floor/tiled/steel_dirty/virgo3b,
/area/submap/OtieShelter)
"aj" = (
/obj/effect/decal/cleanable/blood/drip{
	icon_state = "5"
	},
/obj/effect/floor_decal/industrial/warning{
	dir = 1
	},
/turf/simulated/floor/tiled/steel_dirty/virgo3b,
/area/submap/OtieShelter)
"ar" = (
/obj/structure/closet/secure_closet/medical_wall/anesthetics,
/obj/effect/floor_decal/industrial/warning{
	dir = 8
	},
/turf/simulated/floor/tiled/steel_dirty/virgo3b,
/area/submap/OtieShelter)
"bl" = (
/obj/machinery/light{
	dir = 8
	},
/turf/simulated/floor/tiled/kafel_full/yellow/virgo3b,
/area/submap/OtieShelter)
"ce" = (
/obj/machinery/door/airlock,
/turf/simulated/floor/tiled/steel_dirty/virgo3b,
/area/submap/OtieShelter)
"cq" = (
/obj/structure/bed/chair/office/light{
	dir = 1
	},
/turf/simulated/floor/tiled/freezer/virgo3b,
/area/submap/OtieShelter)
"cU" = (
/obj/machinery/power/port_gen/pacman,
/obj/structure/cable{
	d2 = 4;
	icon_state = "0-4"
	},
/turf/simulated/floor/tiled/freezer/virgo3b,
/area/submap/OtieShelter)
"eI" = (
/obj/machinery/power/terminal{
	dir = 1
	},
/obj/structure/cable{
	d2 = 8;
	icon_state = "0-8"
	},
/turf/simulated/floor/tiled/freezer/virgo3b,
/area/submap/OtieShelter)
"fw" = (
/obj/machinery/door/airlock,
/turf/simulated/floor/tiled/techfloor/grid,
/area/submap/OtieShelter)
"gr" = (
/obj/machinery/porta_turret/poi,
/obj/effect/floor_decal/industrial/warning{
	dir = 1
	},
/turf/simulated/floor/tiled/steel_dirty/virgo3b,
/area/submap/OtieShelter)
"gN" = (
/obj/structure/undies_wardrobe,
/turf/simulated/floor/tiled/kafel_full/yellow/virgo3b,
/area/submap/OtieShelter)
"hh" = (
/obj/structure/window/phoronreinforced{
	dir = 4
	},
/obj/item/trash/bowl,
/obj/item/weapon/reagent_containers/food/snacks/meat/human,
/turf/simulated/floor/tiled/steel_dirty/virgo3b,
/area/submap/OtieShelter)
"hk" = (
/obj/structure/grille/rustic,
/obj/structure/window/phoronreinforced{
	dir = 1
	},
/obj/structure/window/phoronreinforced{
	dir = 4
	},
/obj/structure/window/phoronreinforced,
/turf/simulated/floor/plating,
/area/submap/OtieShelter)
"hD" = (
/obj/effect/decal/cleanable/filth,
/turf/simulated/floor/tiled/steel_dirty/virgo3b,
/area/submap/OtieShelter)
"iv" = (
/obj/structure/table/glass,
/obj/item/weapon/storage/firstaid/surgery,
/turf/simulated/floor/tiled/steel_dirty/virgo3b,
/area/submap/OtieShelter)
"iC" = (
/obj/effect/decal/cleanable/blood,
/mob/living/simple_mob/otie/feral/chubby,
/turf/template_noop,
/area/template_noop)
"iY" = (
/obj/structure/window/phoronreinforced{
	dir = 1
	},
/obj/item/trash/bowl,
/turf/simulated/floor/tiled/steel_dirty/virgo3b,
/area/submap/OtieShelter)
"jc" = (
/obj/machinery/optable,
/turf/simulated/floor/tiled/steel_dirty/virgo3b,
/area/submap/OtieShelter)
"jo" = (
/obj/machinery/light{
	dir = 1
	},
/turf/simulated/floor/tiled/steel_dirty/virgo3b,
/area/submap/OtieShelter)
"jy" = (
/obj/effect/decal/cleanable/blood/drip,
/turf/simulated/floor/tiled/freezer/virgo3b,
/area/submap/OtieShelter)
"jI" = (
/obj/item/weapon/material/shard{
	icon_state = "medium"
	},
/obj/effect/decal/cleanable/blood/tracks{
	color = "red";
	desc = "Your instincts say you shouldn't be following these.";
	dir = 4;
	icon = 'icons/effects/blood.dmi';
	icon_state = "tracks"
	},
/turf/simulated/floor/tiled/steel_dirty/virgo3b,
/area/submap/OtieShelter)
"kX" = (
/obj/effect/floor_decal/industrial/warning/corner{
	dir = 4
	},
/turf/simulated/floor/tiled/steel_dirty/virgo3b,
/area/submap/OtieShelter)
"lv" = (
/obj/structure/door_assembly,
/turf/simulated/floor/tiled/kafel_full/yellow/virgo3b,
/area/submap/OtieShelter)
"lP" = (
/obj/effect/decal/cleanable/blood/drip{
	icon_state = "4"
	},
/obj/effect/decal/cleanable/blood/drip{
	icon_state = "2"
	},
/obj/effect/decal/cleanable/blood,
/turf/simulated/floor/tiled/steel_dirty/virgo3b,
/area/submap/OtieShelter)
"lY" = (
/obj/machinery/light,
/obj/effect/decal/cleanable/blood/drip{
	icon_state = "4"
	},
/turf/simulated/floor/tiled/freezer/virgo3b,
/area/submap/OtieShelter)
"mC" = (
/obj/structure/extinguisher_cabinet{
	pixel_x = -28
	},
/turf/simulated/floor/tiled/steel_dirty/virgo3b,
/area/submap/OtieShelter)
"mJ" = (
/obj/structure/sign/warning/secure_area,
/turf/simulated/wall/r_wall,
/area/submap/OtieShelter)
"nK" = (
/obj/effect/decal/cleanable/blood/drip{
	icon_state = "3"
	},
/obj/effect/decal/cleanable/blood/drip{
	icon_state = "4"
	},
/turf/simulated/floor/tiled/steel_dirty/virgo3b,
/area/submap/OtieShelter)
"nR" = (
/obj/structure/table/marble,
/obj/item/weapon/newspaper,
/obj/item/weapon/paper/card/heart,
/turf/simulated/floor/tiled/freezer/virgo3b,
/area/submap/OtieShelter)
"ob" = (
/obj/structure/grille/rustic,
/obj/structure/window/phoronreinforced{
	dir = 1
	},
/obj/structure/window/phoronreinforced,
/turf/simulated/floor/plating,
/area/submap/OtieShelter)
"od" = (
/obj/machinery/door/window,
/obj/item/weapon/bone,
/turf/simulated/floor/tiled/steel_dirty/virgo3b,
/area/submap/OtieShelter)
"op" = (
/obj/effect/decal/cleanable/blood/drip{
	icon_state = "4"
	},
/turf/simulated/floor/tiled/steel_dirty/virgo3b,
/area/submap/OtieShelter)
"pa" = (
/obj/structure/loot_pile/surface/bones,
/obj/effect/decal/cleanable/blood,
/obj/effect/decal/cleanable/filth,
/obj/effect/decal/cleanable/filth,
/obj/random/handgun/sec,
/turf/simulated/floor/tiled/steel_dirty/virgo3b,
/area/submap/OtieShelter)
"pd" = (
/obj/effect/decal/cleanable/blood/drip{
	icon_state = "5"
	},
/turf/simulated/floor/tiled/freezer/virgo3b,
/area/submap/OtieShelter)
"rb" = (
/obj/machinery/light{
	dir = 1
	},
/obj/effect/floor_decal/industrial/warning{
	dir = 1
	},
/turf/simulated/floor/tiled/steel_dirty/virgo3b,
/area/submap/OtieShelter)
"sJ" = (
/obj/structure/grille/rustic,
/obj/structure/window/phoronreinforced{
	dir = 1
	},
/obj/structure/window/phoronreinforced{
	dir = 8
	},
/obj/structure/window/phoronreinforced,
/turf/simulated/floor/plating,
/area/submap/OtieShelter)
"tz" = (
/obj/effect/decal/cleanable/blood/drip{
	icon_state = "2"
	},
/turf/simulated/floor/tiled/freezer/virgo3b,
/area/submap/OtieShelter)
"tP" = (
/obj/structure/window/phoronreinforced{
	dir = 1
	},
/obj/structure/window/phoronreinforced{
	dir = 4
	},
/obj/item/trash/bowl,
/obj/item/weapon/reagent_containers/food/snacks/meat/human,
/turf/simulated/floor/tiled/steel_dirty/virgo3b,
/area/submap/OtieShelter)
"uD" = (
/obj/machinery/light,
/turf/simulated/floor/tiled/steel_dirty/virgo3b,
/area/submap/OtieShelter)
"uS" = (
/obj/machinery/light{
	dir = 4
	},
/turf/simulated/floor/tiled/steel_dirty/virgo3b,
/area/submap/OtieShelter)
"vA" = (
/obj/item/weapon/bone,
/turf/simulated/floor/tiled/steel_dirty/virgo3b,
/area/submap/OtieShelter)
"vB" = (
/obj/machinery/door/window{
	dir = 8
	},
/obj/item/weapon/bone,
/turf/simulated/floor/tiled/steel_dirty/virgo3b,
/area/submap/OtieShelter)
"vV" = (
/obj/structure/table/woodentable,
/turf/simulated/floor/tiled/kafel_full/yellow/virgo3b,
/area/submap/OtieShelter)
"wO" = (
/obj/structure/dogbed,
/turf/simulated/floor/tiled/steel_dirty/virgo3b,
/area/submap/OtieShelter)
"xf" = (
/obj/structure/window/phoronreinforced{
	dir = 1
	},
/obj/structure/reagent_dispensers,
/obj/effect/floor_decal/industrial/warning{
	dir = 1
	},
/turf/simulated/floor/tiled/freezer/virgo3b,
/area/submap/OtieShelter)
"xj" = (
/obj/structure/table/marble,
/obj/item/modular_computer/laptop/preset/custom_loadout/cheap,
/turf/simulated/floor/tiled/freezer/virgo3b,
/area/submap/OtieShelter)
"xI" = (
/obj/structure/window/phoronreinforced{
	dir = 1
	},
/obj/structure/dogbed,
/turf/simulated/floor/tiled/steel_dirty/virgo3b,
/area/submap/OtieShelter)
"yD" = (
/obj/structure/table/glass,
/obj/item/weapon/storage/firstaid/adv,
/turf/simulated/floor/tiled/steel_dirty/virgo3b,
/area/submap/OtieShelter)
"At" = (
/obj/structure/table/marble,
/obj/item/weapon/paper_bin,
/obj/item/weapon/pen,
/turf/simulated/floor/tiled/freezer/virgo3b,
/area/submap/OtieShelter)
"AO" = (
/obj/structure/table/glass,
/turf/simulated/floor/tiled/steel_dirty/virgo3b,
/area/submap/OtieShelter)
"BM" = (
/obj/item/weapon/melee/baton/cattleprod,
/obj/effect/decal/cleanable/blood/tracks{
	color = "red";
	desc = "Your instincts say you shouldn't be following these.";
	dir = 4;
	icon = 'icons/effects/blood.dmi';
	icon_state = "tracks"
	},
/obj/effect/decal/cleanable/filth,
/obj/effect/floor_decal/industrial/warning{
	dir = 4
	},
/turf/simulated/floor/tiled/steel_dirty/virgo3b,
/area/submap/OtieShelter)
"Cw" = (
/obj/structure/table/glass,
/obj/item/weapon/storage/firstaid,
/turf/simulated/floor/tiled/steel_dirty/virgo3b,
/area/submap/OtieShelter)
"CM" = (
/obj/structure/closet/wardrobe,
/turf/simulated/floor/tiled/kafel_full/yellow/virgo3b,
/area/submap/OtieShelter)
"EE" = (
/obj/machinery/door/airlock/engineering,
/turf/simulated/floor/tiled/freezer/virgo3b,
/area/submap/OtieShelter)
"EI" = (
/obj/effect/decal/cleanable/blood/drip{
	icon_state = "2"
	},
/obj/effect/decal/cleanable/blood/drip,
/turf/simulated/floor/tiled/steel_dirty/virgo3b,
/area/submap/OtieShelter)
"GK" = (
/turf/simulated/floor/tiled/kafel_full/yellow/virgo3b,
/area/submap/OtieShelter)
"Hk" = (
/obj/machinery/door/window,
/turf/simulated/floor/tiled/steel_dirty/virgo3b,
/area/submap/OtieShelter)
"HV" = (
/obj/structure/extinguisher_cabinet{
	pixel_y = 30
	},
/turf/simulated/floor/tiled/steel_dirty/virgo3b,
/area/submap/OtieShelter)
"Ih" = (
/obj/item/weapon/reagent_containers/food/snacks/meat/human,
/turf/simulated/floor/tiled/steel_dirty/virgo3b,
/area/submap/OtieShelter)
"IF" = (
/mob/living/simple_mob/otie/feral,
/turf/simulated/floor/tiled/steel_dirty/virgo3b,
/area/submap/OtieShelter)
"KJ" = (
/obj/structure/window/phoronreinforced{
	dir = 1
	},
/obj/effect/floor_decal/industrial/warning{
	dir = 1
	},
/obj/structure/closet/secure_closet/freezer/meat,
/turf/simulated/floor/tiled/freezer/virgo3b,
/area/submap/OtieShelter)
"Lr" = (
/obj/structure/door_assembly,
/turf/simulated/floor/tiled/steel_dirty/virgo3b,
/area/submap/OtieShelter)
"LF" = (
/obj/structure/ghost_pod/manual/lost_drone/dogborg,
/obj/effect/floor_decal/industrial/warning{
	dir = 4
	},
/turf/simulated/floor/tiled/steel_dirty/virgo3b,
/area/submap/OtieShelter)
"Mc" = (
/obj/structure/fireaxecabinet{
	pixel_y = 29
	},
/turf/simulated/floor/tiled/steel_dirty/virgo3b,
/area/submap/OtieShelter)
"Mg" = (
/obj/structure/window/phoronreinforced{
	dir = 1
	},
/obj/structure/window/phoronreinforced{
	dir = 8
	},
/turf/simulated/floor/tiled/steel_dirty/virgo3b,
/area/submap/OtieShelter)
"Mz" = (
/turf/simulated/wall/r_wall,
/area/submap/OtieShelter)
"MK" = (
/obj/machinery/light{
	dir = 8
	},
/turf/simulated/floor/tiled/freezer/virgo3b,
/area/submap/OtieShelter)
"Nd" = (
/obj/structure/table/marble,
/obj/structure/table/marble,
/obj/item/device/radio/phone,
/turf/simulated/floor/tiled/freezer/virgo3b,
/area/submap/OtieShelter)
"Nh" = (
/obj/item/weapon/bedsheet/browndouble,
/obj/structure/bed/double/padded,
/turf/simulated/floor/tiled/kafel_full/yellow/virgo3b,
/area/submap/OtieShelter)
"Np" = (
/obj/structure/window/phoronreinforced{
	dir = 1
	},
/obj/structure/window/phoronreinforced{
	dir = 4
	},
/obj/item/trash/bowl,
/turf/simulated/floor/tiled/steel_dirty/virgo3b,
/area/submap/OtieShelter)
"NJ" = (
/obj/machinery/door/window{
	dir = 8
	},
/turf/simulated/floor/tiled/steel_dirty/virgo3b,
/area/submap/OtieShelter)
"Of" = (
/obj/machinery/light{
	dir = 8
	},
/turf/simulated/floor/tiled/steel_dirty/virgo3b,
/area/submap/OtieShelter)
"OJ" = (
/obj/effect/decal/cleanable/blood/drip{
	icon_state = "2"
	},
/obj/effect/decal/cleanable/blood/drip{
	icon_state = "5"
	},
/obj/effect/decal/cleanable/blood/tracks/paw{
	icon_state = "paw1"
	},
/obj/item/ammo_casing/spent,
/turf/simulated/floor/tiled/steel_dirty/virgo3b,
/area/submap/OtieShelter)
"Pn" = (
/obj/structure/window/phoronreinforced{
	dir = 1
	},
/obj/structure/window/phoronreinforced{
	dir = 8
	},
/obj/item/trash/bowl,
/obj/item/weapon/reagent_containers/food/snacks/meat/human,
/turf/simulated/floor/tiled/steel_dirty/virgo3b,
/area/submap/OtieShelter)
"Px" = (
/obj/effect/floor_decal/industrial/warning{
	dir = 8
	},
/turf/simulated/floor/tiled/steel_dirty/virgo3b,
/area/submap/OtieShelter)
"Qr" = (
/turf/template_noop,
/area/template_noop)
"Ro" = (
/turf/simulated/floor/tiled/freezer/virgo3b,
/area/submap/OtieShelter)
"RW" = (
/obj/machinery/power/apc{
	dir = 1;
	name = "PAPC";
	pixel_y = 24
	},
/obj/structure/cable/green{
	d2 = 4;
	icon_state = "0-4"
	},
/turf/simulated/floor/tiled/freezer/virgo3b,
/area/submap/OtieShelter)
"TP" = (
/obj/machinery/power/smes/buildable/point_of_interest,
/obj/structure/cable/green{
	d2 = 8;
	icon_state = "0-8"
	},
/turf/simulated/floor/tiled/freezer/virgo3b,
/area/submap/OtieShelter)
"UF" = (
/obj/effect/floor_decal/industrial/warning{
	dir = 4
	},
/turf/simulated/floor/tiled/steel_dirty/virgo3b,
/area/submap/OtieShelter)
"UH" = (
/obj/structure/window/phoronreinforced{
	dir = 8
	},
/obj/item/trash/bowl,
/obj/item/weapon/reagent_containers/food/snacks/meat/human,
/turf/simulated/floor/tiled/steel_dirty/virgo3b,
/area/submap/OtieShelter)
"VE" = (
/obj/effect/decal/cleanable/blood/drip{
	icon_state = "3"
	},
/obj/effect/decal/cleanable/blood/tracks/paw{
	icon_state = "paw1"
	},
/turf/simulated/floor/tiled/freezer/virgo3b,
/area/submap/OtieShelter)
"VL" = (
/obj/structure/extinguisher_cabinet{
	pixel_y = 30
	},
/obj/effect/decal/cleanable/blood/drip{
	icon_state = "2"
	},
/obj/effect/decal/cleanable/blood/drip,
/turf/simulated/floor/tiled/freezer/virgo3b,
/area/submap/OtieShelter)
"VY" = (
/turf/simulated/floor/tiled/steel_dirty/virgo3b,
/area/submap/OtieShelter)
"Wl" = (
/obj/effect/decal/cleanable/blood,
/obj/structure/windoor_assembly,
/obj/structure/windoor_assembly{
	dir = 2
	},
/turf/simulated/floor/tiled/freezer/virgo3b,
/area/submap/OtieShelter)
"WY" = (
/obj/machinery/oxygen_pump/mobile/anesthetic,
/turf/simulated/floor/tiled/steel_dirty/virgo3b,
/area/submap/OtieShelter)
"XB" = (
/obj/structure/window/phoronreinforced{
	dir = 1
	},
/obj/structure/table/rack/shelf/steel,
/obj/item/weapon/storage/toolbox/mechanical,
/obj/effect/floor_decal/industrial/warning{
	dir = 1
	},
/turf/simulated/floor/tiled/freezer/virgo3b,
/area/submap/OtieShelter)
"XG" = (
/obj/structure/window/phoronreinforced{
	dir = 1
	},
/mob/living/simple_mob/otie/feral,
/turf/simulated/floor/tiled/steel_dirty/virgo3b,
/area/submap/OtieShelter)

(1,1,1) = {"
Qr
Qr
Qr
Qr
Qr
Qr
Qr
Qr
Qr
Qr
Qr
Qr
Qr
Qr
Qr
Qr
Qr
Qr
Qr
Qr
"}
(2,1,1) = {"
Qr
Qr
Qr
Qr
Qr
Qr
Qr
Qr
Qr
Qr
Qr
Qr
Qr
Qr
Qr
Qr
Qr
Qr
Qr
Qr
"}
(3,1,1) = {"
Qr
Mz
Mz
Mz
Mz
Mz
Mz
Mz
Mz
Mz
Mz
Mz
Mz
Mz
Mz
Mz
Mz
Qr
Qr
Qr
"}
(4,1,1) = {"
Qr
Mz
wO
Of
xI
Of
xI
Of
xI
Of
xI
Of
Mz
Nh
bl
gN
Mz
Qr
Qr
Qr
"}
(5,1,1) = {"
Qr
Mz
IF
VY
XG
VY
XG
Ih
XG
VY
XG
VY
Mz
vV
GK
GK
Mz
Qr
Qr
Qr
"}
(6,1,1) = {"
Qr
Mz
hh
Hk
tP
Hk
Np
od
Np
Hk
tP
Hk
Mz
CM
GK
GK
Mz
gr
Qr
Qr
"}
(7,1,1) = {"
Qr
Mz
ar
Px
Px
Px
Px
Px
Px
Px
Px
Px
Mz
Mz
fw
Mz
mJ
rb
Lr
Qr
"}
(8,1,1) = {"
Qr
Mz
jo
VY
VY
VY
VY
VY
VY
VY
VY
VY
ce
mC
nK
ag
VY
aj
op
iC
"}
(9,1,1) = {"
Qr
Mz
Mc
VY
VY
AO
Cw
yD
AO
VY
VY
uD
Mz
Mz
lv
Mz
mJ
rb
VY
Qr
"}
(10,1,1) = {"
Qr
Mz
HV
WY
jc
AO
iv
AO
AO
vA
hD
VY
sJ
MK
tz
Ro
Mz
gr
Qr
Qr
"}
(11,1,1) = {"
Qr
Mz
jo
VY
VY
VY
VY
VY
hD
pa
OJ
VY
ob
jy
Nd
nR
Mz
Qr
Qr
Qr
"}
(12,1,1) = {"
Qr
Mz
LF
UF
UF
UF
UF
UF
UF
BM
kX
EI
hk
Ro
xj
cq
Mz
Qr
Qr
Qr
"}
(13,1,1) = {"
Qr
Mz
UH
NJ
Pn
vB
Pn
NJ
Mg
jI
xf
lY
Mz
VL
At
Ro
Mz
Qr
Qr
Qr
"}
(14,1,1) = {"
Qr
Mz
IF
VY
XG
VY
XG
VY
iY
lP
XB
pd
Wl
VE
Ro
Ro
Mz
Qr
Qr
Qr
"}
(15,1,1) = {"
Qr
Mz
wO
uS
xI
uS
xI
uS
xI
uS
KJ
Ro
Mz
Ro
Ro
Ro
Mz
Qr
Qr
Qr
"}
(16,1,1) = {"
Qr
Mz
Mz
Mz
Mz
Mz
Mz
Mz
Mz
Mz
Mz
EE
Mz
Mz
Mz
Mz
Mz
Qr
Qr
Qr
"}
(17,1,1) = {"
Qr
Qr
Qr
Qr
Qr
Qr
Qr
Qr
Qr
Qr
Mz
RW
cU
Mz
Qr
Qr
Qr
Qr
Qr
Qr
"}
(18,1,1) = {"
Qr
Qr
Qr
Qr
Qr
Qr
Qr
Qr
Qr
Qr
Mz
TP
eI
Mz
Qr
Qr
Qr
Qr
Qr
Qr
"}
(19,1,1) = {"
Qr
Qr
Qr
Qr
Qr
Qr
Qr
Qr
Qr
Qr
Mz
Mz
Mz
Mz
Qr
Qr
Qr
Qr
Qr
Qr
"}
(20,1,1) = {"
Qr
Qr
Qr
Qr
Qr
Qr
Qr
Qr
Qr
Qr
Qr
Qr
Qr
Qr
Qr
Qr
Qr
Qr
Qr
Qr
"}
