"a" = (/turf/template_noop,/area/template_noop)
"b" = (/turf/template_noop,/area/submap/PascalB)
"c" = (/turf/simulated/floor/outdoors/dirt,/area/submap/PascalB)
"d" = (/turf/simulated/floor/outdoors/rocks,/area/submap/PascalB)
"e" = (/obj/item/poi/pascalb,/turf/simulated/floor/outdoors/rocks,/area/submap/PascalB)

(1,1,1) = {"
aaaaaaa
abbcbca
accdcca
acdedca
accdcca
abccbca
aaaaaaa
"}
