//MAP CONVERTED BY dmm2tgm.py THIS HEADER COMMENT PREVENTS RECONVERSION, DO NOT REMOVE
"a" = (
/turf/template_noop,
/area/template_noop)
"b" = (
/turf/template_noop,
/area/submap/Peninsula)
"c" = (
/turf/simulated/floor/outdoors/rocks/virgo3b,
/area/submap/Peninsula)
"d" = (
/turf/simulated/floor/water/virgo3b,
/area/submap/Peninsula)
"e" = (
/obj/structure/flora/tree/sif,
/turf/template_noop,
/area/submap/Peninsula)
"f" = (
/turf/simulated/mineral/ignore_mapgen,
/area/submap/Peninsula)
"g" = (
/obj/structure/table/woodentable,
/obj/item/flashlight,
/turf/template_noop,
/area/submap/Peninsula)
"h" = (
/obj/structure/table/woodentable,
/obj/item/cell/device,
/obj/item/cell/device,
/turf/template_noop,
/area/submap/Peninsula)
"i" = (
/obj/structure/bonfire,
/turf/template_noop,
/area/submap/Peninsula)
"j" = (
/obj/structure/flora/tree/sif,
/turf/template_noop,
/area/template_noop)

(1,1,1) = {"
a
a
a
a
a
a
a
a
a
a
a
a
a
a
a
j
a
a
a
a
a
a
a
a
a
a
a
a
a
a
"}
(2,1,1) = {"
a
b
b
e
b
b
b
b
b
b
b
b
b
b
b
b
b
b
b
e
b
b
b
b
b
b
b
b
b
a
"}
(3,1,1) = {"
a
b
b
c
c
c
c
c
c
c
b
b
b
b
b
b
b
b
b
b
b
b
b
b
b
b
c
c
b
a
"}
(4,1,1) = {"
a
b
b
c
d
d
d
d
d
c
c
c
c
c
c
c
b
c
c
c
c
c
c
c
c
c
c
b
b
a
"}
(5,1,1) = {"
a
b
c
c
d
d
d
d
d
d
d
d
d
d
d
c
c
c
c
d
c
d
d
d
d
d
c
b
b
a
"}
(6,1,1) = {"
a
b
c
d
d
d
d
d
d
d
d
d
d
d
d
d
d
d
d
d
d
d
d
d
d
d
c
c
b
a
"}
(7,1,1) = {"
a
b
c
d
d
d
d
d
d
d
d
d
d
d
d
d
d
d
d
d
d
d
d
d
d
d
d
c
b
a
"}
(8,1,1) = {"
a
b
c
d
d
d
d
d
d
d
d
d
d
d
d
d
d
d
d
d
d
d
d
d
d
d
d
c
b
a
"}
(9,1,1) = {"
a
b
c
d
d
d
d
d
d
d
d
d
d
d
d
d
d
d
d
d
d
d
d
d
d
d
d
c
b
a
"}
(10,1,1) = {"
a
b
c
d
d
d
d
d
d
d
d
c
c
c
c
c
c
d
d
d
d
d
d
d
d
d
d
c
b
a
"}
(11,1,1) = {"
a
c
c
d
d
d
d
d
d
d
c
c
b
b
b
b
c
c
c
c
d
d
d
d
d
d
c
c
b
a
"}
(12,1,1) = {"
a
c
d
d
d
d
d
d
d
c
c
b
b
b
b
b
e
b
b
c
c
c
c
c
c
c
c
b
e
a
"}
(13,1,1) = {"
a
c
d
d
d
d
d
d
d
c
b
b
f
f
f
b
b
b
b
b
b
b
b
b
b
b
b
b
b
a
"}
(14,1,1) = {"
a
c
d
d
d
d
d
d
d
c
b
f
f
f
f
f
b
b
b
b
b
b
b
b
b
b
b
b
b
a
"}
(15,1,1) = {"
a
c
d
d
d
d
d
d
d
c
b
f
f
f
f
b
b
b
b
b
b
b
e
b
b
b
b
b
b
a
"}
(16,1,1) = {"
a
c
d
d
d
d
d
d
d
c
b
b
b
g
h
b
b
b
b
b
b
b
b
b
b
b
b
b
b
a
"}
(17,1,1) = {"
a
c
d
d
d
d
d
d
d
c
b
b
b
b
b
e
b
b
b
b
b
b
b
b
b
b
b
b
b
a
"}
(18,1,1) = {"
a
c
d
d
d
d
d
d
d
c
c
e
b
b
b
b
b
b
b
b
b
b
b
b
b
b
b
b
b
a
"}
(19,1,1) = {"
a
c
d
d
d
d
d
d
d
d
c
c
b
b
i
b
b
b
b
b
b
b
b
b
b
b
b
b
b
a
"}
(20,1,1) = {"
a
c
d
d
d
d
d
d
d
d
d
c
b
b
b
b
b
e
b
b
b
b
b
b
b
b
b
b
e
a
"}
(21,1,1) = {"
a
c
d
d
d
d
d
d
d
d
d
c
e
b
b
b
b
b
b
b
b
b
b
b
b
c
c
b
b
a
"}
(22,1,1) = {"
a
c
d
d
d
d
d
d
d
d
c
c
b
b
b
b
b
c
c
c
c
c
c
c
c
c
d
c
c
a
"}
(23,1,1) = {"
a
c
d
d
d
d
d
d
d
d
c
c
c
b
b
b
c
c
d
d
d
d
d
d
d
d
d
d
c
a
"}
(24,1,1) = {"
a
c
d
d
d
d
d
d
d
d
d
d
c
c
b
c
c
d
d
d
d
d
d
d
d
d
d
c
c
a
"}
(25,1,1) = {"
a
c
c
d
d
d
d
d
d
d
d
d
d
c
c
c
d
d
d
d
d
d
d
d
d
d
d
c
c
a
"}
(26,1,1) = {"
a
b
c
d
d
d
d
d
d
d
d
d
d
d
d
d
d
d
d
d
d
d
d
d
d
d
d
c
b
a
"}
(27,1,1) = {"
a
b
c
d
d
d
d
d
d
d
d
d
d
d
d
d
d
d
d
d
d
d
d
d
d
d
d
c
b
a
"}
(28,1,1) = {"
a
b
c
c
c
c
c
d
d
d
d
d
c
d
d
d
c
c
c
c
c
c
c
c
c
c
c
c
b
a
"}
(29,1,1) = {"
a
b
e
b
b
b
c
c
c
c
c
c
c
c
c
c
c
b
b
b
b
b
b
b
b
b
b
b
e
a
"}
(30,1,1) = {"
a
a
a
a
a
a
a
a
a
a
a
a
a
a
a
a
a
a
a
a
a
a
a
a
a
a
a
a
a
a
"}
