"a" = (/turf/template_noop,/area/template_noop)
"b" = (/turf/simulated/mineral/ignore_mapgen,/area/submap/PlainsKururak)
"c" = (/obj/random/trash,/turf/simulated/mineral/floor/ignore_mapgen,/area/submap/PlainsKururak)
"d" = (/obj/random/firstaid,/turf/simulated/mineral/floor/ignore_mapgen,/area/submap/PlainsKururak)
"e" = (/turf/simulated/mineral/floor/ignore_mapgen,/area/submap/PlainsKururak)
"f" = (/obj/random/projectile/sec,/turf/simulated/mineral/floor/ignore_mapgen,/area/submap/PlainsKururak)
"g" = (/obj/random/tech_supply,/obj/random/tech_supply,/turf/simulated/mineral/floor/ignore_mapgen,/area/submap/PlainsKururak)
"h" = (/mob/living/simple_mob/animal/sif/kururak,/turf/simulated/mineral/floor/ignore_mapgen,/area/submap/PlainsKururak)
"i" = (/obj/random/outcrop,/turf/simulated/mineral/floor/ignore_mapgen,/area/submap/PlainsKururak)
"j" = (/obj/random/contraband,/turf/simulated/mineral/floor/ignore_mapgen,/area/submap/PlainsKururak)
"k" = (/mob/living/simple_mob/animal/sif/diyaab,/turf/simulated/mineral/floor/ignore_mapgen,/area/submap/PlainsKururak)
"l" = (/obj/random/trash,/turf/template_noop,/area/submap/PlainsKururak)
"m" = (/turf/template_noop,/area/submap/PlainsKururak)

(1,1,1) = {"
aaaaaaaaaa
abbbbbbbaa
bbbcdefbaa
bbgeehibba
bbieebbbba
bbbjebklma
abbbckkbba
aabbbbibba
aaaabbbbaa
aaaaaaaaaa
"}
