//MAP CONVERTED BY dmm2tgm.py THIS HEADER COMMENT PREVENTS RECONVERSION, DO NOT REMOVE
"a" = (
/turf/template_noop,
/area/template_noop)
"b" = (
/turf/template_noop,
/area/submap/PooledR)
"c" = (
/turf/simulated/mineral/ignore_mapgen,
/area/submap/PooledR)
"d" = (
/obj/structure/flora/tree/sif,
/turf/template_noop,
/area/submap/PooledR)
"e" = (
/obj/structure/table/woodentable,
/turf/template_noop,
/area/submap/PooledR)
"f" = (
/obj/structure/table/woodentable,
/obj/item/weapon/material/knife,
/turf/template_noop,
/area/submap/PooledR)
"g" = (
/obj/structure/flora/ausbushes/palebush,
/turf/template_noop,
/area/submap/PooledR)
"h" = (
/obj/structure/table/woodentable,
/obj/item/weapon/gun/energy/retro{
	cell_type = /obj/item/weapon/cell/device/weapon/empty
	},
/turf/template_noop,
/area/submap/PooledR)
"i" = (
/obj/structure/flora/ausbushes/reedbush,
/turf/template_noop,
/area/submap/PooledR)
"j" = (
/turf/simulated/floor/outdoors/rocks,
/area/submap/PooledR)
"k" = (
/obj/structure/flora/ausbushes,
/turf/template_noop,
/area/submap/PooledR)
"l" = (
/turf/simulated/floor/water,
/area/submap/PooledR)
"m" = (
/obj/structure/flora/ausbushes/grassybush,
/turf/template_noop,
/area/submap/PooledR)
"n" = (
/turf/simulated/floor/water/deep,
/area/submap/PooledR)

(1,1,1) = {"
a
a
a
a
a
a
a
a
a
a
a
a
a
a
a
a
a
a
a
a
a
a
a
a
a
a
a
a
a
a
a
a
a
a
a
"}
(2,1,1) = {"
a
b
b
b
b
b
b
b
b
b
b
b
b
b
b
b
b
c
c
c
b
b
b
b
b
b
b
b
b
b
b
b
b
b
a
"}
(3,1,1) = {"
a
b
b
b
b
b
b
b
b
b
b
b
b
b
c
c
c
c
c
c
c
c
c
c
c
c
c
b
b
b
b
b
b
b
a
"}
(4,1,1) = {"
a
b
b
b
b
b
b
b
b
b
b
d
b
b
c
c
c
c
c
c
c
c
c
c
c
c
c
c
c
b
b
b
b
b
a
"}
(5,1,1) = {"
a
b
b
b
b
b
b
b
b
b
b
b
b
b
b
c
c
c
c
c
c
c
c
c
c
c
c
c
c
c
b
b
b
b
a
"}
(6,1,1) = {"
a
b
b
b
b
b
b
b
b
b
b
b
b
b
b
b
b
c
c
c
c
c
c
c
c
c
c
c
c
c
c
b
b
b
a
"}
(7,1,1) = {"
a
b
b
b
b
b
b
b
b
b
b
b
b
b
b
b
b
b
b
b
b
c
c
c
c
c
c
c
c
c
c
b
b
b
a
"}
(8,1,1) = {"
a
b
b
b
b
b
b
b
b
b
b
b
b
b
b
b
b
b
m
b
b
j
c
c
c
c
c
c
c
c
c
b
b
b
a
"}
(9,1,1) = {"
a
b
b
b
b
b
b
b
b
b
b
b
d
b
b
g
b
b
b
b
j
j
j
c
c
c
c
c
c
c
c
b
b
b
a
"}
(10,1,1) = {"
a
b
b
b
b
b
b
b
b
b
b
b
b
b
b
b
b
b
b
i
j
l
l
c
c
c
c
c
c
c
c
c
b
b
a
"}
(11,1,1) = {"
a
b
b
b
b
b
b
b
b
b
b
b
b
b
b
b
b
b
b
j
j
l
l
c
c
c
c
c
c
c
c
c
b
b
a
"}
(12,1,1) = {"
a
b
b
b
b
b
b
b
b
b
b
b
b
b
b
b
k
b
j
j
l
l
l
l
c
c
c
c
c
c
c
c
b
b
a
"}
(13,1,1) = {"
a
b
b
b
b
d
b
b
b
b
b
b
b
b
b
b
b
b
j
j
l
l
l
l
c
c
c
c
c
c
c
c
b
b
a
"}
(14,1,1) = {"
a
b
b
b
b
b
b
b
b
b
b
b
b
b
b
b
b
j
j
l
l
l
l
l
l
c
c
c
c
c
c
c
b
b
a
"}
(15,1,1) = {"
a
b
b
b
b
b
b
b
b
b
b
b
b
b
b
b
b
j
l
l
l
l
l
l
n
n
c
c
c
c
c
c
c
b
a
"}
(16,1,1) = {"
a
b
b
b
b
b
b
b
b
b
b
b
b
b
b
i
j
j
l
l
l
l
l
n
n
n
n
c
c
c
c
c
c
b
a
"}
(17,1,1) = {"
a
b
b
b
b
b
b
b
b
b
b
b
b
b
b
b
j
j
l
l
l
l
l
n
n
n
n
c
c
c
c
c
c
b
a
"}
(18,1,1) = {"
a
b
b
b
b
b
b
b
b
b
b
b
b
b
b
b
j
l
l
l
l
l
l
n
n
n
n
c
c
c
c
c
c
b
a
"}
(19,1,1) = {"
a
b
b
b
b
b
b
b
b
b
b
b
b
b
b
j
j
l
l
l
l
l
n
n
n
n
n
c
c
c
c
c
c
b
a
"}
(20,1,1) = {"
a
b
b
b
b
b
b
b
b
b
b
b
b
b
b
j
l
l
l
l
l
l
n
n
n
n
n
n
c
c
c
c
c
b
a
"}
(21,1,1) = {"
a
b
b
b
b
b
b
b
b
b
b
b
b
b
b
j
l
l
l
l
l
n
n
n
n
n
n
n
c
c
c
c
c
b
a
"}
(22,1,1) = {"
a
b
b
b
d
b
b
b
b
b
b
b
b
g
b
j
l
l
l
l
l
n
n
n
n
n
n
c
c
c
c
c
c
b
a
"}
(23,1,1) = {"
a
b
b
b
b
b
d
b
b
b
b
b
b
b
i
j
l
l
l
l
l
n
n
n
n
n
c
c
c
c
c
c
c
b
a
"}
(24,1,1) = {"
a
b
b
b
b
b
b
b
b
b
b
b
b
b
b
j
l
l
l
l
l
n
n
n
c
c
c
c
c
c
c
c
c
b
a
"}
(25,1,1) = {"
a
b
b
b
b
b
b
b
b
b
b
b
b
b
c
c
c
l
l
l
l
n
c
c
c
c
c
c
c
c
c
c
c
b
a
"}
(26,1,1) = {"
a
b
b
b
b
b
c
c
c
c
c
e
f
h
c
c
c
c
l
c
c
c
c
c
c
c
c
c
c
c
c
c
b
b
a
"}
(27,1,1) = {"
a
b
b
c
c
c
c
c
c
c
c
c
c
c
c
c
c
c
c
c
c
c
c
c
c
c
c
c
c
c
c
c
b
b
a
"}
(28,1,1) = {"
a
b
b
c
c
c
c
c
c
c
c
c
c
c
c
c
c
c
c
c
c
c
c
c
c
c
c
c
c
c
c
c
b
b
a
"}
(29,1,1) = {"
a
c
c
c
c
c
c
c
c
c
c
c
c
c
c
c
c
c
c
c
c
c
c
c
c
c
c
c
c
c
c
c
b
b
a
"}
(30,1,1) = {"
a
c
c
c
c
c
c
c
c
c
c
c
c
c
c
c
c
c
c
c
c
c
c
c
c
c
c
c
c
c
c
b
b
b
a
"}
(31,1,1) = {"
a
c
c
c
c
c
c
c
c
c
c
c
c
c
b
b
b
b
b
c
c
c
c
c
c
c
c
c
c
c
b
b
b
b
a
"}
(32,1,1) = {"
a
b
c
c
c
c
c
c
c
c
c
c
b
b
b
b
b
b
b
b
b
b
b
c
c
c
c
b
c
b
b
b
b
b
a
"}
(33,1,1) = {"
a
b
b
c
c
c
c
c
c
c
b
b
b
b
b
b
b
b
b
b
b
b
b
b
b
b
b
b
b
b
b
b
b
b
a
"}
(34,1,1) = {"
a
b
b
b
b
b
b
b
b
b
b
b
b
b
b
b
b
b
b
b
b
b
b
b
b
b
b
b
b
b
b
b
b
b
a
"}
(35,1,1) = {"
a
a
a
a
a
a
a
a
a
a
a
a
a
a
a
a
a
a
a
a
a
a
a
a
a
a
a
a
a
a
a
a
a
a
a
"}
