"a" = (/turf/template_noop,/area/template_noop)
"b" = (/turf/template_noop,/area/submap/PooledR)
"c" = (/turf/simulated/mineral/ignore_mapgen,/area/submap/PooledR)
"d" = (/obj/structure/flora/tree/sif,/turf/template_noop,/area/submap/PooledR)
"e" = (/obj/structure/table/woodentable,/turf/template_noop,/area/submap/PooledR)
"f" = (/obj/structure/table/woodentable,/obj/item/material/knife,/turf/template_noop,/area/submap/PooledR)
"g" = (/obj/structure/flora/ausbushes/palebush,/turf/template_noop,/area/submap/PooledR)
"h" = (/obj/structure/table/woodentable,/obj/item/gun/energy/retro{cell_type = /obj/item/cell/device/weapon/empty},/turf/template_noop,/area/submap/PooledR)
"i" = (/obj/structure/flora/ausbushes/reedbush,/turf/template_noop,/area/submap/PooledR)
"j" = (/turf/simulated/floor/outdoors/rocks,/area/submap/PooledR)
"k" = (/obj/structure/flora/ausbushes,/turf/template_noop,/area/submap/PooledR)
"l" = (/turf/simulated/floor/water,/area/submap/PooledR)
"m" = (/obj/structure/flora/ausbushes/grassybush,/turf/template_noop,/area/submap/PooledR)
"n" = (/mob/living/simple_mob/animal/passive/fish/trout,/turf/simulated/floor/water,/area/submap/PooledR)
"o" = (/mob/living/simple_mob/animal/passive/fish/salmon,/turf/simulated/floor/water,/area/submap/PooledR)
"p" = (/turf/simulated/floor/water/deep,/area/submap/PooledR)
"q" = (/mob/living/simple_mob/animal/passive/fish/bass,/turf/simulated/floor/water/deep,/area/submap/PooledR)

(1,1,1) = {"
aaaaaaaaaaaaaaaaaaaaaaaaaaaaaaaaaaa
abbbbbbbbbbbbbbbbbbbbbbbbbbbcccbbba
abbbbbbbbbbbbbbbbbbbbbbbbbbbccccbba
abbbbbbbbbbbbbbbbbbbbbbbbbcccccccba
abbbbbbbbbbbbbbbbbbbbdbbbbcccccccba
abbbbbbbbbbbdbbbbbbbbbbbbbcccccccba
abbbbbbbbbbbbbbbbbbbbbdbbccccccccba
abbbbbbbbbbbbbbbbbbbbbbbbccccccccba
abbbbbbbbbbbbbbbbbbbbbbbbccccccccba
abbbbbbbbbbbbbbbbbbbbbbbbccccccccba
abbbbbbbbbbbbbbbbbbbbbbbbcccccccbba
abbdbbbbbbbbbbbbbbbbbbbbbeccccccbba
abbbbbbbdbbbbbbbbbbbbbbbbfcccccbbba
abbbbbbbbbbbbbbbbbbbbgbbbhcccccbbba
abccbbbbbbbbbbbbbbbbbbibccccccbbbba
abcccbbbgbbbbbbibbjjjjjjccccccbbbba
abcccbbbbbbkbbbjjjjlllllccccccbbbba
acccccbbbbbbbjjjjllllllllcccccbbbba
acccccbmbbbjjjllllllllllllccccbbbba
acccccbbbijjjllllllllnlllccccccbbba
abccccbbjjjllllllllllllllccccccbbba
abcccccjjlllllolllllpppppccccccbbba
abccccccjlllllllllppppppcccccccbbba
abcccccccccllllppppqppppccccccccbba
abccccccccccclpppppppppcccccccccbba
abccccccccccccpppppppppcccccccccbba
abcccccccccccccpppppppccccccccccbba
abbccccccccccccccccppccccccccccbbba
abbcccccccccccccccccccccccccccccbba
abbbcccccccccccccccccccccccccccbbba
abbbbcccccccccccccccccccccccccbbbba
abbbbbbbbccccccccccccccccccccbbbbba
abbbbbbbbbbbbbcccccccccccbbbbbbbbba
abbbbbbbbbbbbbbbbbbbbbbbbbbbbbbbbba
aaaaaaaaaaaaaaaaaaaaaaaaaaaaaaaaaaa
"}
