//MAP CONVERTED BY dmm2tgm.py THIS HEADER COMMENT PREVENTS RECONVERSION, DO NOT REMOVE
"a" = (
/turf/template_noop,
/area/template_noop)
"b" = (
/turf/template_noop,
/area/submap/Shakden)
"c" = (
/turf/simulated/mineral/ignore_mapgen,
/area/submap/Shakden)
"d" = (
/turf/simulated/floor/outdoors/dirt{
	outdoors = 0
	},
/area/submap/Shakden)
"e" = (
/obj/effect/decal/remains/mouse,
/turf/simulated/floor/outdoors/dirt{
	outdoors = 0
	},
/area/submap/Shakden)
"f" = (
/obj/item/weapon/reagent_containers/food/snacks/meat,
/obj/item/weapon/reagent_containers/food/snacks/meat,
/obj/item/weapon/reagent_containers/food/snacks/meat,
/obj/item/weapon/reagent_containers/food/snacks/meat,
/obj/item/weapon/reagent_containers/food/snacks/meat,
/turf/simulated/floor/outdoors/dirt{
	outdoors = 0
	},
/area/submap/Shakden)
"g" = (
/obj/item/weapon/reagent_containers/food/snacks/meat,
/obj/item/weapon/reagent_containers/food/snacks/meat,
/obj/item/weapon/reagent_containers/food/snacks/meat,
/turf/simulated/floor/outdoors/dirt{
	outdoors = 0
	},
/area/submap/Shakden)
"h" = (
/mob/living/simple_mob/vore/aggressive/dragon/virgo3b,
/turf/simulated/floor/outdoors/dirt{
	outdoors = 0
	},
/area/submap/Shakden)
"i" = (
/turf/simulated/floor/outdoors/dirt,
/area/submap/Shakden)
"j" = (
/obj/item/weapon/reagent_containers/food/snacks/meat,
/turf/simulated/floor/outdoors/dirt{
	outdoors = 0
	},
/area/submap/Shakden)
"k" = (
/obj/item/weapon/reagent_containers/food/snacks/meat,
/obj/item/weapon/reagent_containers/food/snacks/meat,
/obj/item/weapon/reagent_containers/food/snacks/meat,
/obj/item/weapon/reagent_containers/food/snacks/meat,
/obj/item/weapon/material/knife/hook,
/turf/simulated/floor/outdoors/dirt{
	outdoors = 0
	},
/area/submap/Shakden)

(1,1,1) = {"
a
a
a
a
a
a
a
a
a
a
a
a
a
a
a
a
a
a
a
a
"}
(2,1,1) = {"
a
b
b
b
b
b
c
c
b
b
b
b
c
c
c
c
b
b
b
a
"}
(3,1,1) = {"
a
b
c
c
c
c
c
c
c
c
c
c
c
c
c
c
c
c
b
a
"}
(4,1,1) = {"
a
b
c
c
c
c
c
d
d
c
c
e
d
c
c
c
c
c
c
a
"}
(5,1,1) = {"
a
c
c
c
c
g
d
d
d
d
d
d
d
d
d
c
c
c
c
a
"}
(6,1,1) = {"
a
c
c
c
e
d
d
d
d
d
d
d
d
d
d
d
c
c
c
a
"}
(7,1,1) = {"
a
c
c
d
d
d
d
d
d
d
d
d
d
d
d
d
d
c
c
a
"}
(8,1,1) = {"
a
c
c
d
d
d
d
c
c
g
d
d
d
h
d
d
d
c
c
a
"}
(9,1,1) = {"
a
c
c
d
d
d
d
c
c
c
d
d
d
d
d
i
d
c
c
a
"}
(10,1,1) = {"
a
c
c
e
d
d
c
c
c
c
d
d
d
d
d
j
d
c
b
a
"}
(11,1,1) = {"
a
c
c
d
d
d
c
c
c
e
d
d
d
d
f
k
e
c
b
a
"}
(12,1,1) = {"
a
c
c
f
d
d
d
c
c
d
d
d
d
c
c
c
c
c
b
a
"}
(13,1,1) = {"
a
c
c
c
d
d
d
d
d
d
d
d
c
c
c
c
c
c
b
a
"}
(14,1,1) = {"
a
c
c
c
d
d
d
d
d
d
c
c
c
c
c
c
c
c
c
a
"}
(15,1,1) = {"
a
c
c
c
d
d
d
d
d
d
c
c
c
d
d
d
d
c
c
a
"}
(16,1,1) = {"
a
c
c
c
c
c
d
d
d
d
c
c
d
d
d
d
d
c
c
a
"}
(17,1,1) = {"
a
b
c
c
c
c
c
d
d
d
c
d
d
d
d
c
c
c
c
a
"}
(18,1,1) = {"
a
b
c
c
c
c
c
c
c
c
c
d
d
b
b
b
c
c
b
a
"}
(19,1,1) = {"
a
b
b
b
c
c
c
c
c
c
c
b
b
b
b
b
b
b
b
a
"}
(20,1,1) = {"
a
a
a
a
a
a
a
a
a
a
a
a
a
a
a
a
a
a
a
a
"}
