"a" = (/turf/template_noop,/area/template_noop)
"b" = (/turf/template_noop,/area/submap/smol2)
"c" = (/obj/structure/flora/tree/sif,/turf/template_noop,/area/submap/smol2)
"d" = (/turf/simulated/mineral/ignore_mapgen,/area/submap/smol2)
"e" = (/obj/item/stack/material/wood/sif,/obj/item/stack/material/wood/sif,/obj/item/stack/material/wood/sif,/obj/item/stack/material/wood/sif,/obj/item/stack/material/wood/sif,/obj/item/stack/material/wood/sif,/turf/template_noop,/area/submap/smol2)
"f" = (/obj/structure/table/woodentable,/turf/template_noop,/area/submap/smol2)
"g" = (/obj/item/storage/firstaid,/obj/item/stack/medical/splint,/obj/item/reagent_containers/pill/tramadol,/turf/template_noop,/area/submap/smol2)
"h" = (/obj/effect/decal/cleanable/blood,/turf/template_noop,/area/submap/smol2)

(1,1,1) = {"
aaaaaaaaaa
abbbcbbdda
abbbbbddda
acbbebbdda
abbbbfddba
abbbghddba
adddddddba
abddddbbba
abbbbbbbba
aaaaaaaaaa
"}
