"a" = (/turf/template_noop,/area/template_noop)
"b" = (/turf/template_noop,/area/submap/smol2)
"c" = (/turf/simulated/floor/outdoors/snow,/area/submap/smol2)

(1,1,1) = {"
aaaaaaaaaaaaaaa
abbbbbbbbbcbbba
abbbbbbbbcccbba
abbbbbbcccccbba
abbbbbccccccbba
abbbbccccccbbba
abbbbccccccbbba
abbbbccccccbbba
abbbcccccccbbba
abbbcccccccbbba
abbbcccccccbbba
abbbccccccbbbba
abbcccccccbbbba
abbccccccbbbbba
abbcccccbbbbbba
abbccccbbbbbbba
abccccbbbbbbbba
abccbcbbbbbbbba
abbbbbbbbbbbbba
aaaaaaaaaaaaaaa
"}
