//MAP CONVERTED BY dmm2tgm.py THIS HEADER COMMENT PREVENTS RECONVERSION, DO NOT REMOVE
"a" = (
/obj/structure/snowman/borg,
/obj/effect/overlay/snow/floor/edges{
	dir = 10
	},
/turf/simulated/floor/snow{
	temperature = 268.15
	},
/area/survivalpod/redspace)
"b" = (
/obj/structure/window/reinforced/survival_pod{
	dir = 8
	},
/obj/structure/window/reinforced/survival_pod{
	dir = 4
	},
/obj/structure/window/reinforced/survival_pod{
	dir = 1
	},
/obj/structure/grille,
/turf/simulated/shuttle/floor/voidcraft/dark,
/area/survivalpod/redspace)
"c" = (
/obj/effect/overlay/snow/floor/edges{
	dir = 6
	},
/turf/simulated/floor/snow{
	temperature = 268.15
	},
/area/survivalpod/redspace)
"d" = (
/obj/effect/overlay/snow/floor/edges{
	dir = 8
	},
/turf/simulated/floor/snow{
	temperature = 268.15
	},
/area/survivalpod/redspace)
"e" = (
/obj/effect/overlay/snow/floor/edges{
	dir = 4
	},
/turf/simulated/floor/snow{
	temperature = 268.15
	},
/area/survivalpod/redspace)
"f" = (
/turf/simulated/floor/snow{
	temperature = 268.15
	},
/area/survivalpod/redspace)
"g" = (
/obj/structure/sign/christmas/lights{
	dir = 4;
	pixel_x = -6
	},
/turf/simulated/shuttle/wall/voidcraft/survival,
/area/survivalpod/redspace)
"h" = (
/obj/effect/overlay/snow/floor/edges,
/turf/simulated/floor/snow{
	temperature = 268.15
	},
/area/survivalpod/redspace)
"i" = (
/obj/effect/overlay/snow/floor/edges{
	dir = 9
	},
/turf/simulated/floor/snow{
	temperature = 268.15
	},
/area/survivalpod/redspace)
"j" = (
/obj/structure/window/reinforced/survival_pod{
	dir = 8
	},
/obj/structure/window/reinforced/survival_pod{
	dir = 1
	},
/turf/simulated/floor/wood/alt/panel,
/area/survivalpod/redspace)
"k" = (
/obj/machinery/door/window/survival_pod{
	dir = 1;
	icon_state = "windoor"
	},
/obj/machinery/light/floortube,
/obj/structure/fans/tiny{
	pixel_y = 9
	},
/turf/simulated/floor/wood/alt/panel,
/area/survivalpod/redspace)
"l" = (
/obj/structure/sign/christmas/wreath,
/turf/simulated/shuttle/wall/voidcraft/survival,
/area/survivalpod/redspace)
"m" = (
/obj/effect/overlay/snow/floor/edges{
	dir = 1
	},
/obj/item/toy/snowglobe/snowvillage{
	pixel_x = 1;
	pixel_y = -6
	},
/turf/simulated/floor/snow{
	temperature = 268.15
	},
/area/survivalpod/redspace)
"o" = (
/obj/machinery/light{
	dir = 8
	},
/obj/effect/overlay/snow/floor/edges{
	dir = 8
	},
/turf/simulated/floor/snow{
	temperature = 268.15
	},
/area/survivalpod/redspace)
"s" = (
/mob/living/simple_mob/vore/reindeer{
	size_multiplier = 2;
	name = "Holly";
	desc = "A VERY large reindeer."
	},
/turf/simulated/floor/snow{
	temperature = 268.15
	},
/area/survivalpod/redspace)
"x" = (
/obj/structure/fans/tiny,
/obj/effect/floor_decal/industrial/danger/full,
/obj/item/toy/mistletoe,
/obj/machinery/door/airlock/voidcraft/survival_pod{
	layer = 3.1
	},
/turf/simulated/shuttle/floor/voidcraft,
/area/survivalpod/redspace)
"y" = (
/obj/structure/window/reinforced/survival_pod{
	dir = 8
	},
/turf/simulated/floor/wood/alt/panel,
/area/survivalpod/redspace)
"A" = (
/turf/simulated/shuttle/wall/voidcraft/survival,
/area/survivalpod/redspace)
"C" = (
/obj/structure/flora/tree/pine/xmas,
/obj/effect/overlay/snow/floor/edges{
	dir = 1
	},
/turf/simulated/floor/snow{
	temperature = 268.15
	},
/area/survivalpod/redspace)
"E" = (
/obj/structure/window/reinforced/survival_pod{
	dir = 8
	},
/obj/structure/window/reinforced/survival_pod{
	dir = 4
	},
/obj/structure/window/reinforced/survival_pod,
/obj/structure/grille,
/turf/simulated/shuttle/floor/voidcraft/dark,
/area/survivalpod/redspace)
"F" = (
/obj/structure/window/reinforced/survival_pod{
	dir = 1
	},
/turf/simulated/floor/wood/alt/panel,
/area/survivalpod/redspace)
"G" = (
/obj/machinery/smartfridge/survival_pod,
/obj/item/clothing/shoes/boots/winter/christmasred,
/obj/item/clothing/shoes/boots/winter/christmasred,
/obj/item/clothing/shoes/boots/winter/christmasgreen,
/obj/item/clothing/shoes/boots/winter/christmasgreen,
/obj/item/clothing/suit/storage/hooded/wintercoat/christmasred,
/obj/item/clothing/suit/storage/hooded/wintercoat/christmasred,
/obj/item/clothing/suit/storage/hooded/wintercoat/christmasgreen,
/obj/item/clothing/suit/storage/hooded/wintercoat/christmasgreen,
/obj/item/clothing/under/christmas/croptop/green,
/obj/item/clothing/under/christmas/croptop/green,
/obj/item/clothing/under/christmas/croptop/red,
/obj/item/clothing/under/christmas/croptop/red,
/obj/item/clothing/under/christmas/green,
/obj/item/clothing/under/christmas/green,
/obj/item/clothing/under/christmas/red,
/obj/item/clothing/under/christmas/red,
/obj/item/reagent_containers/food/drinks/h_chocolate,
/obj/item/reagent_containers/food/drinks/h_chocolate,
/obj/item/reagent_containers/food/drinks/h_chocolate,
/obj/item/reagent_containers/food/drinks/h_chocolate,
/obj/item/clothing/accessory/sweater/uglyxmas,
/obj/item/clothing/accessory/sweater/uglyxmas,
/obj/item/toy/xmas_cracker,
/obj/item/toy/xmas_cracker,
/obj/item/clothing/head/santa,
/obj/item/clothing/head/santa,
/obj/item/clothing/head/santa/green,
/obj/item/clothing/head/santa/green,
/turf/simulated/floor/wood/alt/panel,
/area/survivalpod/redspace)
"J" = (
/obj/structure/snowman,
/obj/effect/overlay/snow/floor/edges{
	dir = 5
	},
/turf/simulated/floor/snow{
	temperature = 268.15
	},
/area/survivalpod/redspace)
"K" = (
/obj/machinery/light{
	dir = 1
	},
/obj/effect/overlay/snow/floor/edges{
	dir = 1
	},
/turf/simulated/floor/snow{
	temperature = 268.15
	},
/area/survivalpod/redspace)
"M" = (
/obj/structure/sign/christmas/lights{
	pixel_y = 6
	},
/turf/simulated/shuttle/wall/voidcraft/survival,
/area/survivalpod/redspace)
"R" = (
/obj/structure/sign/christmas/lights{
	dir = 8;
	pixel_x = 6
	},
/turf/simulated/shuttle/wall/voidcraft/survival,
/area/survivalpod/redspace)
"S" = (
/obj/structure/sign/christmas/lights{
	dir = 1;
	pixel_y = -6
	},
/turf/simulated/shuttle/wall/voidcraft/survival,
/area/survivalpod/redspace)
"U" = (
/turf/simulated/floor/carpet/turcarpet,
/area/survivalpod/redspace)

(1,1,1) = {"
A
b
E
g
g
g
A
"}
(2,1,1) = {"
M
i
d
o
d
a
S
"}
(3,1,1) = {"
M
m
s
f
e
c
S
"}
(4,1,1) = {"
A
C
f
h
j
y
l
"}
(5,1,1) = {"
M
K
f
h
k
U
x
"}
(6,1,1) = {"
M
J
e
c
F
G
l
"}
(7,1,1) = {"
A
R
b
E
R
R
A
"}
