//MAP CONVERTED BY dmm2tgm.py THIS HEADER COMMENT PREVENTS RECONVERSION, DO NOT REMOVE
"a" = (
/obj/structure/window/reinforced/survival_pod{
	dir = 8
	},
/obj/structure/window/reinforced/survival_pod{
	dir = 4
	},
/obj/structure/window/reinforced/survival_pod{
	dir = 1
	},
/obj/structure/grille,
/turf/simulated/shuttle/floor/voidcraft/dark,
/area/survivalpod/redspace)
"b" = (
/obj/structure/sign/mining/survival,
/turf/simulated/shuttle/wall/voidcraft/survival,
/area/survivalpod/redspace)
"c" = (
/obj/structure/fans,
/turf/simulated/floor/outdoors/sidewalk/slab,
/area/survivalpod/redspace)
"d" = (
/obj/structure/sign/mining/survival{
	dir = 8
	},
/turf/simulated/shuttle/wall/voidcraft/survival,
/area/survivalpod/redspace)
"e" = (
/obj/structure/sign/mining/survival{
	dir = 4
	},
/turf/simulated/shuttle/wall/voidcraft/survival,
/area/survivalpod/redspace)
"f" = (
/obj/structure/sign/mining/survival{
	dir = 1
	},
/turf/simulated/shuttle/wall/voidcraft/survival,
/area/survivalpod/redspace)
"i" = (
/turf/simulated/floor/outdoors/grass/seasonal/notrees_nomobs_nosnow,
/area/survivalpod/redspace)
"n" = (
/obj/machinery/smartfridge/survival_pod,
/obj/item/material/knife/machete/hatchet,
/obj/item/reagent_containers/glass/bucket/wood,
/obj/item/clothing/suit/storage/apron,
/obj/item/clothing/suit/storage/apron/overalls,
/turf/simulated/floor/outdoors/sidewalk/slab,
/area/survivalpod/redspace)
"p" = (
/obj/machinery/light/floortube{
	dir = 1
	},
/turf/simulated/floor/outdoors/sidewalk/slab,
/area/survivalpod/redspace)
"t" = (
/obj/structure/window/reinforced/survival_pod{
	dir = 8
	},
/obj/structure/window/reinforced/survival_pod{
	dir = 4
	},
/obj/structure/window/reinforced/survival_pod,
/obj/structure/grille,
/obj/structure/window/reinforced/survival_pod{
	dir = 1
	},
/turf/simulated/shuttle/floor/voidcraft/dark,
/area/survivalpod/redspace)
"u" = (
/obj/structure/window/reinforced/survival_pod{
	dir = 8
	},
/obj/structure/window/reinforced/survival_pod{
	dir = 4
	},
/obj/structure/window/reinforced/survival_pod,
/obj/structure/grille,
/turf/simulated/shuttle/floor/voidcraft/dark,
/area/survivalpod/redspace)
"v" = (
/obj/structure/fans/tiny,
/obj/machinery/door/airlock/voidcraft/survival_pod,
/obj/effect/floor_decal/industrial/danger/full,
/turf/simulated/shuttle/floor/voidcraft,
/area/survivalpod/redspace)
"w" = (
/obj/machinery/portable_atmospherics/hydroponics/soil,
/turf/simulated/floor/outdoors/grass/seasonal/notrees_nomobs_nosnow,
/area/survivalpod/redspace)
"x" = (
/turf/simulated/floor/outdoors/newdirt_nograss,
/area/survivalpod/redspace)
"y" = (
/obj/structure/window/reinforced/survival_pod{
	dir = 8
	},
/obj/structure/window/reinforced/survival_pod{
	dir = 4
	},
/obj/structure/grille,
/turf/simulated/shuttle/floor/voidcraft/dark,
/area/survivalpod/redspace)
"z" = (
/obj/machinery/vending/hydronutrients,
/turf/simulated/floor/outdoors/sidewalk/slab,
/area/survivalpod/redspace)
"E" = (
/obj/machinery/vending/hydroseeds,
/turf/simulated/floor/outdoors/sidewalk/slab,
/area/survivalpod/redspace)
"I" = (
/turf/simulated/shuttle/wall/voidcraft/survival,
/area/survivalpod/redspace)
"L" = (
/obj/machinery/light/floortube,
/turf/simulated/floor/outdoors/sidewalk/slab,
/area/survivalpod/redspace)
"W" = (
/obj/structure/sink/puddle,
/turf/simulated/floor/outdoors/newdirt_nograss,
/area/survivalpod/redspace)

(1,1,1) = {"
I
d
a
y
u
d
I
"}
(2,1,1) = {"
f
c
x
w
w
w
b
"}
(3,1,1) = {"
t
n
i
i
i
i
t
"}
(4,1,1) = {"
v
p
i
i
i
L
v
"}
(5,1,1) = {"
t
E
i
i
i
i
t
"}
(6,1,1) = {"
f
z
i
w
i
W
b
"}
(7,1,1) = {"
I
e
a
y
u
e
I
"}
