//MAP CONVERTED BY dmm2tgm.py THIS HEADER COMMENT PREVENTS RECONVERSION, DO NOT REMOVE
"a" = (
/obj/machinery/light{
	dir = 1
	},
/turf/simulated/floor/water/deep/indoors,
/area/survivalpod/redspace)
"b" = (
/obj/machinery/light{
	dir = 1
	},
/mob/living/simple_mob/vore/jelly,
/turf/simulated/floor/water/deep/indoors,
/area/survivalpod/redspace)
"e" = (
/obj/structure/window/reinforced/survival_pod{
	dir = 8
	},
/obj/structure/window/reinforced/survival_pod{
	dir = 4
	},
/obj/structure/window/reinforced/survival_pod,
/obj/structure/grille,
/turf/simulated/shuttle/floor/voidcraft/dark,
/area/survivalpod/redspace)
"f" = (
/obj/structure/fans/tiny,
/obj/machinery/door/airlock/voidcraft/survival_pod,
/obj/effect/floor_decal/industrial/danger/full,
/turf/simulated/shuttle/floor/voidcraft,
/area/survivalpod/redspace)
"n" = (
/obj/structure/railing{
	dir = 1
	},
/obj/effect/floor_decal/spline/plain{
	dir = 1
	},
/turf/simulated/floor/tiled/white,
/area/survivalpod/redspace)
"q" = (
/obj/structure/sign/mining/survival{
	dir = 8
	},
/turf/simulated/shuttle/wall/voidcraft/survival,
/area/survivalpod/redspace)
"r" = (
/obj/structure/sign/mining/survival{
	dir = 1
	},
/turf/simulated/shuttle/wall/voidcraft/survival,
/area/survivalpod/redspace)
"x" = (
/obj/structure/railing{
	dir = 1
	},
/obj/machinery/light/floortube{
	dir = 1
	},
/obj/effect/floor_decal/spline/plain{
	dir = 1
	},
/turf/simulated/floor/tiled/white,
/area/survivalpod/redspace)
"A" = (
/obj/machinery/smartfridge/survival_pod,
/obj/item/clothing/under/swimsuit/fluff/security,
/obj/item/clothing/under/swimsuit/fluff/security,
/obj/item/clothing/under/swimsuit/green,
/obj/item/clothing/under/swimsuit/green,
/obj/item/clothing/under/swimsuit/highclass,
/obj/item/clothing/under/swimsuit/highclass,
/obj/item/clothing/under/swimsuit/purple,
/obj/item/clothing/under/swimsuit/purple,
/obj/item/clothing/under/swimsuit/red,
/obj/item/clothing/under/swimsuit/red,
/obj/item/clothing/under/swimsuit/risque,
/obj/item/clothing/under/swimsuit/risque,
/obj/item/clothing/under/swimsuit/streamlined,
/obj/item/clothing/under/swimsuit/streamlined,
/obj/item/clothing/under/swimsuit/striped,
/obj/item/clothing/under/swimsuit/striped,
/obj/item/clothing/under/swimsuit/stripper/mankini,
/obj/item/clothing/under/swimsuit/stripper/mankini,
/obj/item/clothing/under/swimsuit/stripper/stripper_pink,
/obj/item/clothing/under/swimsuit/stripper/stripper_pink,
/obj/item/clothing/under/swimsuit/white,
/obj/item/clothing/under/swimsuit/white,
/obj/item/clothing/under/swimsuit/blue,
/obj/item/clothing/under/swimsuit/blue,
/obj/item/clothing/under/swimsuit/cowbikini,
/obj/item/clothing/under/swimsuit/cowbikini,
/obj/item/clothing/under/swimsuit/earth,
/obj/item/clothing/under/swimsuit/earth,
/obj/item/clothing/under/swimsuit/fluff/engineering,
/obj/item/clothing/under/swimsuit/fluff/engineering,
/obj/item/clothing/under/swimsuit/fluff/medical,
/obj/item/clothing/under/swimsuit/fluff/medical,
/obj/item/clothing/under/swimsuit/fluff/science,
/obj/item/clothing/under/swimsuit/fluff/science,
/obj/item/beach_ball,
/obj/item/inflatable_duck,
/turf/simulated/floor/tiled/white,
/area/survivalpod/redspace)
"D" = (
/obj/structure/window/reinforced/survival_pod{
	dir = 1
	},
/obj/structure/window/reinforced/survival_pod,
/obj/structure/grille,
/turf/simulated/shuttle/floor/voidcraft/dark,
/area/survivalpod/redspace)
"H" = (
/obj/structure/window/reinforced/survival_pod{
	dir = 8
	},
/obj/structure/window/reinforced/survival_pod{
	dir = 1
	},
/obj/structure/window/reinforced/survival_pod,
/obj/structure/grille,
/turf/simulated/shuttle/floor/voidcraft/dark,
/area/survivalpod/redspace)
"J" = (
/obj/structure/window/reinforced/survival_pod{
	dir = 8
	},
/obj/structure/window/reinforced/survival_pod{
	dir = 4
	},
/obj/structure/window/reinforced/survival_pod{
	dir = 1
	},
/obj/structure/grille,
/turf/simulated/shuttle/floor/voidcraft/dark,
/area/survivalpod/redspace)
"K" = (
/turf/simulated/shuttle/wall/voidcraft/survival,
/area/survivalpod/redspace)
"L" = (
/obj/structure/window/reinforced/survival_pod{
	dir = 4
	},
/obj/structure/window/reinforced/survival_pod{
	dir = 1
	},
/obj/structure/window/reinforced/survival_pod,
/obj/structure/grille,
/turf/simulated/shuttle/floor/voidcraft/dark,
/area/survivalpod/redspace)
"N" = (
/obj/structure/sign/mining,
/turf/simulated/shuttle/wall/voidcraft/survival,
/area/survivalpod/redspace)
"O" = (
/mob/living/simple_mob/vore/slug{
	dir = 1
	},
/turf/simulated/floor/water/deep/indoors,
/area/survivalpod/redspace)
"P" = (
/obj/structure/sign/mining/survival,
/turf/simulated/shuttle/wall/voidcraft/survival,
/area/survivalpod/redspace)
"R" = (
/obj/structure/sign/mining/survival{
	dir = 4
	},
/turf/simulated/shuttle/wall/voidcraft/survival,
/area/survivalpod/redspace)
"S" = (
/turf/simulated/floor/water/deep/indoors,
/area/survivalpod/redspace)
"U" = (
/obj/structure/fans,
/turf/simulated/floor/tiled/white,
/area/survivalpod/redspace)
"V" = (
/mob/living/simple_mob/vore/jelly,
/turf/simulated/floor/water/deep/indoors,
/area/survivalpod/redspace)

(1,1,1) = {"
K
q
J
e
K
q
K
"}
(2,1,1) = {"
r
b
S
S
S
U
P
"}
(3,1,1) = {"
H
S
S
O
S
n
K
"}
(4,1,1) = {"
D
S
S
S
V
x
f
"}
(5,1,1) = {"
L
S
V
S
S
n
K
"}
(6,1,1) = {"
r
a
S
S
S
A
N
"}
(7,1,1) = {"
K
R
J
e
K
R
K
"}
