//MAP CONVERTED BY dmm2tgm.py THIS HEADER COMMENT PREVENTS RECONVERSION, DO NOT REMOVE
"a" = (
/turf/simulated/shuttle/wall/voidcraft/survival,
/area/survivalpod/redspace)
"e" = (
/obj/machinery/door/window/survival_pod{
	dir = 1;
	icon_state = "windoor"
	},
/turf/simulated/floor/wood/sif,
/area/survivalpod/redspace)
"k" = (
/obj/machinery/light/small{
	light_type = /obj/item/light/bulb/blue
	},
/obj/structure/window/reinforced/survival_pod{
	dir = 1;
	icon_state = "pwindow"
	},
/turf/simulated/floor/wood/sif,
/area/survivalpod/redspace)
"n" = (
/obj/structure/sign/mining/survival,
/turf/simulated/shuttle/wall/voidcraft/survival,
/area/survivalpod/redspace)
"p" = (
/obj/structure/window/reinforced/survival_pod{
	density = 0;
	dir = 9;
	icon_state = "pwindow"
	},
/turf/simulated/floor/wood/sif,
/area/survivalpod/redspace)
"s" = (
/turf/simulated/shuttle/wall/voidcraft,
/area/survivalpod/redspace)
"t" = (
/obj/structure/window/reinforced/survival_pod{
	dir = 8;
	layer = 2.6
	},
/turf/simulated/floor/wood/sif,
/area/survivalpod/redspace)
"u" = (
/obj/structure/window/reinforced/survival_pod{
	dir = 4;
	layer = 2.6
	},
/turf/simulated/floor/wood/sif,
/area/survivalpod/redspace)
"w" = (
/obj/structure/sign/mining,
/turf/simulated/shuttle/wall/voidcraft/survival,
/area/survivalpod/redspace)
"y" = (
/obj/machinery/button/remote/airlock/survival_pod/bolts{
	pixel_y = -22;
	pixel_x = 21
	},
/obj/machinery/light_switch/survival_pod{
	dir = 4;
	pixel_x = -22;
	pixel_y = -1
	},
/turf/simulated/floor/carpet/blue2,
/area/survivalpod/redspace)
"B" = (
/obj/machinery/light/small{
	dir = 8;
	light_type = /obj/item/light/bulb/blue
	},
/obj/structure/table/wooden_reinforced,
/obj/item/reagent_containers/food/drinks/bottle/wine{
	pixel_x = -6;
	pixel_y = 10
	},
/obj/item/reagent_containers/food/drinks/glass2/rocks{
	pixel_x = 7;
	pixel_y = 2
	},
/turf/simulated/floor/carpet/purple,
/area/survivalpod/redspace)
"D" = (
/obj/machinery/smartfridge/survival_pod{
	pixel_y = 28;
	density = 0
	},
/obj/item/storage/mre/random,
/obj/item/storage/mre/random,
/obj/item/storage/mre/random,
/obj/item/storage/mre/random,
/obj/item/storage/mre/random,
/obj/item/storage/mre/random,
/obj/item/storage/mre/menu9,
/obj/item/storage/mre/menu9,
/obj/item/storage/mre/menu10,
/obj/item/storage/mre/menu10,
/obj/item/storage/mre/menu11,
/obj/item/storage/mre/menu11,
/obj/item/fbp_backup_cell,
/obj/item/fbp_backup_cell,
/obj/item/fbp_backup_cell,
/obj/item/fbp_backup_cell,
/obj/item/fbp_backup_cell,
/obj/item/storage/firstaid/fire,
/obj/item/storage/firstaid/toxin,
/obj/item/storage/firstaid/o2,
/obj/item/storage/box/survival/space,
/obj/item/clothing/accessory/watch/survival,
/obj/item/emergency_beacon,
/obj/item/healthanalyzer,
/obj/item/storage/pill_bottle/dice_nerd,
/turf/simulated/shuttle/floor/voidcraft,
/area/survivalpod/redspace)
"E" = (
/obj/structure/bed/double/padded,
/obj/item/bedsheet/rddouble,
/turf/simulated/floor/carpet/blue2,
/area/survivalpod/redspace)
"F" = (
/obj/structure/sign/mining/survival{
	dir = 8
	},
/turf/simulated/shuttle/wall/voidcraft/survival,
/area/survivalpod/redspace)
"H" = (
/obj/structure/fans/tiny,
/obj/machinery/door/airlock/voidcraft/survival_pod,
/obj/effect/floor_decal/industrial/danger/full,
/turf/simulated/shuttle/floor/voidcraft,
/area/survivalpod/redspace)
"I" = (
/obj/item/gps/computer{
	density = 0;
	pixel_y = 0
	},
/turf/simulated/shuttle/floor/voidcraft,
/area/survivalpod/redspace)
"J" = (
/turf/simulated/floor/carpet/blue2,
/area/survivalpod/redspace)
"K" = (
/obj/machinery/button/remote/airlock/survival_pod/bolts{
	pixel_y = -22;
	pixel_x = -21
	},
/obj/machinery/light_switch/survival_pod{
	dir = 8;
	pixel_x = 22;
	pixel_y = -1
	},
/turf/simulated/floor/carpet/purple,
/area/survivalpod/redspace)
"L" = (
/turf/simulated/shuttle/wall/voidcraft/hard_corner,
/area/survivalpod/redspace)
"M" = (
/obj/machinery/door/airlock/voidcraft/survival_pod,
/obj/effect/floor_decal/industrial/danger/full,
/turf/simulated/shuttle/floor/voidcraft,
/area/survivalpod/redspace)
"N" = (
/obj/structure/bed/double/padded{
	dir = 1
	},
/obj/item/bedsheet/reddouble{
	dir = 1
	},
/turf/simulated/floor/carpet/purple,
/area/survivalpod/redspace)
"Q" = (
/obj/structure/fans{
	pixel_y = 32;
	density = 0
	},
/obj/machinery/sleeper/survival_pod,
/turf/simulated/shuttle/floor/voidcraft,
/area/survivalpod/redspace)
"T" = (
/obj/machinery/light/small{
	dir = 4;
	light_type = /obj/item/light/bulb/blue
	},
/obj/structure/table/wooden_reinforced,
/obj/item/storage/firstaid/adv,
/turf/simulated/floor/carpet/blue2,
/area/survivalpod/redspace)
"U" = (
/turf/simulated/floor/carpet/purple,
/area/survivalpod/redspace)
"X" = (
/obj/structure/sign/mining/survival{
	dir = 4
	},
/turf/simulated/shuttle/wall/voidcraft/survival,
/area/survivalpod/redspace)
"Y" = (
/obj/structure/window/reinforced/survival_pod{
	density = 0;
	dir = 5;
	icon_state = "pwindow"
	},
/turf/simulated/floor/wood/sif,
/area/survivalpod/redspace)
"Z" = (
/obj/structure/sign/mining/survival{
	dir = 1
	},
/turf/simulated/shuttle/wall/voidcraft/survival,
/area/survivalpod/redspace)

(1,1,1) = {"
a
F
a
F
a
F
a
"}
(2,1,1) = {"
Z
J
y
M
u
Y
n
"}
(3,1,1) = {"
a
E
T
L
Q
k
a
"}
(4,1,1) = {"
Z
s
s
L
D
e
H
"}
(5,1,1) = {"
a
N
B
L
I
k
a
"}
(6,1,1) = {"
Z
U
K
M
t
p
w
"}
(7,1,1) = {"
a
X
a
X
a
X
a
"}
