"a" = (/turf/simulated/mineral,/area/submap/cave/BlastMine1)
"b" = (/turf/simulated/mineral/floor/ignore_mapgen,/area/submap/cave/BlastMine1)
"c" = (/obj/structure/sign/warning/bomb_range,/turf/simulated/wall/sandstone,/area/submap/cave/BlastMine1)
"d" = (/obj/structure/table/rack,/obj/item/weapon/syndie/c4explosive,/turf/simulated/mineral/floor/ignore_mapgen,/area/submap/cave/BlastMine1)
"e" = (/obj/structure/loot_pile/surface/bones,/turf/simulated/mineral/floor/ignore_mapgen,/area/submap/cave/BlastMine1)
"f" = (/mob/living/simple_mob/animal/sif/savik,/turf/simulated/mineral/floor/ignore_mapgen,/area/submap/cave/BlastMine1)
"g" = (/obj/structure/table/rack,/obj/item/clothing/head/bomb_hood,/obj/item/clothing/suit/bomb_suit,/turf/simulated/mineral/floor/ignore_mapgen,/area/submap/cave/BlastMine1)
"h" = (/obj/item/device/gps/internal/poi{gps_tag = "Unidentified Signal"},/turf/simulated/wall/sandstone,/area/submap/cave/BlastMine1)
"i" = (/mob/living/simple_mob/animal/sif/diyaab,/turf/simulated/mineral/floor/ignore_mapgen,/area/submap/cave/BlastMine1)
"j" = (/obj/structure/table/reinforced,/obj/item/weapon/flame/lighter/zippo/c4detonator{detonator_mode = 1},/turf/simulated/mineral/floor/ignore_mapgen,/area/submap/cave/BlastMine1)
"k" = (/obj/structure/table/rack,/turf/simulated/mineral/floor/ignore_mapgen,/area/submap/cave/BlastMine1)
"l" = (/obj/machinery/floodlight,/turf/simulated/mineral/floor/ignore_mapgen,/area/submap/cave/BlastMine1)
"m" = (/turf/simulated/wall/sandstone,/area/submap/cave/BlastMine1)
"n" = (/obj/structure/girder/displaced,/obj/structure/sign/warning/bomb_range,/turf/simulated/mineral/floor/ignore_mapgen,/area/submap/cave/BlastMine1)
"o" = (/obj/structure/table,/turf/simulated/mineral/floor/ignore_mapgen,/area/submap/cave/BlastMine1)
"p" = (/obj/effect/decal/remains/human,/turf/simulated/mineral/floor/ignore_mapgen,/area/submap/cave/BlastMine1)
"q" = (/obj/structure/sign/warning/bomb_range,/turf/simulated/wall/sandstone{damage = 20},/area/submap/cave/BlastMine1)

(1,1,1) = {"
aaabbbaaaa
aabbbbaaaa
aacbbbbaaa
aadbbbbbbb
abdbbecbbb
abdbfbgbbb
abhbbbbbba
abdibbgjaa
bbkbilmaaa
bbkbbbbbba
banbbbbbbb
abbbbbbbbb
aaopbbqbbb
bbbbbbbbba
baabbbaaaa
"}
