//MAP CONVERTED BY dmm2tgm.py THIS HEADER COMMENT PREVENTS RECONVERSION, DO NOT REMOVE
"a" = (
/turf/template_noop,
/area/template_noop)
"b" = (
/turf/template_noop,
/area/submap/CaveTrench)
"c" = (
/turf/simulated/mineral/ignore_mapgen,
/area/submap/CaveTrench)
"d" = (
/turf/simulated/mineral/floor/ignore_mapgen,
/area/submap/CaveTrench)
"e" = (
/turf/simulated/floor/outdoors/rocks,
/area/submap/CaveTrench)
"f" = (
/turf/simulated/floor/water{
	outdoors = 0
	},
/area/submap/CaveTrench)
"g" = (
/mob/living/simple_animal/hostile/malf_drone/lesser,
/turf/simulated/mineral/floor/ignore_mapgen,
/area/submap/CaveTrench)
"h" = (
/mob/living/simple_animal/fish/trout{
	faction = "malf_drone"
	},
/turf/simulated/floor/water{
	outdoors = 0
	},
/area/submap/CaveTrench)
"i" = (
/obj/effect/decal/remains/human,
/turf/simulated/mineral/floor/ignore_mapgen,
/area/submap/CaveTrench)
"j" = (
/turf/simulated/wall,
/area/submap/CaveTrench)
"k" = (
/turf/simulated/floor/holofloor/wood,
/area/submap/CaveTrench)
"l" = (
/mob/living/simple_animal/fish/trout,
/turf/simulated/floor/water{
	outdoors = 0
	},
/area/submap/CaveTrench)
"m" = (
/turf/simulated/wall/wood,
/area/submap/CaveTrench)
"n" = (
/obj/structure/table/woodentable,
/obj/item/device/flashlight/lantern,
/turf/simulated/mineral/floor/ignore_mapgen,
/area/submap/CaveTrench)
"o" = (
/obj/structure/table/woodentable,
/obj/item/weapon/gun/projectile/shotgun/pump,
/turf/simulated/floor/holofloor/wood,
/area/submap/CaveTrench)
"p" = (
/obj/structure/table/woodentable,
/obj/item/weapon/reagent_containers/food/drinks/bottle/whiskey,
/turf/simulated/floor/holofloor/wood,
/area/submap/CaveTrench)
"q" = (
/obj/item/weapon/stool/padded,
/turf/simulated/floor/holofloor/wood,
/area/submap/CaveTrench)
"r" = (
/obj/structure/table/steel,
/turf/simulated/mineral/floor/ignore_mapgen,
/area/submap/CaveTrench)
"s" = (
/obj/structure/table/steel,
/obj/item/weapon/paper{
	info = "Rellek's telling me that we're in deep shit if the townies found out I'm cooking up drones out here. Like I give a fuck, We're minning our asses off only to dig into some bug nest to get our legs chewed. Well I'm not looking a gift horse in the mouth. Those drone dudes out in the wild hooked us up with these machines so long as they get some of the metal we dig up. Win win for us, Guess we're retiring early after all.";
	name = "Note"
	},
/turf/simulated/mineral/floor/ignore_mapgen,
/area/submap/CaveTrench)
"t" = (
/obj/structure/table/steel,
/obj/item/robot_parts/robot_component/actuator,
/turf/simulated/mineral/floor/ignore_mapgen,
/area/submap/CaveTrench)
"u" = (
/obj/effect/decal/cleanable/blood,
/turf/simulated/mineral/floor/ignore_mapgen,
/area/submap/CaveTrench)
"v" = (
/obj/structure/simple_door/wood,
/turf/simulated/mineral/floor/ignore_mapgen,
/area/submap/CaveTrench)
"w" = (
/obj/structure/table/woodentable,
/obj/item/device/flashlight/lamp,
/turf/simulated/floor/holofloor/wood,
/area/submap/CaveTrench)
"x" = (
/obj/structure/table/steel,
/obj/item/device/robotanalyzer,
/turf/simulated/mineral/floor/ignore_mapgen,
/area/submap/CaveTrench)
"y" = (
/obj/structure/table/steel,
/obj/item/weapon/storage/toolbox,
/turf/simulated/mineral/floor/ignore_mapgen,
/area/submap/CaveTrench)
"z" = (
/obj/structure/table/bench/steel,
/turf/simulated/mineral/floor/ignore_mapgen,
/area/submap/CaveTrench)
"A" = (
/obj/effect/decal/remains,
/obj/item/clothing/under/rank/miner,
/turf/simulated/mineral/floor/ignore_mapgen,
/area/submap/CaveTrench)
"B" = (
/turf/simulated/shuttle/plating,
/area/submap/CaveTrench)
"C" = (
/obj/structure/closet{
	icon_closed = "cabinet_closed";
	icon_opened = "cabinet_open";
	icon_state = "cabinet_closed"
	},
/obj/item/clothing/suit/storage/hooded/wintercoat/miner,
/obj/item/clothing/suit/storage/hooded/wintercoat/miner,
/turf/simulated/floor/holofloor/wood,
/area/submap/CaveTrench)
"D" = (
/obj/structure/coatrack,
/turf/simulated/floor/holofloor/wood,
/area/submap/CaveTrench)
"E" = (
/obj/structure/closet/secure_closet/miner,
/turf/simulated/floor/holofloor/wood,
/area/submap/CaveTrench)
"F" = (
/obj/item/weapon/storage/box/shotgunammo,
/turf/simulated/floor/holofloor/wood,
/area/submap/CaveTrench)
"G" = (
/obj/structure/table/steel,
/obj/item/robot_parts/l_leg,
/obj/item/robot_parts/head,
/turf/simulated/mineral/floor/ignore_mapgen,
/area/submap/CaveTrench)
"H" = (
/obj/effect/decal/cleanable/blood/gibs/robot,
/turf/simulated/mineral/floor/ignore_mapgen,
/area/submap/CaveTrench)
"I" = (
/obj/machinery/power/port_gen/pacman,
/turf/simulated/shuttle/plating,
/area/submap/CaveTrench)
"J" = (
/obj/machinery/drone_fabricator{
	fabricator_tag = "Unknown"
	},
/turf/simulated/shuttle/plating,
/area/submap/CaveTrench)

(1,1,1) = {"
a
a
a
a
a
a
a
a
a
a
a
a
a
a
a
a
a
a
a
a
"}
(2,1,1) = {"
a
b
b
c
c
c
b
b
e
e
e
b
b
b
b
b
b
b
b
a
"}
(3,1,1) = {"
a
b
c
c
d
i
d
e
e
f
e
e
b
b
c
b
b
b
b
a
"}
(4,1,1) = {"
a
c
c
c
d
d
d
e
f
f
f
e
b
c
c
b
b
b
b
a
"}
(5,1,1) = {"
a
c
c
d
d
d
e
e
f
f
f
e
d
d
c
c
c
b
b
a
"}
(6,1,1) = {"
a
c
d
d
d
d
e
f
f
f
f
e
d
d
d
i
c
b
b
a
"}
(7,1,1) = {"
a
c
d
d
d
d
e
f
f
f
f
e
d
d
d
d
c
b
b
a
"}
(8,1,1) = {"
a
c
d
d
d
d
e
f
f
f
f
e
d
d
d
d
c
c
b
a
"}
(9,1,1) = {"
a
c
d
d
d
d
e
h
f
f
f
e
d
d
d
d
c
c
c
a
"}
(10,1,1) = {"
a
c
c
d
d
d
e
f
f
f
h
e
e
d
d
d
r
c
c
a
"}
(11,1,1) = {"
a
c
c
d
d
d
e
f
f
f
f
f
e
d
d
d
s
c
c
a
"}
(12,1,1) = {"
a
c
d
d
d
j
e
f
f
f
f
f
e
j
d
d
t
x
c
a
"}
(13,1,1) = {"
a
c
d
d
d
k
k
k
k
k
k
k
k
k
d
d
u
y
G
a
"}
(14,1,1) = {"
a
c
d
d
d
k
k
k
k
k
k
k
k
k
d
g
d
z
H
a
"}
(15,1,1) = {"
a
c
d
d
d
j
e
f
f
f
f
f
e
j
d
d
d
d
u
a
"}
(16,1,1) = {"
a
c
d
d
d
e
e
f
f
f
f
f
e
d
d
d
d
A
I
a
"}
(17,1,1) = {"
a
c
d
d
d
e
f
f
f
f
f
f
e
d
d
d
d
B
J
a
"}
(18,1,1) = {"
a
c
d
d
d
e
f
h
f
f
f
e
d
d
d
d
d
B
B
a
"}
(19,1,1) = {"
a
c
d
d
d
e
f
f
f
f
f
e
d
d
d
d
d
d
B
a
"}
(20,1,1) = {"
a
c
d
d
d
e
f
f
f
f
f
e
d
d
d
n
d
d
d
a
"}
(21,1,1) = {"
a
c
d
d
d
e
f
f
f
f
f
e
d
d
m
m
v
m
m
a
"}
(22,1,1) = {"
a
c
d
d
d
e
f
f
f
f
f
e
d
d
m
o
k
C
m
a
"}
(23,1,1) = {"
a
c
d
d
g
e
f
f
f
f
f
e
d
d
m
p
k
D
m
a
"}
(24,1,1) = {"
a
c
d
d
d
e
f
f
l
f
f
e
d
d
m
k
k
E
m
a
"}
(25,1,1) = {"
a
c
c
d
d
e
f
f
f
f
f
e
d
d
m
k
q
k
m
a
"}
(26,1,1) = {"
a
c
c
d
d
e
f
f
f
f
f
e
d
d
m
q
w
q
m
a
"}
(27,1,1) = {"
a
c
c
d
d
e
f
f
f
f
f
e
d
d
m
k
q
F
m
a
"}
(28,1,1) = {"
a
c
c
d
d
e
f
f
f
f
e
e
d
d
m
m
m
m
m
a
"}
(29,1,1) = {"
a
c
c
d
d
e
f
f
f
f
e
d
d
d
d
m
m
m
d
a
"}
(30,1,1) = {"
a
c
c
d
d
e
f
f
f
f
e
d
d
d
d
d
d
d
d
a
"}
(31,1,1) = {"
a
c
c
d
d
e
f
f
f
f
e
d
d
d
d
d
d
d
d
a
"}
(32,1,1) = {"
a
c
c
d
d
e
f
f
f
f
e
d
d
d
d
d
d
d
d
a
"}
(33,1,1) = {"
a
c
d
d
d
e
f
f
f
f
e
d
d
d
d
d
d
d
d
a
"}
(34,1,1) = {"
a
c
d
d
d
e
f
f
f
f
e
d
d
d
d
d
d
d
c
a
"}
(35,1,1) = {"
a
c
d
d
d
e
f
f
f
f
e
e
d
d
d
d
d
d
c
a
"}
(36,1,1) = {"
a
c
d
d
d
e
f
f
f
f
f
e
d
d
d
d
d
d
c
a
"}
(37,1,1) = {"
a
c
d
d
d
e
f
h
f
f
f
e
d
d
d
d
d
c
c
a
"}
(38,1,1) = {"
a
c
d
e
e
e
f
f
f
f
e
e
d
d
d
d
d
c
c
a
"}
(39,1,1) = {"
a
c
e
e
f
f
f
f
f
f
e
d
d
d
d
d
d
c
c
a
"}
(40,1,1) = {"
a
c
e
f
f
f
f
f
f
f
e
d
d
d
d
d
d
c
b
a
"}
(41,1,1) = {"
a
c
e
f
f
f
f
f
f
f
e
d
d
d
i
b
b
b
c
a
"}
(42,1,1) = {"
a
c
e
f
h
f
f
f
f
f
e
d
d
d
d
b
b
b
b
a
"}
(43,1,1) = {"
a
c
e
f
f
f
e
e
f
f
e
d
d
d
b
b
b
b
b
a
"}
(44,1,1) = {"
a
c
e
e
e
c
c
e
e
e
e
d
c
c
c
c
b
b
b
a
"}
(45,1,1) = {"
a
a
a
a
a
a
a
a
a
a
a
a
a
a
a
a
a
a
a
a
"}
