//MAP CONVERTED BY dmm2tgm.py THIS HEADER COMMENT PREVENTS RECONVERSION, DO NOT REMOVE
"a" = (
/turf/template_noop,
/area/template_noop)
"b" = (
/turf/template_noop,
/area/submap/Cavelake)
"c" = (
/turf/simulated/mineral/ignore_mapgen,
/area/submap/Cavelake)
"d" = (
/turf/simulated/mineral/floor/ignore_mapgen,
/area/submap/Cavelake)
"e" = (
/obj/effect/decal/cleanable/cobweb2,
/turf/simulated/mineral/floor/ignore_mapgen,
/area/submap/Cavelake)
"f" = (
/turf/simulated/floor/outdoors/rocks,
/area/submap/Cavelake)
"g" = (
/mob/living/simple_mob/animal/sif/hooligan_crab,
/turf/simulated/mineral/floor/ignore_mapgen,
/area/submap/Cavelake)
"h" = (
/turf/simulated/floor/water,
/area/submap/Cavelake)
"i" = (
/mob/living/simple_mob/animal/passive/fish/perch,
/turf/simulated/floor/water,
/area/submap/Cavelake)
"j" = (
/obj/machinery/crystal,
/turf/simulated/mineral/floor/ignore_mapgen,
/area/submap/Cavelake)
"k" = (
/mob/living/simple_mob/animal/passive/fish/trout,
/turf/simulated/floor/water,
/area/submap/Cavelake)
"l" = (
/obj/effect/decal/cleanable/cobweb,
/turf/simulated/mineral/floor/ignore_mapgen,
/area/submap/Cavelake)
"m" = (
/obj/random/mob/sif,
/turf/simulated/mineral/floor/ignore_mapgen,
/area/submap/Cavelake)
"n" = (
/obj/item/clothing/mask/snorkel,
/turf/simulated/mineral/floor/ignore_mapgen,
/area/submap/Cavelake)
"o" = (
/obj/effect/decal/remains/mouse,
/turf/simulated/mineral/floor/ignore_mapgen,
/area/submap/Cavelake)

(1,1,1) = {"
a
a
a
a
a
a
a
a
a
a
a
a
a
a
a
a
a
a
a
a
a
a
a
a
a
a
a
a
a
a
a
a
a
a
a
a
a
a
a
a
"}
(2,1,1) = {"
a
b
b
b
b
b
c
c
c
c
c
c
c
c
c
c
c
c
c
c
c
c
c
c
c
c
c
c
c
c
c
c
c
b
b
b
b
b
b
a
"}
(3,1,1) = {"
a
b
b
b
c
c
c
c
c
c
c
c
d
d
d
d
d
c
c
c
c
d
d
d
f
f
d
d
d
d
d
d
c
c
b
b
b
b
b
a
"}
(4,1,1) = {"
a
b
b
c
c
c
c
c
c
c
d
d
d
d
d
d
d
d
d
d
d
d
d
f
h
f
f
d
d
d
d
d
d
c
c
b
b
b
b
a
"}
(5,1,1) = {"
a
b
c
c
c
c
d
d
d
d
d
d
d
d
d
d
d
d
d
d
d
d
d
f
h
h
f
f
d
g
d
d
d
d
c
b
b
b
b
a
"}
(6,1,1) = {"
a
c
c
c
d
d
d
d
d
d
d
d
d
d
c
c
j
d
d
d
d
d
d
f
h
h
h
f
f
d
o
d
d
d
c
c
b
b
b
a
"}
(7,1,1) = {"
a
c
c
d
d
d
d
d
d
d
d
d
d
c
c
c
c
d
d
d
d
d
f
f
h
h
h
h
f
d
d
d
d
d
d
c
b
b
b
a
"}
(8,1,1) = {"
a
b
d
d
d
d
d
d
d
d
d
d
d
c
c
c
c
c
d
d
d
d
f
h
h
h
h
h
f
d
d
d
d
d
d
c
b
b
b
a
"}
(9,1,1) = {"
a
b
d
d
d
d
d
d
d
d
d
d
d
c
c
c
c
c
d
d
d
d
f
h
k
h
h
h
h
f
d
d
d
d
d
c
c
b
b
a
"}
(10,1,1) = {"
a
b
d
d
d
d
d
d
d
d
d
d
d
j
c
c
c
l
d
d
d
d
f
h
h
h
h
h
h
f
d
d
d
d
d
c
c
b
b
a
"}
(11,1,1) = {"
a
b
d
d
d
d
d
d
d
d
d
d
d
d
d
c
c
m
d
d
d
n
f
h
h
h
h
h
h
f
d
d
d
d
c
c
c
b
b
a
"}
(12,1,1) = {"
a
b
d
d
d
d
d
d
d
d
d
d
d
d
d
d
d
d
d
d
d
d
f
h
h
h
h
k
h
f
f
d
d
d
c
c
c
b
b
a
"}
(13,1,1) = {"
a
b
c
d
d
d
d
d
d
d
d
d
d
d
d
d
d
d
d
d
d
d
f
h
h
h
h
h
h
h
f
d
d
d
c
c
c
b
b
a
"}
(14,1,1) = {"
a
c
c
d
d
d
d
d
d
d
d
d
d
d
d
d
d
d
d
d
d
d
f
h
h
h
h
h
h
h
f
d
d
d
c
c
c
b
b
a
"}
(15,1,1) = {"
a
c
c
d
d
d
d
d
d
d
d
d
d
d
d
d
d
d
d
d
d
d
f
h
h
i
h
h
h
h
f
d
d
d
d
d
c
b
b
a
"}
(16,1,1) = {"
a
c
c
d
d
d
d
d
d
d
d
d
d
d
d
d
d
d
d
d
d
d
f
h
h
h
h
h
h
h
f
d
d
d
d
d
c
b
b
a
"}
(17,1,1) = {"
a
c
c
d
d
d
d
d
d
d
d
d
d
d
d
d
d
d
d
d
d
d
f
f
h
h
h
h
h
h
f
d
d
d
d
d
c
b
b
a
"}
(18,1,1) = {"
a
c
c
d
d
d
d
d
g
d
d
d
d
d
d
d
d
d
d
d
d
d
f
f
f
f
f
f
h
h
f
d
d
d
d
d
c
b
b
a
"}
(19,1,1) = {"
a
c
c
d
d
d
d
d
d
d
f
f
f
f
d
d
d
d
d
d
d
d
d
d
d
d
d
f
f
h
f
d
d
d
d
c
c
b
b
a
"}
(20,1,1) = {"
a
c
c
d
d
d
d
d
f
f
h
h
f
f
f
f
f
d
d
d
d
d
d
d
d
d
d
d
f
f
f
d
d
d
d
c
b
b
b
a
"}
(21,1,1) = {"
a
b
b
b
d
d
d
d
f
h
h
h
h
h
f
f
f
f
f
f
f
d
d
d
d
d
d
d
d
d
d
d
d
d
d
c
b
b
b
a
"}
(22,1,1) = {"
a
b
b
b
d
d
d
f
f
h
h
h
h
h
h
h
h
h
h
h
f
f
f
f
f
f
d
d
d
d
d
d
d
d
d
c
b
b
b
a
"}
(23,1,1) = {"
a
b
b
b
d
d
d
f
h
h
h
h
h
h
h
h
h
h
h
h
h
h
f
h
h
h
f
f
d
d
d
d
d
d
d
c
b
b
b
a
"}
(24,1,1) = {"
a
b
b
b
d
d
d
f
h
h
h
h
h
h
h
h
h
h
h
h
h
h
h
h
h
h
h
h
f
d
d
d
d
d
d
c
b
b
b
a
"}
(25,1,1) = {"
a
b
b
b
d
d
d
f
h
h
h
h
h
h
h
h
h
h
h
h
h
h
h
h
h
h
h
h
f
d
d
d
d
d
d
c
c
b
b
a
"}
(26,1,1) = {"
a
b
c
b
d
d
d
f
h
h
h
h
h
h
h
h
h
h
h
h
h
h
h
h
h
h
h
h
f
f
d
d
d
d
d
c
c
b
b
a
"}
(27,1,1) = {"
a
b
c
b
d
d
d
f
h
h
h
h
i
h
h
h
h
h
h
h
h
h
h
h
h
h
h
h
f
f
d
d
d
d
c
c
b
b
b
a
"}
(28,1,1) = {"
a
b
c
c
d
d
d
f
h
h
h
h
h
h
h
h
h
h
h
h
h
i
h
h
h
h
h
h
f
d
d
d
d
d
c
c
b
b
b
a
"}
(29,1,1) = {"
a
b
c
c
d
d
d
f
h
h
h
h
h
h
h
h
h
h
h
h
h
h
h
h
h
h
h
h
f
d
d
d
d
d
c
c
b
b
b
a
"}
(30,1,1) = {"
a
b
c
c
d
d
d
f
h
h
h
h
h
h
h
h
h
h
h
h
h
h
h
h
h
h
h
h
f
d
d
d
d
d
b
b
b
b
b
a
"}
(31,1,1) = {"
a
b
c
c
d
d
d
f
f
h
h
h
h
h
h
h
h
h
h
h
h
h
h
h
h
h
h
f
f
d
d
d
d
d
b
b
b
b
b
a
"}
(32,1,1) = {"
a
b
c
c
d
d
d
d
f
f
f
h
h
h
h
h
h
h
h
h
h
h
h
h
h
h
h
f
d
d
d
d
d
d
b
b
b
b
b
a
"}
(33,1,1) = {"
a
b
c
c
d
d
d
d
d
d
f
f
h
h
h
h
h
h
h
h
h
h
h
h
h
f
f
f
d
d
d
d
d
d
d
b
b
b
b
a
"}
(34,1,1) = {"
a
b
c
c
d
d
d
d
d
d
d
f
f
h
h
h
h
h
h
h
h
h
h
h
h
f
d
d
d
d
d
d
d
d
d
b
b
b
b
a
"}
(35,1,1) = {"
a
b
c
c
e
d
d
d
d
d
d
f
f
h
h
h
h
h
h
h
h
h
h
h
f
f
d
d
d
d
d
d
d
d
d
c
b
b
b
a
"}
(36,1,1) = {"
a
b
c
c
c
c
d
d
d
d
d
f
f
h
h
h
h
h
h
h
h
h
h
h
f
d
d
d
c
c
c
c
c
c
c
b
b
b
b
a
"}
(37,1,1) = {"
a
b
b
c
c
c
c
c
c
c
c
c
f
h
h
h
k
h
h
h
h
h
h
f
c
c
c
c
c
c
c
c
c
b
b
b
b
b
b
a
"}
(38,1,1) = {"
a
b
b
b
b
b
b
b
b
b
c
c
f
f
f
f
f
f
f
f
f
f
f
f
c
c
b
c
c
c
c
b
b
b
b
b
b
b
b
a
"}
(39,1,1) = {"
a
b
b
b
b
b
b
b
b
b
b
c
c
c
c
c
c
c
c
c
c
c
c
c
c
b
b
b
b
b
b
b
b
b
b
b
b
b
b
a
"}
(40,1,1) = {"
a
a
a
a
a
a
a
a
a
a
a
a
a
a
a
a
a
a
a
a
a
a
a
a
a
a
a
a
a
a
a
a
a
a
a
a
a
a
a
a
"}
