"a" = (/turf/template_noop,/area/template_noop)
"b" = (/turf/template_noop,/area/submap/Cavelake)
"c" = (/turf/simulated/mineral/ignore_mapgen,/area/submap/Cavelake)
"d" = (/turf/simulated/mineral/floor/ignore_mapgen,/area/submap/Cavelake)
"e" = (/obj/effect/decal/cleanable/cobweb2,/turf/simulated/mineral/floor/ignore_mapgen,/area/submap/Cavelake)
"f" = (/turf/simulated/floor/outdoors/rocks,/area/submap/Cavelake)
"g" = (/mob/living/simple_animal/giant_crab,/turf/simulated/mineral/floor/ignore_mapgen,/area/submap/Cavelake)
"h" = (/turf/simulated/floor/water,/area/submap/Cavelake)
"i" = (/mob/living/simple_animal/fish/perch,/turf/simulated/floor/water,/area/submap/Cavelake)
"j" = (/obj/machinery/crystal,/turf/simulated/mineral/floor/ignore_mapgen,/area/submap/Cavelake)
"k" = (/mob/living/simple_animal/fish/trout,/turf/simulated/floor/water,/area/submap/Cavelake)
"l" = (/obj/effect/decal/cleanable/cobweb,/turf/simulated/mineral/floor/ignore_mapgen,/area/submap/Cavelake)
"m" = (/obj/effect/decal/remains/mouse,/turf/simulated/mineral/floor/ignore_mapgen,/area/submap/Cavelake)

(1,1,1) = {"
aaaaaaaaaaaaaaaaaaaaaaaaaaaaaaaaaaaaaaaa
abbbbccbbbbbbcccccccbbbbbbbbbbbbbbbbbbba
abbbcccdddddccccccccbbbbbcccccccccccbbba
abbcccddddddddddddddbbbbbbbccccccccccbba
abcccdddddddddddddddddddddddddddddeccbba
abcccddddddddddddddddddddddddddddddccbba
acccddddddddddddddddddddddddddddddddcbba
acccdddddddddddddddddffffffffffdddddcbba
acccdddddddddddddgdfffhhhhhhhhffddddcbba
acccdddddddddddddddfhhhhhhhhhhhfddddcbba
accdddddddddddddddfhhhhhhhhhhhhffdddccba
accdddddddddddddddfhhhhhhhhhhhhhffffccca
acddddddddddddddddffhhhhhhihhhhhhfffffca
acddddcccjddddddddffhhhhhhhhhhhhhhhhhfca
acdddcccccdddddddddffhhhhhhhhhhhhhhhhfca
acdddccccccddddddddffhhhhhhhhhhhhhhhhfca
acdddjcccccddddddddffhhhhhhhhhhhhhhhkfca
accddddcclddddddddddfhhhhhhhhhhhhhhhhfca
accdddddddddddddddddfhhhhhhhhhhhhhhhhfca
accdddddddddddddddddfhhhhhhhhhhhhhhhhfca
accdddddddddddddddddffhhhhhhhhhhhhhhhfca
acdddddddddddddddddddfhhhhhihhhhhhhhhfca
acddddffffffffffffdddffhhhhhhhhhhhhhhfca
acdffffhhhhhhhhhffdddfhhhhhhhhhhhhhhffca
acfhhhhhkhhhhhhhhfdddfhhhhhhhhhhhhffccca
acffhhhhhhhhhhihhfdddfhhhhhhhhhhfffdccba
acdffhhhhhhhhhhhhfddddfhhhhhhhhhfdddcbba
acddffhhhhhkhhhhhffdddfhhhhhhhfffdddccba
acdddfffhhhhhhhhhhffdddffffffffddddcccba
acddgdddffffhhhhhhhfdddddffddddddddcccba
acdddmdddddfffffffffdddddddddddddddcccba
acdddddddddddddddddddddddddddddddddccbba
accddddddddddddddddddddddddddddddddccbba
abccdddddddddddddddddddddddddddddddcbbba
abbcccddddccccddddddddddddcccbbbdddcbbba
abbbbcccccccccddddcccccccccccbbbbbcbbbba
abbbbbbbcccccccccccbbbbbccbbbbbbbbbbbbba
abbbbbbbbbbbbbbbbbbbbbbbbbbbbbbbbbbbbbba
abbbbbbbbbbbbbbbbbbbbbbbbbbbbbbbbbbbbbba
aaaaaaaaaaaaaaaaaaaaaaaaaaaaaaaaaaaaaaaa
"}
