"a" = (/turf/template_noop,/area/template_noop)
"b" = (/turf/simulated/mineral/floor/ignore_mapgen,/area/template_noop)
"c" = (/obj/item/weapon/ore,/turf/simulated/mineral/floor/ignore_mapgen,/area/template_noop)
"d" = (/obj/random/outcrop,/turf/simulated/mineral/floor/ignore_mapgen,/area/template_noop)
"e" = (/obj/structure/cliff/automatic/corner,/turf/simulated/mineral/floor/ignore_mapgen,/area/template_noop)
"f" = (/obj/structure/cliff/automatic{icon_state = "cliffbuilder"; dir = 5},/turf/simulated/mineral/floor/ignore_mapgen,/area/template_noop)
"g" = (/obj/structure/cliff/automatic{icon_state = "cliffbuilder"; dir = 9},/turf/simulated/mineral/floor/ignore_mapgen,/area/template_noop)
"h" = (/obj/structure/cliff/automatic,/turf/simulated/mineral/floor/ignore_mapgen,/area/template_noop)
"i" = (/obj/structure/cliff/automatic/corner{icon_state = "cliffbuilder-corner"; dir = 9},/turf/simulated/mineral/floor/ignore_mapgen,/area/template_noop)
"j" = (/obj/random/humanoidremains{spawn_nothing_percentage = 70},/turf/simulated/mineral/floor/ignore_mapgen,/area/template_noop)

(1,1,1) = {"
aaaaaaaaaaaaaaaaaaaaaaaaaaaaaa
aaaaaaaaaaaaaaaaaaaaaaaaaaaaaa
abbbbabbbbbbbaabbbbbbbbaaabbaa
aabcbbbdbcbbbbbbdbbcdbbbbcbbaa
aabefcbbbbbdbbcbbbbbbcghhhibaa
aabcehhfbbbbbbbbbcghhhibbbcbaa
aaajbbbehfbcbghhhhibbbcjbbbaaa
aaaaabbcbehhhibbbbbbcbbbbaaaaa
aaaaaaacbbbjbbcbbcbbbaaaaaaaaa
aaaaaaaaaaaaaaaaaaaaaaaaaaaaaa
"}
