//MAP CONVERTED BY dmm2tgm.py THIS HEADER COMMENT PREVENTS RECONVERSION, DO NOT REMOVE
"aa" = (
/turf/template_noop,
/area/submap/crashedcontainmentshuttle)
"ab" = (
/turf/simulated/shuttle/wall/dark/hard_corner,
/area/submap/crashedcontainmentshuttle)
"ac" = (
/turf/simulated/shuttle/wall/dark,
/area/submap/crashedcontainmentshuttle)
"ad" = (
/turf/simulated/shuttle/floor/black,
/area/submap/crashedcontainmentshuttle)
"ae" = (
/turf/simulated/shuttle/floor/yellow,
/area/submap/crashedcontainmentshuttle)
"af" = (
/turf/simulated/shuttle/floor/red,
/area/submap/crashedcontainmentshuttle)
"ag" = (
/turf/simulated/shuttle/floor/white,
/area/submap/crashedcontainmentshuttle)
"ah" = (
/obj/structure/grille,
/obj/item/weapon/material/shard{
	icon_state = "medium"
	},
/turf/simulated/floor/plating,
/area/submap/crashedcontainmentshuttle)
"ai" = (
/obj/random/landmine,
/turf/template_noop,
/area/submap/crashedcontainmentshuttle)
"aj" = (
/obj/item/weapon/material/shard{
	icon_state = "medium"
	},
/turf/template_noop,
/area/submap/crashedcontainmentshuttle)
"ak" = (
/obj/structure/door_assembly/door_assembly_ext{
	anchored = 1
	},
/turf/simulated/floor/plating,
/area/submap/crashedcontainmentshuttle)
"al" = (
/obj/structure/lattice,
/turf/template_noop,
/area/submap/crashedcontainmentshuttle)
"am" = (
/obj/item/weapon/material/shard,
/turf/template_noop,
/area/submap/crashedcontainmentshuttle)
"an" = (
/obj/structure/girder,
/turf/simulated/floor/plating,
/area/submap/crashedcontainmentshuttle)
"ao" = (
/turf/simulated/floor/plating,
/area/submap/crashedcontainmentshuttle)
"ap" = (
/obj/item/stack/rods,
/turf/template_noop,
/area/submap/crashedcontainmentshuttle)
"aq" = (
/obj/structure/door_assembly/door_assembly_ext,
/turf/template_noop,
/area/submap/crashedcontainmentshuttle)
"ar" = (
/obj/structure/grille,
/obj/item/weapon/material/shard,
/turf/simulated/floor/plating,
/area/submap/crashedcontainmentshuttle)
"as" = (
/obj/item/weapon/material/shard,
/turf/simulated/floor/plating,
/area/submap/crashedcontainmentshuttle)
"at" = (
/obj/structure/loot_pile/maint/technical,
/turf/template_noop,
/area/submap/crashedcontainmentshuttle)
"au" = (
/obj/item/stack/rods,
/turf/simulated/shuttle/floor/black,
/area/submap/crashedcontainmentshuttle)
"av" = (
/obj/structure/closet/walllocker/emerglocker/east,
/turf/simulated/shuttle/floor/black,
/area/submap/crashedcontainmentshuttle)
"aw" = (
/obj/structure/frame,
/turf/simulated/shuttle/floor/black,
/area/submap/crashedcontainmentshuttle)
"ax" = (
/obj/item/frame/mirror,
/obj/item/weapon/material/shard{
	icon_state = "medium"
	},
/turf/simulated/shuttle/wall/dark,
/area/submap/crashedcontainmentshuttle)
"ay" = (
/obj/effect/decal/mecha_wreckage/gygax{
	anchored = 1
	},
/turf/simulated/shuttle/floor/black,
/area/submap/crashedcontainmentshuttle)
"az" = (
/obj/effect/gibspawner/generic,
/turf/simulated/shuttle/floor/black,
/area/submap/crashedcontainmentshuttle)
"aA" = (
/obj/structure/closet/medical_wall,
/turf/simulated/shuttle/wall/dark,
/area/submap/crashedcontainmentshuttle)
"aB" = (
/obj/structure/largecrate/animal/crashedshuttle,
/turf/simulated/shuttle/floor/red,
/area/submap/crashedcontainmentshuttle)
"aC" = (
/obj/structure/grille{
	density = 0;
	icon_state = "brokengrille"
	},
/obj/structure/lattice,
/turf/template_noop,
/area/submap/crashedcontainmentshuttle)
"aD" = (
/obj/structure/shuttle/engine/propulsion{
	dir = 8
	},
/turf/template_noop,
/area/submap/crashedcontainmentshuttle)
"aE" = (
/obj/structure/extinguisher_cabinet,
/turf/simulated/shuttle/wall/dark,
/area/submap/crashedcontainmentshuttle)
"aF" = (
/obj/machinery/computer,
/turf/simulated/shuttle/floor/yellow,
/area/submap/crashedcontainmentshuttle)
"aG" = (
/obj/item/weapon/circuitboard/broken,
/turf/template_noop,
/area/submap/crashedcontainmentshuttle)
"aH" = (
/obj/structure/frame/computer,
/turf/simulated/shuttle/floor/yellow,
/area/submap/crashedcontainmentshuttle)
"aI" = (
/obj/structure/grille{
	density = 0;
	icon_state = "brokengrille"
	},
/obj/item/stack/rods,
/turf/simulated/floor/plating,
/area/submap/crashedcontainmentshuttle)
"aJ" = (
/obj/item/stack/rods,
/turf/simulated/floor/plating,
/area/submap/crashedcontainmentshuttle)
"aK" = (
/obj/structure/grille{
	density = 0;
	icon_state = "brokengrille"
	},
/obj/item/weapon/material/shard{
	icon_state = "medium"
	},
/obj/item/stack/rods,
/turf/simulated/floor/plating,
/area/submap/crashedcontainmentshuttle)
"aL" = (
/obj/item/weapon/circuitboard/broken,
/turf/simulated/shuttle/floor/black,
/area/submap/crashedcontainmentshuttle)
"aM" = (
/obj/structure/frame,
/obj/item/weapon/circuitboard/broken,
/turf/simulated/shuttle/floor/black,
/area/submap/crashedcontainmentshuttle)
"aN" = (
/obj/structure/table/steel_reinforced,
/turf/simulated/shuttle/floor/black,
/area/submap/crashedcontainmentshuttle)
"aO" = (
/obj/structure/closet/walllocker/emerglocker/north,
/obj/structure/frame,
/obj/item/weapon/circuitboard/broken,
/turf/simulated/shuttle/floor/white,
/area/submap/crashedcontainmentshuttle)
"aP" = (
/turf/simulated/floor/outdoors/rocks,
/area/submap/crashedcontainmentshuttle)
"aQ" = (
/obj/item/clothing/suit/space/cult,
/turf/template_noop,
/area/submap/crashedcontainmentshuttle)
"aR" = (
/obj/structure/shuttle/engine/heater{
	dir = 8
	},
/obj/structure/window/reinforced{
	dir = 4;
	health = 1e+006
	},
/turf/template_noop,
/area/submap/crashedcontainmentshuttle)
"aS" = (
/obj/structure/door_assembly/door_assembly_highsecurity{
	anchored = 1
	},
/turf/simulated/shuttle/floor/black,
/area/submap/crashedcontainmentshuttle)
"aT" = (
/obj/structure/loot_pile/maint/technical,
/turf/simulated/shuttle/floor/yellow,
/area/submap/crashedcontainmentshuttle)
"aU" = (
/obj/structure/loot_pile/maint/technical,
/turf/simulated/shuttle/floor/white,
/area/submap/crashedcontainmentshuttle)
"aV" = (
/obj/effect/decal/remains/robot,
/turf/template_noop,
/area/submap/crashedcontainmentshuttle)
"aW" = (
/obj/structure/loot_pile/maint/technical,
/turf/simulated/shuttle/floor/black,
/area/submap/crashedcontainmentshuttle)
"aX" = (
/obj/structure/door_assembly/door_assembly_ext{
	anchored = 1
	},
/turf/template_noop,
/area/submap/crashedcontainmentshuttle)
"aY" = (
/obj/effect/decal/remains/human,
/obj/effect/gibspawner/human,
/turf/template_noop,
/area/submap/crashedcontainmentshuttle)
"aZ" = (
/obj/item/clothing/head/helmet/space/cult,
/turf/template_noop,
/area/submap/crashedcontainmentshuttle)
"bb" = (
/obj/effect/decal/cleanable/blood/drip,
/turf/simulated/shuttle/floor/black,
/area/submap/crashedcontainmentshuttle)
"bc" = (
/obj/structure/door_assembly,
/turf/simulated/shuttle/floor/white,
/area/submap/crashedcontainmentshuttle)
"bd" = (
/obj/item/weapon/material/knife/ritual,
/turf/template_noop,
/area/submap/crashedcontainmentshuttle)
"be" = (
/obj/structure/bed/chair/office/dark{
	dir = 8
	},
/obj/effect/decal/remains/human,
/turf/template_noop,
/area/submap/crashedcontainmentshuttle)
"bf" = (
/obj/structure/grille,
/obj/item/weapon/material/shard{
	icon_state = "medium"
	},
/turf/template_noop,
/area/submap/crashedcontainmentshuttle)
"bg" = (
/obj/effect/gibspawner/generic,
/turf/template_noop,
/area/submap/crashedcontainmentshuttle)
"bh" = (
/obj/effect/decal/remains/human,
/turf/simulated/shuttle/floor/yellow,
/area/submap/crashedcontainmentshuttle)
"bi" = (
/obj/item/weapon/circuitboard/broken,
/obj/effect/decal/remains/human,
/obj/item/weapon/gun/energy/laser,
/turf/simulated/shuttle/floor/black,
/area/submap/crashedcontainmentshuttle)
"bj" = (
/obj/item/device/gps/internal/poi,
/turf/simulated/shuttle/floor/red,
/area/submap/crashedcontainmentshuttle)
"bk" = (
/obj/effect/decal/cleanable/vomit,
/turf/simulated/shuttle/floor/black,
/area/submap/crashedcontainmentshuttle)
"bl" = (
/obj/effect/decal/remains/robot,
/turf/simulated/shuttle/floor/red,
/area/submap/crashedcontainmentshuttle)
"bm" = (
/obj/effect/decal/cleanable/liquid_fuel,
/turf/template_noop,
/area/submap/crashedcontainmentshuttle)
"bn" = (
/obj/effect/decal/cleanable/vomit,
/turf/simulated/shuttle/floor/white,
/area/submap/crashedcontainmentshuttle)
"bo" = (
/obj/effect/decal/cleanable/blood/drip,
/turf/template_noop,
/area/submap/crashedcontainmentshuttle)
"bp" = (
/obj/structure/bed/chair/office/dark{
	dir = 4
	},
/turf/simulated/shuttle/floor/yellow,
/area/submap/crashedcontainmentshuttle)
"bq" = (
/obj/item/weapon/circuitboard/broken,
/obj/structure/bed/chair/office/dark{
	dir = 4
	},
/turf/simulated/shuttle/floor/yellow,
/area/submap/crashedcontainmentshuttle)
"br" = (
/obj/effect/decal/cleanable/blood/drip,
/obj/effect/decal/cleanable/blood/drip,
/obj/effect/decal/cleanable/blood/drip,
/turf/simulated/shuttle/floor/yellow,
/area/submap/crashedcontainmentshuttle)
"bs" = (
/obj/structure/table/steel_reinforced,
/turf/simulated/shuttle/floor/yellow,
/area/submap/crashedcontainmentshuttle)
"bt" = (
/obj/structure/shuttle/engine/propulsion{
	icon_state = "burst_r"
	},
/turf/template_noop,
/area/submap/crashedcontainmentshuttle)
"bv" = (
/obj/effect/decal/cleanable/blood/oil,
/turf/simulated/shuttle/floor/red,
/area/submap/crashedcontainmentshuttle)
"bw" = (
/obj/item/weapon/material/knife/ritual,
/obj/effect/decal/cleanable/blood,
/turf/simulated/shuttle/floor/red,
/area/submap/crashedcontainmentshuttle)
"bx" = (
/turf/simulated/shuttle/wall/dark/no_join,
/area/submap/crashedcontainmentshuttle)
"by" = (
/obj/random/landmine,
/obj/random/landmine,
/turf/simulated/shuttle/floor/black,
/area/submap/crashedcontainmentshuttle)
"bz" = (
/obj/effect/decal/remains/human,
/obj/item/clothing/head/helmet/space/cult,
/obj/effect/decal/cleanable/blood,
/turf/simulated/shuttle/floor/red,
/area/submap/crashedcontainmentshuttle)
"bA" = (
/obj/effect/decal/cleanable/blood/drip,
/obj/effect/decal/cleanable/blood/drip,
/turf/simulated/shuttle/floor/white,
/area/submap/crashedcontainmentshuttle)
"bB" = (
/obj/structure/sink{
	icon_state = "sink";
	dir = 8;
	pixel_x = -12;
	pixel_y = 2
	},
/obj/effect/decal/cleanable/blood/drip,
/obj/effect/decal/cleanable/blood/drip,
/turf/simulated/shuttle/floor/white,
/area/submap/crashedcontainmentshuttle)
"bC" = (
/obj/effect/decal/cleanable/liquid_fuel,
/turf/simulated/shuttle/floor/black,
/area/submap/crashedcontainmentshuttle)
"bD" = (
/obj/effect/decal/cleanable/liquid_fuel,
/obj/random/landmine,
/turf/template_noop,
/area/submap/crashedcontainmentshuttle)
"bE" = (
/obj/effect/decal/cleanable/blood/drip,
/obj/effect/decal/cleanable/blood/drip,
/turf/simulated/shuttle/floor/black,
/area/submap/crashedcontainmentshuttle)
"bF" = (
/obj/effect/decal/cleanable/blood/drip,
/turf/simulated/shuttle/floor/white,
/area/submap/crashedcontainmentshuttle)
"bG" = (
/obj/structure/reagent_dispensers/fueltank,
/turf/template_noop,
/area/submap/crashedcontainmentshuttle)
"bH" = (
/obj/structure/closet/crate{
	name = "landmines crate";
	opened = 1
	},
/turf/simulated/shuttle/floor/black,
/area/submap/crashedcontainmentshuttle)
"bI" = (
/obj/random/landmine,
/turf/simulated/shuttle/floor/black,
/area/submap/crashedcontainmentshuttle)
"bJ" = (
/obj/random/landmine,
/turf/simulated/floor/plating,
/area/submap/crashedcontainmentshuttle)
"bK" = (
/obj/random/landmine,
/turf/simulated/shuttle/floor/yellow,
/area/submap/crashedcontainmentshuttle)
"bL" = (
/obj/effect/decal/cleanable/blood,
/obj/random/landmine,
/turf/simulated/shuttle/floor/red,
/area/submap/crashedcontainmentshuttle)
"bM" = (
/obj/effect/decal/cleanable/liquid_fuel,
/obj/effect/decal/remains/human,
/obj/item/weapon/flame/lighter/random,
/turf/template_noop,
/area/submap/crashedcontainmentshuttle)
"bN" = (
/obj/structure/toilet{
	dir = 8
	},
/obj/effect/gibspawner/generic,
/obj/effect/decal/remains/human,
/obj/item/weapon/card/id/syndicate{
	age = "\\42";
	blood_type = "\\O+";
	desc = "A strange ID card.";
	dna_hash = "\[REDACTED]";
	fingerprint_hash = "\\------";
	name = "Aaron Presley's ID Card(Delivery Service) ";
	registered_name = "Aaron Presley";
	sex = "\\Male"
	},
/turf/simulated/shuttle/floor/white,
/area/submap/crashedcontainmentshuttle)

(1,1,1) = {"
aa
aa
aa
aa
aa
aa
aa
aa
aa
ac
aP
aa
aP
aP
aP
ad
aP
aP
aa
ac
aa
aa
aa
aa
aa
"}
(2,1,1) = {"
aa
aa
aa
aa
aa
aa
aD
aQ
aa
aa
ad
aP
bx
aP
aP
aa
ac
aP
aa
aa
aG
bt
aa
aa
aa
"}
(3,1,1) = {"
aa
aa
aa
ab
ac
aa
aG
aa
aY
aa
aD
ad
aD
aa
ad
aa
aa
aa
aG
aa
aa
aa
aa
ad
aa
"}
(4,1,1) = {"
aa
aa
aa
ac
aa
aa
aa
aR
aZ
aa
aR
aa
aR
aa
aa
aa
aa
aP
aR
aa
aa
bg
aa
ad
ad
"}
(5,1,1) = {"
aa
aa
aa
aa
aa
au
ad
ac
bd
al
ac
ac
ac
aa
aJ
aa
am
ac
aa
aP
aa
aa
aa
aa
aa
"}
(6,1,1) = {"
aa
aa
aa
aa
ad
aq
ao
aa
al
ad
ad
aM
aW
aa
al
ao
al
ad
ac
aP
ac
at
aa
aa
aa
"}
(7,1,1) = {"
aa
aa
aa
aa
aa
ak
aa
ad
al
au
ad
ad
ad
bE
bI
ad
ad
ad
aX
aa
aa
aa
ad
aa
aa
"}
(8,1,1) = {"
aa
aa
ah
aa
aa
ar
ad
ad
al
ad
ad
bk
bb
az
ad
ad
aW
ad
al
ao
aa
aa
aL
ac
aP
"}
(9,1,1) = {"
aa
aa
aa
aa
aa
ac
ad
aV
ad
ad
bi
ad
ad
ad
ad
aP
aP
ad
ao
aa
ad
aa
aa
aP
aP
"}
(10,1,1) = {"
aa
aa
aa
aa
aa
ac
ai
al
ad
ad
ad
bb
bb
ad
aP
aP
aP
ad
aK
aa
aa
aa
aa
bC
aa
"}
(11,1,1) = {"
aa
aa
aa
aa
ai
at
aG
bI
ad
ac
ac
ac
an
an
aP
aP
bb
ad
an
al
aa
bD
bm
bm
aa
"}
(12,1,1) = {"
aa
aa
ai
aa
al
aC
bH
by
bI
ac
bj
bv
bl
ac
ad
ad
ad
aw
an
al
bm
bm
bG
bm
aa
"}
(13,1,1) = {"
aa
aa
an
al
aP
ac
by
bI
ad
aS
af
aB
bL
ac
ad
ac
aA
ax
an
aP
aa
bo
bM
bm
bm
"}
(14,1,1) = {"
aa
aa
aa
aa
aP
ac
ay
az
ad
ac
af
bw
bz
ac
ad
an
bA
bB
ac
aP
bo
aa
bm
aa
aa
"}
(15,1,1) = {"
aa
aa
aa
aP
aP
an
ad
bb
au
an
ac
ac
an
aE
ad
ac
aU
ag
ac
aP
aa
bm
bm
ai
aa
"}
(16,1,1) = {"
aa
aa
aa
aP
ad
an
ad
ad
ad
ad
ad
aL
ad
ad
ad
bc
bF
bn
ar
al
aa
bg
aa
aa
aa
"}
(17,1,1) = {"
aa
aa
aa
aa
aP
ac
aW
aN
aN
av
ad
ad
bb
ad
ad
ac
aO
bN
an
aP
aa
aa
aa
aa
aa
"}
(18,1,1) = {"
aa
aa
aa
am
aa
ab
ac
ac
aA
ac
ad
aS
as
ah
ac
ac
ac
an
ab
aP
aa
aa
aa
aa
aa
"}
(19,1,1) = {"
aa
aa
aa
aa
aa
aa
ab
an
ae
bh
bK
bK
ae
ae
ae
aT
ac
ab
aP
aa
aa
aa
aa
aa
aa
"}
(20,1,1) = {"
aa
aa
aa
aa
aa
aa
aa
bJ
aT
ae
bp
bq
br
bp
ae
bs
ac
aP
aP
aa
aa
aa
aa
aa
aa
"}
(21,1,1) = {"
aa
aa
aj
aa
ap
aa
aa
aa
an
ae
aH
aH
aF
aH
ae
ac
ab
aP
aa
aa
aa
aa
aa
aa
aa
"}
(22,1,1) = {"
aa
aa
aa
aa
aa
aa
aa
aa
aa
ah
ar
ao
aI
ao
ah
ac
aP
aa
bg
aa
aa
aa
aa
aa
aa
"}
(23,1,1) = {"
aa
aa
aa
aa
aa
aa
aa
aa
aa
aa
aa
al
aa
aa
aa
aa
aa
aa
aa
aa
aa
aa
aa
aa
aa
"}
(24,1,1) = {"
aa
aa
aa
aa
aa
aa
aa
aa
ap
aa
aa
aa
be
bf
aa
aa
aa
aa
aa
aa
aa
aa
aa
aa
aa
"}
(25,1,1) = {"
aa
aa
aa
aa
aa
aa
aa
aa
aa
aa
aa
aa
aa
aa
aa
aa
aa
aa
aa
aa
aa
aa
aa
aa
aa
"}
