"aa" = (/turf/simulated/mineral/floor/ignore_mapgen,/area/submap/CrashedMedShuttle)
"ab" = (/turf/simulated/floor/outdoors/rocks,/area/submap/CrashedMedShuttle)
"ac" = (/obj/structure/lattice,/turf/simulated/floor/outdoors/rocks,/area/submap/CrashedMedShuttle)
"ad" = (/obj/effect/spider/stickyweb,/turf/simulated/shuttle/plating,/area/submap/CrashedMedShuttle)
"ae" = (/obj/structure/sign/greencross{desc = "White cross in a green field, you can get medical aid here."; name = "First-Aid"},/turf/simulated/shuttle/wall/no_join,/area/submap/CrashedMedShuttle)
"af" = (/obj/structure/grille,/obj/structure/shuttle/window,/turf/simulated/shuttle/plating,/area/submap/CrashedMedShuttle)
"ag" = (/turf/simulated/shuttle/wall,/area/submap/CrashedMedShuttle)
"ah" = (/obj/item/weapon/material/shard{icon_state = "medium"},/turf/simulated/mineral/floor/ignore_mapgen,/area/submap/CrashedMedShuttle)
"ai" = (/obj/item/weapon/material/shard{icon_state = "medium"},/obj/effect/decal/cleanable/blood/oil,/obj/structure/lattice,/turf/simulated/floor/outdoors/rocks,/area/submap/CrashedMedShuttle)
"aj" = (/obj/machinery/light/small{dir = 4; pixel_y = 0},/obj/structure/sign/warning/airlock{pixel_x = 32},/obj/effect/spider/stickyweb,/turf/simulated/shuttle/plating,/area/submap/CrashedMedShuttle)
"ak" = (/obj/structure/dispenser/oxygen,/turf/simulated/shuttle/floor/white,/area/submap/CrashedMedShuttle)
"al" = (/obj/item/weapon/storage/toolbox/mechanical,/obj/machinery/light{dir = 1},/obj/structure/table/standard,/turf/simulated/shuttle/floor/white,/area/submap/CrashedMedShuttle)
"am" = (/obj/structure/table/standard,/obj/machinery/recharger{pixel_y = 4},/turf/simulated/shuttle/floor/white,/area/submap/CrashedMedShuttle)
"an" = (/obj/structure/window/reinforced,/obj/effect/decal/cleanable/blood/oil,/obj/structure/loot_pile/surface/bones,/obj/structure/lattice,/turf/simulated/floor/outdoors/rocks,/area/submap/CrashedMedShuttle)
"ao" = (/obj/item/weapon/circuitboard/broken,/obj/structure/door_assembly/door_assembly_ext,/turf/simulated/shuttle/plating,/area/submap/CrashedMedShuttle)
"ap" = (/obj/structure/door_assembly/door_assembly_ext,/turf/simulated/shuttle/plating,/area/submap/CrashedMedShuttle)
"aq" = (/obj/effect/decal/cleanable/liquid_fuel,/mob/living/simple_animal/hostile/giant_spider/webslinger{returns_home = 1},/turf/simulated/shuttle/floor/white,/area/submap/CrashedMedShuttle)
"ar" = (/turf/simulated/shuttle/floor/white,/area/submap/CrashedMedShuttle)
"as" = (/obj/structure/closet/crate/medical,/obj/random/medical,/obj/random/medical,/obj/item/weapon/reagent_containers/hypospray/autoinjector/biginjector/bonemed,/turf/simulated/shuttle/floor/white,/area/submap/CrashedMedShuttle)
"at" = (/obj/structure/table/standard,/obj/machinery/cell_charger,/turf/simulated/shuttle/floor/white,/area/submap/CrashedMedShuttle)
"au" = (/obj/item/weapon/material/shard,/obj/structure/lattice,/turf/simulated/floor/outdoors/rocks,/area/submap/CrashedMedShuttle)
"av" = (/obj/structure/closet/secure_closet/personal/patient,/obj/effect/spider/stickyweb,/turf/simulated/shuttle/floor/white,/area/submap/CrashedMedShuttle)
"aw" = (/obj/machinery/light{dir = 8; icon_state = "tube1"; pixel_y = 0},/mob/living/simple_animal/hostile/giant_spider/nurse/medical{returns_home = 1},/turf/simulated/shuttle/floor/white,/area/submap/CrashedMedShuttle)
"ax" = (/obj/machinery/door/airlock/glass,/turf/simulated/shuttle/floor/white,/area/submap/CrashedMedShuttle)
"ay" = (/obj/effect/decal/cleanable/blood/drip,/obj/effect/decal/cleanable/liquid_fuel,/turf/simulated/shuttle/floor/white,/area/submap/CrashedMedShuttle)
"az" = (/obj/effect/decal/cleanable/blood,/obj/effect/decal/cleanable/liquid_fuel,/turf/simulated/shuttle/floor/white,/area/submap/CrashedMedShuttle)
"aA" = (/mob/living/simple_animal/hostile/giant_spider/nurse/medical{returns_home = 1},/turf/simulated/shuttle/floor/white,/area/submap/CrashedMedShuttle)
"aB" = (/obj/effect/decal/cleanable/blood/gibs/robot,/obj/item/weapon/firstaid_arm_assembly,/mob/living/simple_animal/hostile/giant_spider/frost{returns_home = 1},/turf/simulated/shuttle/floor/white,/area/submap/CrashedMedShuttle)
"aC" = (/obj/machinery/suit_cycler/medical{locked = 0},/turf/simulated/shuttle/floor/white,/area/submap/CrashedMedShuttle)
"aD" = (/obj/item/stack/rods,/turf/simulated/mineral/floor/ignore_mapgen,/area/submap/CrashedMedShuttle)
"aE" = (/obj/structure/lattice,/obj/item/stack/rods,/mob/living/simple_animal/hostile/giant_spider/nurse{returns_home = 1},/turf/simulated/floor/outdoors/rocks,/area/submap/CrashedMedShuttle)
"aF" = (/obj/effect/decal/cleanable/blood/oil,/obj/item/weapon/firstaid_arm_assembly,/turf/simulated/shuttle/floor/white,/area/submap/CrashedMedShuttle)
"aG" = (/obj/structure/closet/secure_closet/personal/patient,/turf/simulated/shuttle/floor/white,/area/submap/CrashedMedShuttle)
"aH" = (/obj/effect/decal/cleanable/blood/drip,/turf/simulated/shuttle/floor/white,/area/submap/CrashedMedShuttle)
"aI" = (/obj/structure/reagent_dispensers/fueltank,/obj/effect/decal/cleanable/liquid_fuel,/turf/simulated/shuttle/floor/white,/area/submap/CrashedMedShuttle)
"aJ" = (/obj/structure/reagent_dispensers/watertank,/obj/effect/decal/cleanable/liquid_fuel,/turf/simulated/shuttle/floor/white,/area/submap/CrashedMedShuttle)
"aK" = (/obj/machinery/recharge_station,/obj/effect/decal/cleanable/liquid_fuel,/turf/simulated/shuttle/floor/white,/area/submap/CrashedMedShuttle)
"aL" = (/obj/structure/table/standard,/obj/item/clothing/suit/space/void/medical/alt,/obj/item/clothing/head/helmet/space/void/medical/alt,/obj/effect/spider/stickyweb,/obj/machinery/light,/turf/simulated/shuttle/floor/white,/area/submap/CrashedMedShuttle)
"aM" = (/obj/structure/table/standard,/obj/item/clothing/suit/space/void/medical/alt,/obj/item/clothing/head/helmet/space/void/medical/alt,/obj/effect/spider/stickyweb,/turf/simulated/shuttle/floor/white,/area/submap/CrashedMedShuttle)
"aN" = (/obj/structure/table/standard,/obj/item/weapon/material/shard{icon_state = "medium"},/obj/effect/spider/stickyweb,/turf/simulated/shuttle/floor/white,/area/submap/CrashedMedShuttle)
"aO" = (/obj/structure/grille/broken,/obj/item/weapon/material/shard{icon_state = "medium"},/obj/item/stack/rods,/turf/simulated/shuttle/plating,/area/submap/CrashedMedShuttle)
"aP" = (/obj/item/weapon/material/shard,/turf/simulated/floor/outdoors/rocks,/area/submap/CrashedMedShuttle)
"aQ" = (/obj/effect/decal/cleanable/blood/oil,/turf/simulated/floor/outdoors/rocks,/area/submap/CrashedMedShuttle)
"aR" = (/obj/item/weapon/material/shard{icon_state = "medium"},/obj/effect/spider/stickyweb,/turf/simulated/shuttle/floor/white,/area/submap/CrashedMedShuttle)
"aS" = (/obj/effect/decal/cleanable/blood/gibs/robot,/mob/living/simple_animal/hostile/giant_spider/nurse/medical{returns_home = 1},/turf/simulated/shuttle/floor/white,/area/submap/CrashedMedShuttle)
"aT" = (/obj/effect/spider/stickyweb,/turf/simulated/shuttle/floor/white,/area/submap/CrashedMedShuttle)
"aU" = (/turf/simulated/shuttle/wall/no_join,/area/submap/CrashedMedShuttle)
"aV" = (/obj/effect/decal/cleanable/blood/oil,/obj/structure/loot_pile/surface/bones,/obj/structure/lattice,/turf/simulated/floor/outdoors/rocks,/area/submap/CrashedMedShuttle)
"aW" = (/obj/machinery/light,/obj/structure/table/standard,/obj/machinery/computer/med_data/laptop,/obj/effect/spider/stickyweb,/turf/simulated/shuttle/floor/white,/area/submap/CrashedMedShuttle)
"aX" = (/obj/structure/table/standard,/obj/item/weapon/material/shard{icon_state = "medium"},/obj/random/medical,/turf/simulated/shuttle/floor/white,/area/submap/CrashedMedShuttle)
"aY" = (/obj/effect/spider/stickyweb,/turf/simulated/floor/outdoors/rocks,/area/submap/CrashedMedShuttle)
"aZ" = (/obj/effect/decal/cleanable/blood/drip,/turf/simulated/floor/outdoors/rocks,/area/submap/CrashedMedShuttle)
"ba" = (/obj/machinery/computer,/turf/simulated/shuttle/floor/yellow,/area/submap/CrashedMedShuttle)
"bb" = (/obj/machinery/computer/crew,/turf/simulated/shuttle/floor/yellow,/area/submap/CrashedMedShuttle)
"bc" = (/obj/effect/spider/stickyweb,/turf/simulated/mineral/floor/ignore_mapgen,/area/submap/CrashedMedShuttle)
"bd" = (/obj/effect/spider/cocoon,/turf/simulated/mineral/floor/ignore_mapgen,/area/submap/CrashedMedShuttle)
"be" = (/obj/item/weapon/material/shard{icon_state = "medium"},/turf/simulated/floor/outdoors/rocks,/area/submap/CrashedMedShuttle)
"bf" = (/obj/item/stack/rods,/turf/simulated/floor/outdoors/rocks,/area/submap/CrashedMedShuttle)
"bg" = (/obj/effect/spider/stickyweb,/obj/structure/girder/displaced,/obj/structure/lattice,/turf/simulated/floor/outdoors/rocks,/area/submap/CrashedMedShuttle)
"bh" = (/obj/machinery/light{dir = 8; icon_state = "tube1"; pixel_y = 0},/obj/structure/extinguisher_cabinet{pixel_x = -32},/obj/structure/lattice,/obj/item/device/gps/internal/poi,/obj/structure/flora/tree/sif,/turf/simulated/floor/outdoors/rocks,/area/submap/CrashedMedShuttle)
"bi" = (/mob/living/simple_animal/hostile/giant_spider/nurse/medical,/turf/simulated/floor/outdoors/rocks,/area/submap/CrashedMedShuttle)
"bj" = (/obj/effect/decal/cleanable/blood/splatter,/obj/structure/loot_pile/surface/bones,/obj/effect/decal/cleanable/blood/drip,/obj/structure/lattice,/turf/simulated/floor/outdoors/rocks,/area/submap/CrashedMedShuttle)
"bk" = (/obj/structure/grille/broken,/obj/item/weapon/material/shard{icon_state = "medium"},/turf/simulated/floor/outdoors/rocks,/area/submap/CrashedMedShuttle)
"bl" = (/obj/effect/spider/stickyweb,/mob/living/simple_animal/hostile/giant_spider/nurse/medical,/turf/simulated/floor/outdoors/rocks,/area/submap/CrashedMedShuttle)
"bm" = (/obj/effect/decal/mecha_wreckage/odysseus,/obj/effect/decal/cleanable/blood/oil,/turf/simulated/mineral/floor/ignore_mapgen,/area/submap/CrashedMedShuttle)
"bn" = (/obj/item/weapon/material/shard,/obj/effect/spider/stickyweb,/turf/simulated/floor/outdoors/rocks,/area/submap/CrashedMedShuttle)
"bo" = (/obj/effect/decal/cleanable/blood/oil,/obj/structure/lattice,/turf/simulated/floor/outdoors/rocks,/area/submap/CrashedMedShuttle)
"bp" = (/obj/effect/spider/stickyweb,/obj/item/weapon/material/shard,/turf/simulated/shuttle/floor/white,/area/submap/CrashedMedShuttle)
"bq" = (/obj/random/medical,/obj/random/medical,/turf/simulated/shuttle/floor/white,/area/submap/CrashedMedShuttle)
"br" = (/mob/living/simple_animal/hostile/giant_spider/webslinger{returns_home = 1},/turf/simulated/floor/outdoors/rocks,/area/submap/CrashedMedShuttle)
"bs" = (/obj/effect/spider/cocoon,/obj/structure/lattice,/turf/simulated/floor/outdoors/rocks,/area/submap/CrashedMedShuttle)
"bt" = (/obj/structure{anchored = 1; density = 1; desc = "Once an artificial intelligence; now merely a brick of inert metal and circuits."; icon = 'icons/mob/AI.dmi'; icon_state = "ai-empty"; name = "V.I.T.A"},/turf/simulated/shuttle/floor/yellow,/area/submap/CrashedMedShuttle)
"bu" = (/obj/structure/flora/tree/sif,/turf/simulated/floor/outdoors/rocks,/area/submap/CrashedMedShuttle)
"bv" = (/obj/structure/grille/broken,/obj/item/weapon/material/shard,/turf/simulated/floor/outdoors/rocks,/area/submap/CrashedMedShuttle)
"bw" = (/obj/effect/decal/cleanable/blood/drip,/obj/effect/spider/stickyweb,/mob/living/simple_animal/hostile/giant_spider/webslinger,/turf/simulated/mineral/floor/ignore_mapgen,/area/submap/CrashedMedShuttle)
"bx" = (/obj/effect/decal/cleanable/blood/drip,/turf/simulated/mineral/floor/ignore_mapgen,/area/submap/CrashedMedShuttle)
"by" = (/obj/effect/decal/remains/tajaran,/obj/item/weapon/surgical/circular_saw,/turf/simulated/floor/outdoors/rocks,/area/submap/CrashedMedShuttle)
"bz" = (/obj/effect/decal/cleanable/blood/oil,/obj/effect/spider/stickyweb,/turf/simulated/floor/outdoors/rocks,/area/submap/CrashedMedShuttle)
"bA" = (/obj/item/weapon/material/shard,/obj/structure/loot_pile/maint/technical,/obj/structure/lattice,/turf/simulated/mineral/floor/ignore_mapgen,/area/submap/CrashedMedShuttle)
"bB" = (/obj/structure/bed/chair/office/light{dir = 8},/turf/simulated/shuttle/floor/purple,/area/submap/CrashedMedShuttle)
"bC" = (/obj/item/weapon/circuitboard/broken,/turf/simulated/shuttle/floor/white,/area/submap/CrashedMedShuttle)
"bD" = (/obj/structure/girder,/turf/template_noop,/area/submap/CrashedMedShuttle)
"bE" = (/obj/structure/girder/displaced,/turf/template_noop,/area/submap/CrashedMedShuttle)
"bF" = (/obj/structure/shuttle/engine/propulsion{tag = "icon-propulsion_r (WEST)"; icon_state = "propulsion_r"; dir = 8},/turf/simulated/floor/outdoors/rocks,/area/submap/CrashedMedShuttle)
"bG" = (/obj/structure/shuttle/engine/heater{icon_state = "heater"; dir = 8},/obj/structure/window/reinforced{dir = 4},/turf/simulated/mineral/floor/ignore_mapgen,/area/submap/CrashedMedShuttle)
"bH" = (/obj/structure/table/standard,/obj/item/weapon/reagent_containers/chem_disp_cartridge/tricord,/obj/item/weapon/reagent_containers/chem_disp_cartridge/tramadol,/obj/item/weapon/reagent_containers/chem_disp_cartridge/bicaridine,/obj/item/weapon/reagent_containers/chem_disp_cartridge/dermaline,/turf/simulated/shuttle/floor/purple,/area/submap/CrashedMedShuttle)
"bI" = (/obj/structure/table/standard,/obj/item/weapon/reagent_containers/glass/beaker/bluespace,/obj/item/weapon/storage/fancy/vials,/turf/simulated/shuttle/floor/purple,/area/submap/CrashedMedShuttle)
"bJ" = (/obj/random/medical/pillbottle,/mob/living/simple_animal/hostile/giant_spider/webslinger{returns_home = 1},/turf/simulated/shuttle/floor/white,/area/submap/CrashedMedShuttle)
"bK" = (/obj/structure/table/standard,/obj/item/device/defib_kit/loaded,/turf/simulated/shuttle/floor/white,/area/submap/CrashedMedShuttle)
"bL" = (/obj/structure/table/standard,/obj/random/medical,/obj/random/medical,/turf/simulated/shuttle/floor/white,/area/submap/CrashedMedShuttle)
"bM" = (/obj/structure/table/standard,/obj/item/roller,/turf/simulated/shuttle/floor/white,/area/submap/CrashedMedShuttle)
"bN" = (/obj/structure/table/standard,/obj/machinery/light{dir = 1},/obj/random/firstaid,/turf/simulated/shuttle/floor/white,/area/submap/CrashedMedShuttle)
"bO" = (/obj/structure/table/standard,/obj/random/medical/lite,/turf/simulated/shuttle/floor/white,/area/submap/CrashedMedShuttle)
"bP" = (/obj/structure/table/standard,/obj/random/medical/lite,/obj/item/weapon/surgical/retractor,/turf/simulated/shuttle/floor/white,/area/submap/CrashedMedShuttle)
"bQ" = (/obj/item/weapon/material/shard,/obj/structure/grille,/turf/simulated/shuttle/plating,/area/submap/CrashedMedShuttle)
"bR" = (/obj/machinery/light{dir = 8},/obj/structure/table/standard,/obj/structure/loot_pile/maint/technical,/turf/simulated/shuttle/floor/purple,/area/submap/CrashedMedShuttle)
"bS" = (/obj/effect/decal/cleanable/blood/gibs/robot,/obj/effect/spider/cocoon,/turf/simulated/shuttle/floor/white,/area/submap/CrashedMedShuttle)
"bT" = (/obj/machinery/light{icon_state = "tube1"; dir = 4},/obj/structure/closet/secure_closet/medical_wall/anesthetics{pixel_x = 32},/obj/item/weapon/material/shard{icon_state = "medium"},/turf/simulated/shuttle/floor/white,/area/submap/CrashedMedShuttle)
"bU" = (/obj/machinery/light{dir = 8; icon_state = "tube1"; pixel_y = 0},/turf/simulated/shuttle/floor/white,/area/submap/CrashedMedShuttle)
"bV" = (/obj/effect/spider/cocoon,/turf/simulated/shuttle/floor/white,/area/submap/CrashedMedShuttle)
"bW" = (/mob/living/simple_animal/hostile/giant_spider/nurse{returns_home = 1},/turf/simulated/shuttle/floor/white,/area/submap/CrashedMedShuttle)
"bX" = (/obj/effect/decal/cleanable/blood/splatter,/obj/structure/loot_pile/surface/bones,/obj/item/weapon/surgical/surgicaldrill,/turf/simulated/shuttle/floor/white,/area/submap/CrashedMedShuttle)
"bY" = (/obj/structure/table/standard,/obj/item/weapon/storage/firstaid/combat,/obj/random/firstaid,/turf/simulated/shuttle/floor/white,/area/submap/CrashedMedShuttle)
"bZ" = (/obj/item/weapon/material/shard{icon_state = "medium"},/obj/structure/grille,/turf/simulated/shuttle/plating,/area/submap/CrashedMedShuttle)
"ca" = (/obj/structure/table/standard,/obj/item/device/reagent_scanner/adv,/turf/simulated/shuttle/floor/purple,/area/submap/CrashedMedShuttle)
"cb" = (/obj/machinery/iv_drip,/obj/item/weapon/reagent_containers/blood/OMinus,/turf/simulated/shuttle/floor/white,/area/submap/CrashedMedShuttle)
"cc" = (/obj/structure/table/standard,/obj/item/weapon/storage/box/masks,/obj/item/weapon/storage/box/gloves,/obj/random/medical,/obj/random/medical,/obj/random/medical,/turf/simulated/shuttle/floor/white,/area/submap/CrashedMedShuttle)
"cd" = (/obj/effect/spider/stickyweb,/obj/structure/door_assembly/door_assembly_ext,/turf/simulated/shuttle/plating,/area/submap/CrashedMedShuttle)
"ce" = (/obj/structure/table/standard,/obj/item/device/healthanalyzer/enhanced,/obj/random/firstaid,/turf/simulated/shuttle/floor/white,/area/submap/CrashedMedShuttle)
"cf" = (/obj/structure/table/standard,/obj/item/weapon/storage/backpack/medic,/obj/random/medical/lite,/turf/simulated/shuttle/floor/white,/area/submap/CrashedMedShuttle)
"cg" = (/obj/structure/table/standard,/obj/effect/spider/stickyweb,/obj/random/medical,/turf/simulated/shuttle/floor/white,/area/submap/CrashedMedShuttle)
"ch" = (/obj/structure/girder,/turf/simulated/shuttle/plating,/area/submap/CrashedMedShuttle)
"ci" = (/obj/machinery/vending/medical,/turf/simulated/shuttle/floor/white,/area/submap/CrashedMedShuttle)
"cj" = (/obj/structure/table/standard,/obj/structure/sign/periodic{pixel_y = -32},/obj/item/weapon/surgical/bonesetter,/obj/item/weapon/surgical/scalpel,/turf/simulated/shuttle/floor/white,/area/submap/CrashedMedShuttle)
"ck" = (/obj/machinery/optable,/obj/effect/decal/cleanable/blood/splatter,/obj/structure/loot_pile/surface/bones,/obj/random/medical/pillbottle,/turf/simulated/shuttle/floor/white,/area/submap/CrashedMedShuttle)
"cl" = (/obj/structure/table/standard,/obj/item/weapon/surgical/bonegel,/obj/item/weapon/surgical/FixOVein,/turf/simulated/shuttle/floor/white,/area/submap/CrashedMedShuttle)
"cm" = (/obj/machinery/embedded_controller/radio/simple_docking_controller{frequency = 1380; id_tag = "admin_shuttle"; pixel_x = -25; pixel_y = 0; req_one_access = list(101); tag_door = "admin_shuttle_hatch"},/mob/living/simple_animal/hostile/giant_spider/nurse{returns_home = 1},/turf/simulated/shuttle/plating,/area/submap/CrashedMedShuttle)
"cn" = (/obj/structure/table/standard,/obj/item/weapon/storage/belt/medical/emt,/turf/simulated/shuttle/floor/white,/area/submap/CrashedMedShuttle)
"co" = (/obj/structure/table/standard,/obj/item/weapon/storage/box/syringes,/obj/item/weapon/storage/box/autoinjectors,/obj/effect/spider/stickyweb,/obj/machinery/light,/turf/simulated/shuttle/floor/white,/area/submap/CrashedMedShuttle)
"cp" = (/obj/structure/table/standard,/obj/structure/closet/secure_closet/medical_wall/pills{pixel_x = 32},/turf/simulated/shuttle/floor/white,/area/submap/CrashedMedShuttle)
"cq" = (/obj/machinery/door/airlock/external{frequency = 1380; icon_state = "door_locked"; id_tag = "admin_shuttle_hatch"; locked = 1; name = "Shuttle Hatch"; req_access = null},/turf/simulated/shuttle/plating,/area/submap/CrashedMedShuttle)
"cr" = (/mob/living/bot/medbot,/turf/simulated/mineral/floor/ignore_mapgen,/area/submap/CrashedMedShuttle)

(1,1,1) = {"
aaaaaaaaaaaaaaaaaaaaaaaaaaaaaaaaaaaaaaaaaaaa
aaaaaaaaaaaaabaaaaabacadaeafagagagaaaaaaabaa
aaaaaaababaaaaahabaiadajagakalamagagagaaaaaa
aaaaaaaaaaaaaaabanagaoapagaqararasatagagaaaa
aaaaaaaaahaaabauavagawaraxayazaAaraBaCafabaa
aaababaaaDabaEaFaGafaraHagaIaJaKaLaMaNaOabaa
aaabaaaaaPaQacaRaSaxaraTaUagagagagagagagabaa
aaaaaaaaababaVaWaXafaYaZbabbafabbcaabdabaaaa
aaaaaabebfbgagagagagbhabbibjbkbcblbmababaaaa
aaaaaaabbnboarbpbqafbrbsbtbubvbwbxbyabaaaaaa
aaaaabbzbAbBararaAbCararagbDbDbEagagagagaaaa
aDabbFbGbHbIbJararafaTaragbKbLbMbNbObPbQabaa
aaabagagbRbBbSarbTagbUbVbCarbWaraAbXbYbZabaa
aaaaabagagcacbbWccagcdaoagcearcfbLcgchchaaaa
aaaaaaabagcicjckclagcmajagcncocpagchchabaaaa
aaaaaaabagagagagagaecqcqaeafagagchabababaaaa
aaaaaaaaababababcrababaaaaaaababaaaaaaaaaaaa
"}
