"a" = (/obj/effect/decal/cleanable/liquid_fuel/flamethrower_fuel,/obj/effect/decal/cleanable/molten_item,/turf/template_noop,/area/submap/deadspy)
"b" = (/obj/item/weapon/flamethrower,/obj/effect/decal/cleanable/liquid_fuel/flamethrower_fuel,/turf/template_noop,/area/submap/deadspy)
"c" = (/obj/effect/decal/cleanable/liquid_fuel/flamethrower_fuel,/obj/effect/decal/cleanable/ash,/obj/random/landmine,/turf/template_noop,/area/submap/deadspy)
"d" = (/obj/item/weapon/material/butterfly,/obj/effect/decal/cleanable/liquid_fuel,/turf/template_noop,/area/submap/deadspy)
"e" = (/obj/item/weapon/flame/lighter/zippo,/obj/effect/decal/cleanable/liquid_fuel,/turf/template_noop,/area/submap/deadspy)
"f" = (/obj/effect/decal/cleanable/liquid_fuel,/obj/effect/decal/cleanable/liquid_fuel/flamethrower_fuel,/turf/template_noop,/area/submap/deadspy)
"g" = (/obj/effect/decal/cleanable/liquid_fuel,/obj/random/landmine,/turf/template_noop,/area/submap/deadspy)
"h" = (/obj/item/weapon/deadringer,/obj/effect/decal/cleanable/liquid_fuel,/turf/template_noop,/area/submap/deadspy)
"i" = (/obj/effect/decal/cleanable/liquid_fuel,/obj/item/weapon/storage/fancy/cigarettes/professionals,/turf/template_noop,/area/submap/deadspy)
"j" = (/obj/effect/decal/cleanable/liquid_fuel/flamethrower_fuel,/turf/template_noop,/area/submap/deadspy)
"k" = (/obj/effect/decal/cleanable/liquid_fuel/flamethrower_fuel,/obj/effect/decal/cleanable/ash,/turf/template_noop,/area/submap/deadspy)
"l" = (/obj/effect/decal/cleanable/liquid_fuel,/obj/effect/decal/cleanable/molten_item,/turf/template_noop,/area/submap/deadspy)
"m" = (/obj/effect/decal/remains/human,/obj/item/clothing/mask/balaclava,/obj/item/clothing/under/suit_jacket/really_black,/obj/effect/decal/cleanable/ash,/obj/effect/decal/cleanable/liquid_fuel,/obj/effect/decal/cleanable/ash,/turf/template_noop,/area/submap/deadspy)
"n" = (/obj/effect/decal/cleanable/liquid_fuel,/obj/effect/decal/cleanable/liquid_fuel,/obj/effect/decal/cleanable/ash,/turf/template_noop,/area/submap/deadspy)
"o" = (/obj/effect/decal/cleanable/liquid_fuel,/obj/effect/decal/cleanable/liquid_fuel,/obj/random/landmine,/turf/template_noop,/area/submap/deadspy)
"p" = (/obj/effect/decal/cleanable/liquid_fuel/flamethrower_fuel,/obj/random/landmine,/turf/template_noop,/area/submap/deadspy)
"q" = (/obj/effect/decal/remains/xeno,/obj/item/clothing/mask/gas,/obj/item/clothing/suit/fire/firefighter,/turf/template_noop,/area/submap/deadspy)
"r" = (/turf/template_noop,/area/submap/deadspy)
"s" = (/obj/effect/decal/remains/human,/obj/item/weapon/wrench,/obj/item/clothing/head/hardhat,/turf/template_noop,/area/submap/deadspy)
"t" = (/obj/machinery/porta_turret/poi{desc = "Looking at this heavy caliber, tripod-mounted, little ol' number makes you want to square-dance."; lethal = 0; name = "sentry turret"},/turf/template_noop,/area/submap/deadspy)
"u" = (/obj/item/weapon/card/emag_broken,/turf/template_noop,/area/submap/deadspy)

(1,1,1) = {"
qrrrrrr
rabfjcr
rjgldjs
rjemnjt
rjhoiju
rpjkjjr
rrrrrrr
"}
