"a" = (/turf/template_noop,/area/template_noop)
"b" = (/turf/simulated/mineral/floor/ignore_mapgen,/area/submap/cave/deadBeacon)
"c" = (/obj/structure/loot_pile/maint/junk,/turf/simulated/mineral/floor/ignore_mapgen,/area/submap/cave/deadBeacon)
"d" = (/turf/simulated/wall/r_wall,/area/submap/cave/deadBeacon)
"e" = (/obj/structure/grille,/obj/structure/window/reinforced{dir = 1},/obj/structure/window/reinforced{dir = 8},/obj/structure/window/reinforced,/turf/simulated/floor/plating,/area/submap/cave/deadBeacon)
"f" = (/obj/structure/grille,/obj/structure/window/reinforced,/turf/simulated/floor/plating,/area/submap/cave/deadBeacon)
"g" = (/turf/simulated/floor/plating,/area/submap/cave/deadBeacon)
"h" = (/turf/simulated/floor/airless{icon_state = "asteroidplating2"},/area/submap/cave/deadBeacon)
"i" = (/obj/structure/grille/broken,/turf/simulated/floor/plating,/area/submap/cave/deadBeacon)
"j" = (/obj/structure/table/steel,/turf/simulated/floor/tiled/asteroid_steel,/area/submap/cave/deadBeacon)
"k" = (/obj/structure/loot_pile/maint/technical,/turf/simulated/floor/tiled/asteroid_steel,/area/submap/cave/deadBeacon)
"l" = (/obj/item/weapon/material/shard,/turf/simulated/floor/plating,/area/submap/cave/deadBeacon)
"m" = (/obj/structure/table/steel,/obj/item/weapon/circuitboard/comm_server,/obj/machinery/light{dir = 8; status = LIGHT_EMPTY},/turf/simulated/floor/tiled/asteroid_steel,/area/submap/cave/deadBeacon)
"n" = (/turf/simulated/floor/tiled/asteroid_steel,/area/submap/cave/deadBeacon)
"o" = (/obj/item/weapon/paper/crumpled{info = "Sampatti Relay Sif-833 <BR> Decryption Key for 12-04-2488: <BR> 849B0022FBA920C244 <BR> Eyes Only.  <BR> The insider who knows all the secrets can bring down Lanka."; name = "Dusty Note"},/turf/simulated/floor/tiled/asteroid_steel,/area/submap/cave/deadBeacon)
"p" = (/obj/structure/door_assembly/door_assembly_ext,/turf/simulated/floor/tiled/asteroid_steel,/area/submap/cave/deadBeacon)
"q" = (/obj/item/stack/rods,/turf/simulated/floor/tiled/asteroid_steel,/area/submap/cave/deadBeacon)
"r" = (/obj/machinery/telecomms/relay{active_power_usage = 1; broadcasting = 0; panel_open = 1},/obj/structure/cable{icon_state = "0-2"; pixel_y = 1; d2 = 2},/turf/simulated/floor/tiled/asteroid_steel,/area/submap/cave/deadBeacon)
"s" = (/obj/machinery/telecomms/broadcaster{light_power = 0; on = 0},/turf/simulated/floor/tiled/asteroid_steel,/area/submap/cave/deadBeacon)
"t" = (/obj/structure/grille,/obj/structure/window/reinforced{dir = 8},/obj/structure/window/reinforced{dir = 4},/turf/simulated/floor/plating,/area/submap/cave/deadBeacon)
"u" = (/obj/machinery/telecomms/receiver{light_power = 0; on = 0},/obj/structure/cable,/turf/simulated/floor/tiled/asteroid_steel,/area/submap/cave/deadBeacon)
"v" = (/obj/item/weapon/circuitboard/broken,/turf/simulated/floor/tiled/asteroid_steel,/area/submap/cave/deadBeacon)
"w" = (/obj/effect/decal/cleanable/blood/oil,/turf/simulated/floor/tiled/asteroid_steel,/area/submap/cave/deadBeacon)
"x" = (/obj/structure/grille,/obj/structure/window/reinforced{dir = 4},/obj/structure/window/reinforced{dir = 8},/turf/simulated/floor/plating,/area/submap/cave/deadBeacon)
"y" = (/obj/effect/decal/remains/robot,/obj/effect/decal/cleanable/blood/oil,/turf/simulated/floor/tiled/asteroid_steel,/area/submap/cave/deadBeacon)
"z" = (/obj/item/stack/cable_coil{amount = 1},/turf/simulated/floor/tiled/asteroid_steel,/area/submap/cave/deadBeacon)
"A" = (/obj/item/weapon/circuitboard/broken,/turf/simulated/mineral/floor/ignore_mapgen,/area/submap/cave/deadBeacon)
"B" = (/obj/structure/grille/broken,/obj/structure/window/reinforced{dir = 4},/turf/simulated/floor/plating,/area/submap/cave/deadBeacon)
"C" = (/obj/structure/loot_pile/maint/junk,/turf/simulated/floor/plating,/area/submap/cave/deadBeacon)
"D" = (/obj/item/weapon/cigbutt,/obj/item/weapon/tool/wrench,/obj/machinery/light,/turf/simulated/floor/tiled/asteroid_steel,/area/submap/cave/deadBeacon)
"E" = (/obj/item/weapon/material/shard,/turf/simulated/floor/tiled/asteroid_steel,/area/submap/cave/deadBeacon)
"F" = (/obj/machinery/recharge_station,/turf/simulated/floor/tiled/asteroid_steel,/area/submap/cave/deadBeacon)
"G" = (/obj/structure/grille,/obj/structure/window/reinforced{dir = 4},/obj/structure/window/reinforced{dir = 8},/obj/structure/window/reinforced,/turf/simulated/floor/plating,/area/submap/cave/deadBeacon)
"H" = (/obj/machinery/door/airlock/external,/turf/simulated/floor/tiled/asteroid_steel,/area/submap/cave/deadBeacon)
"I" = (/obj/machinery/access_button/airlock_interior{dir = 4},/turf/simulated/wall/r_wall,/area/submap/cave/deadBeacon)
"J" = (/obj/structure/grille/broken,/obj/item/stack/rods,/turf/simulated/floor/plating,/area/submap/cave/deadBeacon)
"K" = (/obj/structure/girder,/turf/simulated/floor/plating,/area/submap/cave/deadBeacon)
"L" = (/obj/structure/sign/warning/secure_area,/turf/simulated/wall/r_wall,/area/submap/cave/deadBeacon)
"M" = (/obj/structure/sign/warning/high_voltage,/turf/simulated/wall/r_wall,/area/submap/cave/deadBeacon)

(1,1,1) = {"
aaaaaaaaaaaaaaaaaaaa
aaaaaaaaaabbaaaaaaaa
aaaaaabbabbcbaaaaaaa
aaaaaadefgghidaaaaaa
aaaaaahjkgglhibaaaaa
aaaaahdmnoggggbaaaaa
aaaabnpqnrsgqtbaaaaa
aaaabngnnuvwnxaaaaaa
aaaabhdgynnzkxbaaaaa
aaaaAbBCDnnEFGbaaaaa
aaaaaadidHHIJdbaaaaa
aaaaaaabdgnKbbaaaaaa
aaaaaaaaLHHMaaaaaaaa
aaaaaaaabbbAaaaaaaaa
aaaaaaaaaaaaaaaaaaaa
aaaaaaaaaaaaaaaaaaaa
aaaaaaaaaaaaaaaaaaaa
aaaaaaaaaaaaaaaaaaaa
aaaaaaaaaaaaaaaaaaaa
aaaaaaaaaaaaaaaaaaaa
"}
