//MAP CONVERTED BY dmm2tgm.py THIS HEADER COMMENT PREVENTS RECONVERSION, DO NOT REMOVE
"a" = (
/turf/template_noop,
/area/template_noop)
"b" = (
/obj/structure/loot_pile/surface/bones,
/obj/effect/decal/cleanable/blood,
/turf/simulated/mineral/floor/ignore_mapgen/cave,
/area/template_noop)
"e" = (
/mob/living/simple_mob/vore/rabbit/killer,
/turf/simulated/mineral/floor/ignore_mapgen/cave,
/area/template_noop)
"g" = (
/turf/simulated/mineral/floor/ignore_mapgen/cave,
/area/template_noop)
"h" = (
/turf/simulated/mineral/ignore_mapgen/cave,
/area/template_noop)
"m" = (
/obj/item/bone/skull,
/obj/effect/decal/cleanable/blood,
/turf/simulated/mineral/floor/ignore_mapgen/cave,
/area/template_noop)
"n" = (
/obj/item/clothing/suit/storage/hooded/knight/galahad,
/obj/effect/decal/cleanable/blood,
/obj/item/clothing/shoes/knight,
/turf/simulated/mineral/floor/ignore_mapgen/cave,
/area/template_noop)
"q" = (
/obj/effect/decal/cleanable/blood,
/obj/item/bone,
/obj/item/bone/skull,
/turf/simulated/mineral/floor/ignore_mapgen/cave,
/area/template_noop)
"r" = (
/obj/item/bone,
/turf/simulated/mineral/floor/ignore_mapgen/cave,
/area/template_noop)
"s" = (
/obj/item/bone/ribs,
/obj/effect/decal/cleanable/blood,
/turf/simulated/mineral/floor/ignore_mapgen/cave,
/area/template_noop)
"t" = (
/obj/effect/gibspawner/human,
/turf/simulated/mineral/floor/ignore_mapgen/cave,
/area/template_noop)
"u" = (
/obj/effect/decal/cleanable/blood,
/obj/item/bone/skull,
/turf/simulated/mineral/floor/ignore_mapgen/cave,
/area/template_noop)
"v" = (
/obj/item/grenade/explosive/frag,
/turf/simulated/mineral/floor/ignore_mapgen/cave,
/area/template_noop)
"y" = (
/obj/item/bone,
/obj/item/bone/ribs,
/turf/simulated/mineral/floor/ignore_mapgen/cave,
/area/template_noop)
"A" = (
/obj/effect/decal/cleanable/blood,
/obj/item/bone,
/turf/simulated/mineral/floor/ignore_mapgen/cave,
/area/template_noop)
"C" = (
/obj/item/clothing/suit/storage/hooded/knight/lancelot,
/obj/effect/decal/cleanable/blood,
/obj/item/clothing/shoes/knight,
/obj/item/clothing/shoes/knight/black,
/turf/simulated/mineral/floor/ignore_mapgen/cave,
/area/template_noop)
"E" = (
/obj/item/clothing/suit/armor/combat/crusader/bedevere,
/obj/item/clothing/head/helmet/combat/bedevere,
/obj/effect/decal/cleanable/blood,
/obj/item/clothing/shoes/knight/black,
/turf/simulated/mineral/floor/ignore_mapgen/cave,
/area/template_noop)
"F" = (
/obj/item/bone,
/obj/item/bone/skull,
/turf/simulated/mineral/floor/ignore_mapgen/cave,
/area/template_noop)
"I" = (
/obj/item/clothing/suit/storage/hooded/knight/robin,
/obj/effect/decal/cleanable/blood/splatter,
/obj/item/clothing/shoes/knight,
/turf/simulated/mineral/floor/ignore_mapgen/cave,
/area/template_noop)
"J" = (
/obj/effect/decal/cleanable/blood,
/obj/item/bone/ribs,
/turf/simulated/mineral/floor/ignore_mapgen/cave,
/area/template_noop)
"K" = (
/obj/item/clothing/suit/armor/combat/crusader,
/obj/item/clothing/head/helmet/combat/crusader,
/obj/effect/decal/cleanable/blood,
/obj/item/clothing/shoes/knight,
/turf/simulated/mineral/floor/ignore_mapgen/cave,
/area/template_noop)
"L" = (
/obj/structure/barricade/cutout/fukken_xeno,
/turf/simulated/mineral/floor/ignore_mapgen/cave,
/area/template_noop)
"P" = (
/obj/item/bone/skull,
/turf/simulated/mineral/floor/ignore_mapgen/cave,
/area/template_noop)
"Q" = (
/obj/item/bone,
/obj/structure/loot_pile/surface/bones,
/obj/effect/decal/cleanable/blood,
/turf/simulated/mineral/floor/ignore_mapgen/cave,
/area/template_noop)
"T" = (
/obj/structure/barricade,
/turf/simulated/mineral/floor/ignore_mapgen/cave,
/area/template_noop)
"U" = (
/obj/item/bone/ribs,
/obj/item/clothing/suit/storage/hooded/knight,
/obj/item/bone/skull,
/obj/effect/decal/cleanable/blood,
/obj/item/clothing/shoes/knight/black,
/turf/simulated/mineral/floor/ignore_mapgen/cave,
/area/template_noop)
"V" = (
/obj/item/bone,
/obj/effect/decal/cleanable/blood,
/turf/simulated/mineral/floor/ignore_mapgen/cave,
/area/template_noop)
"Y" = (
/obj/effect/decal/cleanable/blood,
/turf/simulated/mineral/floor/ignore_mapgen/cave,
/area/template_noop)

(1,1,1) = {"
a
a
a
a
a
a
a
a
a
a
a
a
a
a
a
a
a
a
a
a
"}
(2,1,1) = {"
a
a
a
a
h
h
h
h
h
h
h
a
a
a
a
a
a
a
a
a
"}
(3,1,1) = {"
h
h
h
h
h
h
h
h
h
h
h
h
h
h
g
a
a
a
a
a
"}
(4,1,1) = {"
h
h
h
h
h
h
h
h
h
h
h
h
h
h
b
g
a
a
a
a
"}
(5,1,1) = {"
h
h
h
h
g
g
m
g
g
g
g
h
h
h
h
h
h
m
g
g
"}
(6,1,1) = {"
h
h
h
g
g
s
I
t
g
n
m
h
h
h
h
h
h
q
u
g
"}
(7,1,1) = {"
h
h
h
g
g
g
V
g
g
t
g
g
g
g
g
g
T
T
A
g
"}
(8,1,1) = {"
h
h
h
g
g
g
g
g
U
g
g
g
g
g
g
g
T
h
F
g
"}
(9,1,1) = {"
h
h
h
g
g
g
g
g
g
g
g
b
h
h
v
g
h
h
h
Q
"}
(10,1,1) = {"
h
h
h
g
g
h
h
g
g
g
h
h
h
h
h
h
h
h
h
h
"}
(11,1,1) = {"
h
h
h
e
g
h
h
g
g
V
h
h
h
h
h
h
h
h
h
h
"}
(12,1,1) = {"
h
h
h
g
g
g
g
g
g
g
g
g
h
h
v
T
h
h
h
r
"}
(13,1,1) = {"
h
h
h
t
g
g
m
g
g
g
g
g
g
g
g
T
Y
h
P
g
"}
(14,1,1) = {"
h
h
h
m
E
t
K
g
g
g
g
g
g
g
V
T
T
J
r
r
"}
(15,1,1) = {"
h
h
h
g
g
g
g
g
C
g
g
h
h
h
h
h
h
b
y
P
"}
(16,1,1) = {"
h
h
h
h
g
b
g
t
m
g
g
h
h
h
h
h
h
m
r
r
"}
(17,1,1) = {"
h
h
h
h
h
h
h
h
h
h
h
h
h
h
L
g
a
a
a
a
"}
(18,1,1) = {"
h
h
h
h
h
h
h
h
h
h
h
h
h
h
g
a
a
a
a
a
"}
(19,1,1) = {"
a
a
a
a
h
h
h
h
h
h
h
a
a
a
a
a
a
a
a
a
"}
(20,1,1) = {"
a
a
a
a
a
a
a
a
a
a
a
a
a
a
a
a
a
a
a
a
"}
