"a" = (/turf/template_noop,/area/template_noop)
"b" = (/obj/structure/loot_pile/surface/bones,/obj/effect/decal/cleanable/blood,/turf/simulated/mineral/floor/ignore_mapgen/cave,/area/template_noop)
"e" = (/mob/living/simple_mob/vore/rabbit/killer,/turf/simulated/mineral/floor/ignore_mapgen/cave,/area/template_noop)
"g" = (/turf/simulated/mineral/floor/ignore_mapgen/cave,/area/template_noop)
"h" = (/turf/simulated/mineral/ignore_mapgen/cave,/area/template_noop)
"m" = (/obj/item/bone/skull,/obj/effect/decal/cleanable/blood,/turf/simulated/mineral/floor/ignore_mapgen/cave,/area/template_noop)
"n" = (/obj/item/clothing/suit/storage/hooded/knight/galahad,/obj/effect/decal/cleanable/blood,/obj/item/clothing/shoes/knight,/turf/simulated/mineral/floor/ignore_mapgen/cave,/area/template_noop)
"q" = (/obj/effect/decal/cleanable/blood,/obj/item/bone,/obj/item/bone/skull,/turf/simulated/mineral/floor/ignore_mapgen/cave,/area/template_noop)
"r" = (/obj/item/bone,/turf/simulated/mineral/floor/ignore_mapgen/cave,/area/template_noop)
"s" = (/obj/item/bone/ribs,/obj/effect/decal/cleanable/blood,/turf/simulated/mineral/floor/ignore_mapgen/cave,/area/template_noop)
"t" = (/obj/effect/spawner/gibs/human,/turf/simulated/mineral/floor/ignore_mapgen/cave,/area/template_noop)
"u" = (/obj/effect/decal/cleanable/blood,/obj/item/bone/skull,/turf/simulated/mineral/floor/ignore_mapgen/cave,/area/template_noop)
"v" = (/obj/item/grenade/explosive/frag,/turf/simulated/mineral/floor/ignore_mapgen/cave,/area/template_noop)
"y" = (/obj/item/bone,/obj/item/bone/ribs,/turf/simulated/mineral/floor/ignore_mapgen/cave,/area/template_noop)
"A" = (/obj/effect/decal/cleanable/blood,/obj/item/bone,/turf/simulated/mineral/floor/ignore_mapgen/cave,/area/template_noop)
"C" = (/obj/item/clothing/suit/storage/hooded/knight/lancelot,/obj/effect/decal/cleanable/blood,/obj/item/clothing/shoes/knight,/obj/item/clothing/shoes/knight/black,/turf/simulated/mineral/floor/ignore_mapgen/cave,/area/template_noop)
"E" = (/obj/item/clothing/suit/armor/combat/crusader/bedevere,/obj/item/clothing/head/helmet/combat/bedevere,/obj/effect/decal/cleanable/blood,/obj/item/clothing/shoes/knight/black,/turf/simulated/mineral/floor/ignore_mapgen/cave,/area/template_noop)
"F" = (/obj/item/bone,/obj/item/bone/skull,/turf/simulated/mineral/floor/ignore_mapgen/cave,/area/template_noop)
"I" = (/obj/item/clothing/suit/storage/hooded/knight/robin,/obj/effect/decal/cleanable/blood/splatter,/obj/item/clothing/shoes/knight,/turf/simulated/mineral/floor/ignore_mapgen/cave,/area/template_noop)
"J" = (/obj/effect/decal/cleanable/blood,/obj/item/bone/ribs,/turf/simulated/mineral/floor/ignore_mapgen/cave,/area/template_noop)
"K" = (/obj/item/clothing/suit/armor/combat/crusader,/obj/item/clothing/head/helmet/combat/crusader,/obj/effect/decal/cleanable/blood,/obj/item/clothing/shoes/knight,/turf/simulated/mineral/floor/ignore_mapgen/cave,/area/template_noop)
"L" = (/obj/structure/barricade/cutout/fukken_xeno,/turf/simulated/mineral/floor/ignore_mapgen/cave,/area/template_noop)
"P" = (/obj/item/bone/skull,/turf/simulated/mineral/floor/ignore_mapgen/cave,/area/template_noop)
"Q" = (/obj/item/bone,/obj/structure/loot_pile/surface/bones,/obj/effect/decal/cleanable/blood,/turf/simulated/mineral/floor/ignore_mapgen/cave,/area/template_noop)
"T" = (/obj/structure/barricade,/turf/simulated/mineral/floor/ignore_mapgen/cave,/area/template_noop)
"U" = (/obj/item/bone/ribs,/obj/item/clothing/suit/storage/hooded/knight,/obj/item/bone/skull,/obj/effect/decal/cleanable/blood,/obj/item/clothing/shoes/knight/black,/turf/simulated/mineral/floor/ignore_mapgen/cave,/area/template_noop)
"V" = (/obj/item/bone,/obj/effect/decal/cleanable/blood,/turf/simulated/mineral/floor/ignore_mapgen/cave,/area/template_noop)
"Y" = (/obj/effect/decal/cleanable/blood,/turf/simulated/mineral/floor/ignore_mapgen/cave,/area/template_noop)

(1,1,1) = {"
aahhhhhhhhhhhhhhhhaa
aahhhhhhhhhhhhhhhhaa
aahhhhhhhhhhhhhhhhaa
aahhhgggggegtmghhhaa
ahhhgggggggggEgghhha
ahhhgsggghhggtgbhhha
ahhhmIVgghhgmKgghhha
ahhhgtgggggggggthhha
ahhhgggUggggggCmhhha
ahhhgntgggVggggghhha
ahhhgmggghhggggghhha
aahhhhggbhhggghhhhaa
aahhhhgghhhhgghhhhaa
aahhhhgghhhhgghhhhaa
aagbhhggvhhvgVhhLgaa
aaaghhggghhTTThhgaaa
aaaahhTThhhhYThhaaaa
aaaamqThhhhhhJbmaaaa
aaaaguAFhhhhPryraaaa
aaaaggggQhhrgrPraaaa
"}
