//MAP CONVERTED BY dmm2tgm.py THIS HEADER COMMENT PREVENTS RECONVERSION, DO NOT REMOVE
"aa" = (
/turf/template_noop,
/area/template_noop)
"ab" = (
/obj/structure/cliff/automatic{
	icon_state = "cliffbuilder";
	dir = 9
	},
/turf/simulated/floor/outdoors/rocks/caves,
/area/submap/lava_trench)
"ac" = (
/obj/structure/cliff/automatic,
/turf/simulated/floor/outdoors/rocks/caves,
/area/submap/lava_trench)
"ad" = (
/obj/structure/cliff/automatic{
	icon_state = "cliffbuilder";
	dir = 5
	},
/turf/simulated/floor/outdoors/rocks/caves,
/area/submap/lava_trench)
"ae" = (
/obj/structure/cliff/automatic/corner{
	icon_state = "cliffbuilder-corner";
	dir = 9
	},
/turf/simulated/floor/outdoors/rocks/caves,
/area/submap/lava_trench)
"af" = (
/turf/simulated/floor/outdoors/rocks/caves,
/area/submap/lava_trench)
"ag" = (
/obj/structure/cliff/automatic/corner,
/turf/simulated/floor/outdoors/rocks/caves,
/area/submap/lava_trench)
"ah" = (
/obj/structure/fence/end{
	icon_state = "end";
	dir = 4
	},
/turf/simulated/floor/outdoors/rocks/caves,
/area/submap/lava_trench)
"ai" = (
/obj/structure/fence/post{
	icon_state = "post";
	dir = 4
	},
/turf/simulated/floor/outdoors/rocks/caves,
/area/submap/lava_trench)
"aj" = (
/obj/structure/fence/door/opened,
/turf/simulated/floor/outdoors/rocks/caves,
/area/submap/lava_trench)
"ak" = (
/obj/structure/fence/end{
	icon_state = "end";
	dir = 8
	},
/turf/simulated/floor/outdoors/rocks/caves,
/area/submap/lava_trench)
"al" = (
/obj/structure/cliff/automatic{
	icon_state = "cliffbuilder";
	dir = 8
	},
/turf/simulated/floor/outdoors/rocks/caves,
/area/submap/lava_trench)
"am" = (
/obj/structure/fence/end{
	icon_state = "end";
	dir = 1
	},
/turf/simulated/floor/outdoors/rocks/caves,
/area/submap/lava_trench)
"an" = (
/obj/structure/cliff/automatic{
	icon_state = "cliffbuilder";
	dir = 9
	},
/turf/simulated/floor/lava,
/area/submap/lava_trench)
"ao" = (
/obj/structure/cliff/automatic,
/turf/simulated/floor/lava,
/area/submap/lava_trench)
"ap" = (
/obj/structure/cliff/automatic{
	icon_state = "cliffbuilder";
	dir = 5
	},
/turf/simulated/floor/lava,
/area/submap/lava_trench)
"aq" = (
/obj/structure/sign/warning/lava,
/turf/simulated/wall,
/area/submap/lava_trench)
"ar" = (
/obj/structure/fence/post,
/turf/simulated/floor/outdoors/rocks/caves,
/area/submap/lava_trench)
"as" = (
/obj/structure/cliff/automatic{
	icon_state = "cliffbuilder";
	dir = 6
	},
/turf/simulated/floor/outdoors/rocks/caves,
/area/submap/lava_trench)
"at" = (
/obj/structure/cliff/automatic/corner{
	icon_state = "cliffbuilder-corner";
	dir = 9
	},
/turf/simulated/floor/lava,
/area/submap/lava_trench)
"au" = (
/turf/simulated/floor/lava,
/area/submap/lava_trench)
"av" = (
/obj/structure/cliff/automatic/corner,
/turf/simulated/floor/lava,
/area/submap/lava_trench)
"aw" = (
/obj/structure/railing{
	icon_state = "railing0";
	dir = 4
	},
/turf/simulated/floor/outdoors/rocks/caves,
/area/submap/lava_trench)
"ax" = (
/obj/structure/catwalk,
/turf/simulated/floor/outdoors/rocks/caves,
/area/submap/lava_trench)
"ay" = (
/obj/structure/railing{
	icon_state = "railing0";
	dir = 8
	},
/turf/simulated/floor/outdoors/rocks/caves,
/area/submap/lava_trench)
"az" = (
/obj/structure/fence/door/opened{
	icon_state = "door_opened";
	dir = 8
	},
/turf/simulated/floor/outdoors/rocks/caves,
/area/submap/lava_trench)
"aA" = (
/obj/structure/cliff/automatic{
	icon_state = "cliffbuilder";
	dir = 8
	},
/turf/simulated/floor/lava,
/area/submap/lava_trench)
"aB" = (
/turf/simulated/mineral/floor/ignore_mapgen,
/area/template_noop)
"aC" = (
/turf/simulated/floor/outdoors/rocks/caves,
/area/template_noop)
"aD" = (
/obj/structure/cliff/automatic,
/obj/structure/railing{
	icon_state = "railing0";
	dir = 4
	},
/turf/simulated/floor/lava,
/area/submap/lava_trench)
"aE" = (
/obj/structure/cliff/automatic,
/obj/structure/railing{
	icon_state = "railing0";
	dir = 8
	},
/turf/simulated/floor/lava,
/area/submap/lava_trench)
"aF" = (
/obj/structure/cliff/automatic{
	icon_state = "cliffbuilder";
	dir = 10
	},
/turf/simulated/floor/lava,
/area/submap/lava_trench)
"aG" = (
/obj/structure/cliff/automatic/corner{
	icon_state = "cliffbuilder-corner";
	dir = 10
	},
/turf/simulated/floor/lava,
/area/submap/lava_trench)
"aH" = (
/obj/structure/railing{
	icon_state = "railing0";
	dir = 4
	},
/obj/effect/step_trigger/teleporter/offset/east,
/turf/simulated/floor/lava,
/area/submap/lava_trench)
"aI" = (
/obj/structure/catwalk,
/turf/simulated/floor/lava,
/area/submap/lava_trench)
"aJ" = (
/obj/structure/ore_box,
/turf/simulated/floor/tiled/asteroid_steel,
/area/submap/lava_trench)
"aK" = (
/obj/structure/railing{
	icon_state = "railing0";
	dir = 8
	},
/obj/effect/step_trigger/teleporter/offset/west,
/turf/simulated/floor/lava,
/area/submap/lava_trench)
"aL" = (
/obj/structure/cliff/automatic{
	icon_state = "cliffbuilder";
	dir = 4
	},
/turf/simulated/floor/outdoors/rocks/caves,
/area/submap/lava_trench)
"aM" = (
/obj/machinery/light/small/flicker{
	icon_state = "bulb1";
	dir = 4
	},
/turf/simulated/floor/outdoors/rocks/caves,
/area/submap/lava_trench)
"aN" = (
/obj/machinery/door/airlock/hatch{
	normalspeed = 0;
	safe = 0
	},
/obj/effect/map_effect/interval/effect_emitter/sparks,
/turf/simulated/floor/tiled/old_tile,
/area/submap/lava_trench/outpost)
"aO" = (
/turf/simulated/wall/rshull,
/area/submap/lava_trench/outpost)
"aQ" = (
/turf/simulated/floor/tiled/old_tile,
/area/submap/lava_trench/outpost)
"aR" = (
/obj/effect/floor_decal/corner_oldtile/blue/full{
	icon_state = "corner_oldtile_full";
	dir = 8
	},
/obj/machinery/microscope,
/obj/structure/table/standard,
/turf/simulated/floor/tiled/old_tile,
/area/submap/lava_trench/outpost)
"aS" = (
/obj/effect/floor_decal/corner_oldtile/blue/full{
	icon_state = "corner_oldtile_full";
	dir = 8
	},
/obj/structure/table/standard,
/obj/random/unidentified_medicine/scientific,
/turf/simulated/floor/tiled/old_tile,
/area/submap/lava_trench/outpost)
"aT" = (
/obj/structure/fence/end,
/turf/simulated/floor/outdoors/rocks/caves,
/area/submap/lava_trench)
"aU" = (
/obj/structure/cliff/automatic{
	icon_state = "cliffbuilder";
	dir = 2
	},
/turf/simulated/floor/lava,
/area/submap/lava_trench)
"aV" = (
/obj/structure/cliff/automatic{
	icon_state = "cliffbuilder";
	dir = 10
	},
/turf/simulated/floor/outdoors/rocks/caves,
/area/submap/lava_trench)
"aW" = (
/obj/structure/cliff/automatic/corner{
	icon_state = "cliffbuilder-corner";
	dir = 10
	},
/turf/simulated/floor/outdoors/rocks/caves,
/area/submap/lava_trench)
"aX" = (
/obj/structure/cliff/automatic/corner{
	icon_state = "cliffbuilder-corner";
	dir = 6
	},
/turf/simulated/floor/lava,
/area/submap/lava_trench)
"aY" = (
/obj/structure/cliff/automatic{
	icon_state = "cliffbuilder";
	dir = 2
	},
/obj/structure/railing{
	icon_state = "railing0";
	dir = 4
	},
/turf/simulated/floor/lava,
/area/submap/lava_trench)
"aZ" = (
/obj/structure/cliff/automatic{
	icon_state = "cliffbuilder";
	dir = 2
	},
/obj/structure/railing{
	icon_state = "railing0";
	dir = 8
	},
/turf/simulated/floor/lava,
/area/submap/lava_trench)
"ba" = (
/obj/machinery/crystal/lava,
/turf/simulated/floor/outdoors/rocks/caves,
/area/submap/lava_trench)
"bb" = (
/obj/structure/cliff/automatic{
	icon_state = "cliffbuilder";
	dir = 4
	},
/turf/simulated/floor/lava,
/area/submap/lava_trench)
"bc" = (
/obj/structure/cliff/automatic{
	icon_state = "cliffbuilder";
	dir = 6
	},
/turf/simulated/floor/lava,
/area/submap/lava_trench)
"bd" = (
/obj/structure/table/steel,
/obj/item/storage/excavation,
/obj/item/measuring_tape,
/obj/effect/floor_decal/corner_oldtile/purple{
	icon_state = "corner_oldtile";
	dir = 4
	},
/turf/simulated/floor/tiled/old_tile,
/area/submap/lava_trench/outpost)
"be" = (
/turf/simulated/mineral/ignore_mapgen,
/area/template_noop)
"bf" = (
/obj/structure/railing,
/turf/simulated/floor/outdoors/rocks/caves,
/area/submap/lava_trench)
"bg" = (
/obj/structure/cliff/automatic{
	icon_state = "cliffbuilder";
	dir = 10
	},
/obj/structure/railing,
/turf/simulated/floor/lava,
/area/submap/lava_trench)
"bh" = (
/obj/structure/cliff/automatic/corner{
	icon_state = "cliffbuilder-corner";
	dir = 10
	},
/obj/structure/railing,
/turf/simulated/floor/lava,
/area/submap/lava_trench)
"bi" = (
/obj/structure/railing,
/obj/effect/step_trigger/teleporter/offset/south,
/turf/simulated/floor/lava,
/area/submap/lava_trench)
"bj" = (
/obj/structure/cliff/automatic{
	icon_state = "cliffbuilder";
	dir = 4
	},
/obj/structure/railing,
/turf/simulated/floor/lava,
/area/submap/lava_trench)
"bk" = (
/obj/structure/catwalk,
/obj/structure/railing,
/turf/simulated/floor/outdoors/rocks/caves,
/area/submap/lava_trench)
"bl" = (
/obj/structure/catwalk,
/obj/structure/railing,
/turf/simulated/floor/lava,
/area/submap/lava_trench)
"bm" = (
/obj/structure/fence/door/opened{
	icon_state = "door_opened";
	dir = 4
	},
/turf/simulated/floor/outdoors/rocks/caves,
/area/submap/lava_trench)
"bn" = (
/obj/structure/cliff/automatic{
	icon_state = "cliffbuilder";
	dir = 2
	},
/turf/simulated/floor/outdoors/rocks/caves,
/area/submap/lava_trench)
"bo" = (
/obj/effect/floor_decal/corner_oldtile/purple/full{
	icon_state = "corner_oldtile_full";
	dir = 1
	},
/obj/machinery/space_heater,
/turf/simulated/floor/tiled/old_tile,
/area/submap/lava_trench/outpost)
"bp" = (
/obj/machinery/floodlight,
/turf/simulated/floor/outdoors/rocks/caves,
/area/submap/lava_trench)
"bq" = (
/obj/machinery/newscaster{
	pixel_y = 32
	},
/obj/machinery/light/small/flicker{
	icon_state = "bulb1";
	dir = 1
	},
/turf/simulated/floor/tiled/old_tile,
/area/submap/lava_trench/outpost)
"br" = (
/obj/effect/floor_decal/corner_oldtile/blue{
	icon_state = "corner_oldtile";
	dir = 1
	},
/obj/structure/bed/chair/office/light{
	icon_state = "officechair_white";
	dir = 4
	},
/turf/simulated/floor/tiled/old_tile,
/area/submap/lava_trench/outpost)
"bs" = (
/turf/simulated/floor/tiled/old_tile/gray,
/area/submap/lava_trench/outpost)
"bt" = (
/obj/effect/floor_decal/corner_oldtile/purple{
	icon_state = "corner_oldtile";
	dir = 4
	},
/turf/simulated/floor/tiled/old_tile,
/area/submap/lava_trench/outpost)
"bu" = (
/obj/structure/cliff/automatic/corner{
	icon_state = "cliffbuilder-corner";
	dir = 6
	},
/turf/simulated/floor/outdoors/rocks/caves,
/area/submap/lava_trench)
"bv" = (
/obj/item/slime_crystal,
/obj/item/slime_crystal,
/obj/item/slime_crystal,
/obj/effect/floor_decal/corner_oldtile/blue{
	icon_state = "corner_oldtile";
	dir = 9
	},
/obj/structure/table/standard,
/turf/simulated/floor/tiled/old_tile,
/area/submap/lava_trench/outpost)
"bw" = (
/turf/simulated/floor/tiled/asteroid_steel,
/area/submap/lava_trench)
"bx" = (
/obj/machinery/crystal/ice,
/turf/simulated/floor/tiled/asteroid_steel,
/area/submap/lava_trench)
"by" = (
/obj/machinery/ai_status_display{
	pixel_y = 32
	},
/obj/machinery/light/small/flicker{
	icon_state = "bulb1";
	dir = 1
	},
/turf/simulated/floor/tiled/old_tile,
/area/submap/lava_trench/outpost)
"bz" = (
/obj/effect/floor_decal/corner_oldtile{
	icon_state = "corner_oldtile";
	dir = 1
	},
/turf/simulated/floor/tiled/old_tile/gray,
/area/submap/lava_trench/outpost)
"bA" = (
/obj/effect/floor_decal/corner_oldtile{
	icon_state = "corner_oldtile";
	dir = 4
	},
/turf/simulated/floor/tiled/old_tile/gray,
/area/submap/lava_trench/outpost)
"bB" = (
/obj/effect/floor_decal/corner_oldtile/blue{
	icon_state = "corner_oldtile";
	dir = 8
	},
/turf/simulated/floor/tiled/old_tile,
/area/submap/lava_trench/outpost)
"bC" = (
/obj/structure/table/rack,
/obj/item/shovel,
/obj/effect/floor_decal/corner_oldtile/purple/full{
	icon_state = "corner_oldtile_full";
	dir = 1
	},
/obj/item/pickaxe/drill,
/turf/simulated/floor/tiled/old_tile,
/area/submap/lava_trench/outpost)
"bD" = (
/obj/effect/step_trigger/teleporter/offset/north,
/turf/simulated/floor/lava,
/area/submap/lava_trench)
"bE" = (
/obj/machinery/crystal/lava,
/turf/simulated/floor/tiled/asteroid_steel,
/area/submap/lava_trench)
"bF" = (
/obj/structure/table/rack,
/obj/random/tool/powermaint,
/obj/random/tool/powermaint,
/obj/effect/floor_decal/corner_oldtile/purple{
	icon_state = "corner_oldtile";
	dir = 6
	},
/turf/simulated/floor/tiled/old_tile,
/area/submap/lava_trench/outpost)
"bG" = (
/obj/effect/floor_decal/corner_oldtile/purple,
/obj/structure/table/steel,
/obj/item/xenoarch_multi_tool,
/turf/simulated/floor/tiled/old_tile,
/area/submap/lava_trench/outpost)
"bH" = (
/obj/effect/floor_decal/corner_oldtile/purple,
/turf/simulated/floor/tiled/old_tile,
/area/submap/lava_trench/outpost)
"bI" = (
/obj/item/gps/science{
	gps_tag = "CRYSTALS"
	},
/turf/simulated/floor/tiled/old_tile,
/area/submap/lava_trench/outpost)
"bK" = (
/obj/effect/floor_decal/corner_oldtile/blue/full,
/obj/random/drinkbottle,
/obj/random/maintenance/research,
/obj/structure/table/standard,
/obj/machinery/light/small/flicker{
	icon_state = "bulb1";
	dir = 8
	},
/turf/simulated/floor/tiled/old_tile,
/area/submap/lava_trench/outpost)
"bL" = (
/obj/structure/flora/pottedplant/crystal,
/obj/effect/floor_decal/corner_oldtile/blue{
	icon_state = "corner_oldtile";
	dir = 8
	},
/turf/simulated/floor/tiled/old_tile,
/area/submap/lava_trench/outpost)
"bM" = (
/obj/structure/cult/pylon,
/obj/effect/floor_decal/industrial/outline,
/turf/simulated/floor/tiled/old_tile/gray,
/area/submap/lava_trench/outpost)
"bN" = (
/obj/structure/anomaly_container,
/obj/machinery/artifact,
/turf/simulated/floor/outdoors/rocks/caves,
/area/submap/lava_trench)
"bO" = (
/obj/machinery/light/small/flicker{
	icon_state = "bulb1";
	dir = 4
	},
/turf/simulated/floor/tiled/old_tile,
/area/submap/lava_trench/outpost)
"bP" = (
/obj/effect/floor_decal/corner_oldtile/purple/full{
	icon_state = "corner_oldtile_full";
	dir = 4
	},
/obj/structure/table/steel,
/obj/machinery/recharger,
/obj/machinery/light/small/flicker{
	icon_state = "bulb1";
	dir = 4
	},
/turf/simulated/floor/tiled/old_tile,
/area/submap/lava_trench/outpost)
"bQ" = (
/obj/machinery/light/small/flicker{
	icon_state = "bulb1";
	dir = 8
	},
/turf/simulated/floor/outdoors/rocks/caves,
/area/submap/lava_trench)
"bR" = (
/obj/machinery/light/small/flicker{
	icon_state = "bulb1";
	dir = 1
	},
/turf/simulated/floor/outdoors/rocks/caves,
/area/submap/lava_trench)
"bS" = (
/obj/effect/floor_decal/corner_oldtile/blue{
	icon_state = "corner_oldtile";
	dir = 1
	},
/obj/structure/loot_pile/surface/medicine_cabinet{
	pixel_y = 28
	},
/obj/structure/table/standard,
/obj/item/healthanalyzer/improved,
/turf/simulated/floor/tiled/old_tile,
/area/submap/lava_trench/outpost)
"bT" = (
/obj/machinery/suspension_gen{
	anchored = 1
	},
/obj/effect/floor_decal/industrial/hatch/yellow,
/turf/simulated/floor/tiled/old_tile,
/area/submap/lava_trench/outpost)
"bU" = (
/obj/machinery/light/small/flicker,
/obj/structure/ore_box,
/turf/simulated/floor/tiled/asteroid_steel,
/area/submap/lava_trench)
"bW" = (
/obj/structure/anomaly_container,
/turf/simulated/floor/outdoors/rocks/caves,
/area/submap/lava_trench)
"bX" = (
/obj/effect/floor_decal/corner_oldtile/purple/full{
	icon_state = "corner_oldtile_full";
	dir = 4
	},
/obj/item/storage/box/samplebags,
/obj/structure/table/steel,
/obj/item/stack/flag/red,
/turf/simulated/floor/tiled/old_tile,
/area/submap/lava_trench/outpost)
"bY" = (
/obj/machinery/crystal,
/turf/simulated/floor/tiled/asteroid_steel,
/area/submap/lava_trench)
"bZ" = (
/obj/structure/table/steel,
/obj/item/stock_parts/subspace/crystal,
/turf/simulated/floor/tiled/asteroid_steel,
/area/submap/lava_trench)
"ca" = (
/obj/structure/table/steel,
/obj/item/stack/material/diamond,
/turf/simulated/floor/tiled/asteroid_steel,
/area/submap/lava_trench)
"cb" = (
/obj/structure/loot_pile/surface/bones,
/turf/simulated/floor/tiled/old_tile,
/area/submap/lava_trench/outpost)
"ce" = (
/obj/effect/floor_decal/corner_oldtile/blue/full,
/obj/structure/table/standard,
/turf/simulated/floor/tiled/old_tile,
/area/submap/lava_trench/outpost)
"ch" = (
/obj/structure/loot_pile/maint/trash,
/turf/simulated/floor/outdoors/rocks/caves,
/area/submap/lava_trench)
"cj" = (
/obj/item/clothing/head/bio_hood/anomaly,
/turf/simulated/floor/tiled/old_tile,
/area/submap/lava_trench/outpost)
"ck" = (
/obj/item/clothing/suit/bio_suit/anomaly,
/turf/simulated/floor/tiled/old_tile,
/area/submap/lava_trench/outpost)
"co" = (
/obj/machinery/floodlight,
/turf/simulated/floor/tiled/asteroid_steel,
/area/submap/lava_trench)
"cp" = (
/obj/machinery/light/small/flicker,
/obj/structure/closet/crate/secure/loot,
/turf/simulated/floor/tiled/asteroid_steel,
/area/submap/lava_trench)
"cq" = (
/obj/item/banner/nt,
/turf/simulated/floor/tiled/asteroid_steel,
/area/submap/lava_trench)
"cr" = (
/obj/structure/table/steel,
/obj/item/material/shard/phoron,
/turf/simulated/floor/tiled/asteroid_steel,
/area/submap/lava_trench)
"cs" = (
/obj/item/banner/nt,
/turf/simulated/floor/outdoors/rocks/caves,
/area/submap/lava_trench)

(1,1,1) = {"
aB
aB
aB
aB
af
af
af
aB
aB
aB
aB
aB
be
be
be
be
be
be
be
be
be
aa
aa
aa
aa
aa
aa
aa
aa
aa
"}
(2,1,1) = {"
aB
ab
al
am
ar
az
ar
aT
al
aV
aB
aB
aB
aB
aB
aB
aB
aB
aB
be
be
aa
aa
aa
aa
aa
aa
aa
aa
aa
"}
(3,1,1) = {"
ab
ae
af
af
af
af
af
af
af
aW
aV
aB
aB
aB
aB
aB
aB
aB
aB
be
be
be
aa
aa
aa
aa
aa
aa
aa
aa
"}
(4,1,1) = {"
ac
af
af
af
af
af
af
af
af
af
aW
al
al
al
al
al
aV
aB
aB
be
be
be
be
aa
aa
aa
aa
aa
aa
aa
"}
(5,1,1) = {"
ac
af
af
ba
an
aA
aF
af
af
af
af
af
af
af
af
af
bn
aB
aB
aB
aB
be
be
be
aa
aa
aa
aa
aa
aa
"}
(6,1,1) = {"
ac
af
af
an
at
au
aG
aF
af
aq
af
af
af
af
af
af
bn
aB
aB
aB
aB
aB
be
be
aa
aa
aa
aa
aa
aa
"}
(7,1,1) = {"
ac
af
af
ao
au
au
au
aU
af
af
af
af
af
af
af
af
aW
al
al
aV
aB
aB
be
be
aa
aa
aa
aa
aa
aa
"}
(8,1,1) = {"
ac
af
af
ao
au
au
au
aG
aF
af
af
af
af
af
af
af
af
af
af
bn
aB
aB
be
be
be
aa
aa
aa
aa
aa
"}
(9,1,1) = {"
ac
af
af
ao
au
au
au
au
aG
aF
af
af
bw
bw
bw
bw
af
af
af
bn
aB
aB
be
be
be
be
aa
aa
aa
aa
"}
(10,1,1) = {"
ac
af
af
ao
au
au
au
au
au
aU
af
af
bw
bx
bZ
bw
bw
af
af
bn
aB
aB
aB
aB
be
be
be
aa
aa
aa
"}
(11,1,1) = {"
ac
af
af
ap
av
au
au
au
af
af
af
af
bw
bE
ca
bw
bw
af
af
bn
aB
aB
aB
aB
aB
be
be
be
aa
aa
"}
(12,1,1) = {"
ac
af
af
af
ao
au
au
au
au
aU
af
af
bw
bY
cr
bw
bw
af
af
aW
al
al
aV
aB
aB
be
be
be
be
aa
"}
(13,1,1) = {"
ac
af
af
af
ao
au
au
au
au
aG
aF
af
bw
bw
bw
bw
bw
af
af
af
af
af
bn
aB
aB
aB
aB
be
be
be
"}
(14,1,1) = {"
ad
ag
af
af
ao
au
au
au
au
au
aU
af
af
bw
bw
bw
bw
af
aM
af
af
af
aW
al
al
aV
aB
aB
be
be
"}
(15,1,1) = {"
aB
ac
af
af
ao
au
au
au
au
au
aU
af
af
bw
bw
aJ
aO
aO
aO
aO
aO
af
af
af
af
bn
aB
aB
be
be
"}
(16,1,1) = {"
aB
ac
af
af
ao
au
au
af
au
au
aU
af
af
bw
cq
aO
aO
aR
bv
ce
aO
aO
af
af
af
bn
aB
aB
be
be
"}
(17,1,1) = {"
aB
ac
af
af
ao
au
au
au
au
au
aU
af
af
bw
bU
aO
aS
br
aQ
bB
bK
aO
ch
af
af
bn
aB
aB
be
be
"}
(18,1,1) = {"
aB
ac
af
af
ao
au
au
au
au
au
aU
af
af
bw
aJ
aO
bS
aQ
aQ
aQ
bL
aO
aO
af
af
bn
aB
aB
be
be
"}
(19,1,1) = {"
aB
ah
af
af
ap
av
au
au
au
aX
bc
af
af
bw
aO
aO
aO
bq
aQ
aQ
bz
bs
aO
af
af
bn
aB
aB
be
be
"}
(20,1,1) = {"
aC
ai
af
af
aw
aD
aH
aH
aH
aY
aw
af
af
bw
aN
bO
aN
aQ
aQ
bT
bs
bM
aO
bR
af
bn
aB
aB
be
be
"}
(21,1,1) = {"
aC
aj
af
af
ax
ax
ax
aI
aI
aI
ax
bw
bw
bw
aO
aO
aO
by
aQ
ck
bA
bs
aO
af
af
bn
aB
aB
be
be
"}
(22,1,1) = {"
aC
ai
af
af
ay
aE
aK
aK
aK
aZ
ay
af
bw
bw
co
aO
bd
cj
cb
aQ
bG
aO
aO
af
af
bn
aB
aB
be
be
"}
(23,1,1) = {"
aB
ak
af
af
af
ao
au
au
au
aG
aF
af
bw
bw
cp
aO
bo
bt
bI
bH
bP
aO
bN
af
af
bn
aB
aB
be
be
"}
(24,1,1) = {"
aB
ac
af
aq
af
ao
au
au
au
au
aU
af
bw
af
cs
aO
aO
bC
bF
bX
aO
aO
bW
af
af
bn
aB
aB
aB
be
"}
(25,1,1) = {"
aB
ad
ag
af
af
ao
au
au
af
au
aU
bf
bk
af
af
af
aO
aO
aO
aO
aO
bN
af
af
af
bn
aB
aB
aB
aB
"}
(26,1,1) = {"
aB
aB
ac
af
af
ao
au
au
au
au
aG
bg
bk
af
aq
af
af
af
bQ
af
af
af
af
af
af
aW
al
aV
aB
aB
"}
(27,1,1) = {"
aB
aB
ac
af
af
ao
au
au
au
au
au
bh
bl
aA
aA
aF
af
af
af
af
af
af
af
af
af
af
af
bn
aB
aB
"}
(28,1,1) = {"
aB
aB
ac
af
af
ao
au
au
af
au
au
bi
bl
bD
au
aG
aA
aA
aF
af
af
af
af
af
af
af
af
aW
aV
aB
"}
(29,1,1) = {"
aB
aB
ac
af
af
ao
au
au
af
af
au
bi
bl
bD
au
au
au
au
aG
aA
aA
af
aA
aA
aF
af
af
af
aW
aV
"}
(30,1,1) = {"
aB
aB
ac
af
af
ap
av
au
au
ba
au
bi
bl
bD
au
au
au
au
au
au
au
af
au
au
aG
aF
af
af
af
bn
"}
(31,1,1) = {"
aB
aB
ac
af
af
af
ap
av
au
au
au
bi
bl
bD
au
af
au
au
au
au
au
au
au
au
au
aG
aF
af
af
bn
"}
(32,1,1) = {"
aB
aB
ac
af
af
af
af
ap
av
au
au
bi
bl
bD
au
au
au
au
au
af
af
af
au
au
au
au
aU
af
af
bn
"}
(33,1,1) = {"
aB
aB
ad
ag
af
af
af
af
ap
bb
bb
bj
bl
av
au
au
au
au
au
au
ba
af
af
au
au
au
aU
af
af
bn
"}
(34,1,1) = {"
aB
aB
aB
ad
ag
af
af
af
af
af
af
bf
bk
ap
bb
bb
av
au
au
au
au
au
au
au
au
au
aU
af
af
ah
"}
(35,1,1) = {"
be
aB
aB
aB
ad
ag
af
af
af
af
af
bf
bk
af
af
af
ap
av
au
au
au
au
au
au
au
au
aU
af
af
ai
"}
(36,1,1) = {"
be
be
aB
aB
aB
ad
aL
aL
ag
af
af
af
af
af
af
af
af
ap
bb
bb
bb
bb
bb
av
au
au
aU
af
af
aj
"}
(37,1,1) = {"
be
be
be
aB
aB
aB
aB
aB
ac
af
af
af
af
af
af
aq
af
af
af
af
af
af
af
ap
bb
bb
bc
af
af
ai
"}
(38,1,1) = {"
aa
be
be
be
aB
aB
aB
aB
ac
af
af
ba
af
af
af
bp
af
af
af
af
af
af
af
af
af
af
af
af
af
ak
"}
(39,1,1) = {"
aa
aa
be
be
be
be
aB
aB
ad
ag
af
af
af
af
af
af
af
af
af
af
ba
af
af
af
af
af
af
af
af
bn
"}
(40,1,1) = {"
aa
aa
aa
be
be
be
aB
aB
aB
ac
af
af
af
af
af
af
af
ba
af
af
af
af
bu
aL
aL
aL
aL
aL
aL
as
"}
(41,1,1) = {"
aa
aa
aa
aa
be
be
be
aB
aB
ac
af
af
af
af
af
af
af
af
af
af
af
af
bn
aB
aB
aB
aB
aB
aB
aB
"}
(42,1,1) = {"
aa
aa
aa
aa
aa
be
be
aB
aB
ac
af
af
af
af
af
af
af
af
af
af
af
bu
as
aB
aB
aB
aB
aB
aB
aB
"}
(43,1,1) = {"
aa
aa
aa
aa
aa
be
be
aB
aB
ad
am
ar
bm
ar
aT
aL
aL
aL
aL
aL
aL
as
aB
aB
aB
be
be
be
be
be
"}
(44,1,1) = {"
aa
aa
aa
aa
aa
be
be
aB
aB
aB
aB
af
af
af
af
af
aB
aB
aB
aB
aB
aB
aB
aB
be
be
be
be
be
be
"}
(45,1,1) = {"
aa
aa
aa
aa
aa
be
be
aB
aB
aB
aB
aB
aB
aB
aB
aB
aB
aB
aB
aB
aB
aB
aB
be
be
be
aa
aa
aa
aa
"}
(46,1,1) = {"
aa
aa
aa
aa
aa
be
be
be
be
aB
aB
aB
aB
aB
aB
aB
aB
be
be
be
be
be
be
be
be
aa
aa
aa
aa
aa
"}
(47,1,1) = {"
aa
aa
aa
aa
aa
aa
be
be
be
aB
aB
aB
aB
aB
aB
aB
aB
aB
be
be
be
be
be
be
aa
aa
aa
aa
aa
aa
"}
(48,1,1) = {"
aa
aa
aa
aa
aa
aa
aa
aa
aa
aB
aB
aB
aB
aB
aB
aB
aB
aB
be
aa
aa
aa
aa
aa
aa
aa
aa
aa
aa
aa
"}
