"a" = (/turf/template_noop,/area/template_noop)
"b" = (/turf/simulated/mineral/ignore_mapgen,/area/submap/cave/Scave1)
"c" = (/obj/effect/spider/stickyweb,/turf/simulated/mineral/floor/ignore_mapgen,/area/submap/cave/Scave1)
"d" = (/turf/simulated/mineral/floor/ignore_mapgen,/area/submap/cave/Scave1)
"e" = (/obj/effect/spider/spiderling/frost,/turf/simulated/mineral/floor/ignore_mapgen,/area/submap/cave/Scave1)
"f" = (/obj/item/spacecash/c100,/obj/item/spacecash/c100,/turf/simulated/mineral/floor/ignore_mapgen,/area/submap/cave/Scave1)
"g" = (/obj/random/mob/spider/mutant,/turf/simulated/mineral/floor/ignore_mapgen,/area/submap/cave/Scave1)
"h" = (/obj/item/spacecash/c100,/obj/item/spacecash/c100,/obj/item/spacecash/c100,/obj/effect/decal/remains,/turf/simulated/mineral/floor/ignore_mapgen,/area/submap/cave/Scave1)
"i" = (/obj/random/mob/spider,/turf/simulated/mineral/floor/ignore_mapgen,/area/submap/cave/Scave1)
"j" = (/obj/item/grenade/spawnergrenade/spider,/turf/simulated/mineral/floor/ignore_mapgen,/area/submap/cave/Scave1)
"k" = (/obj/random/toolbox,/turf/simulated/mineral/floor/ignore_mapgen,/area/submap/cave/Scave1)
"l" = (/obj/effect/decal/mecha_wreckage/ripley,/turf/simulated/mineral/floor/ignore_mapgen,/area/submap/cave/Scave1)
"m" = (/obj/item/mecha_parts/mecha_equipment/tool/drill/diamonddrill,/turf/simulated/mineral/floor/ignore_mapgen,/area/submap/cave/Scave1)
"n" = (/obj/item/flashlight,/turf/simulated/mineral/floor/ignore_mapgen,/area/submap/cave/Scave1)
"o" = (/mob/living/simple_mob/animal/giant_spider/frost,/turf/simulated/mineral/floor/ignore_mapgen,/area/submap/cave/Scave1)
"p" = (/obj/effect/spider/stickyweb,/obj/effect/spider/stickyweb,/turf/simulated/mineral/floor/ignore_mapgen,/area/submap/cave/Scave1)
"q" = (/obj/effect/decal/remains,/turf/simulated/mineral/floor/ignore_mapgen,/area/submap/cave/Scave1)

(1,1,1) = {"
aaaaaaaaaaaaaaaaaaaaaaaaaaaaaa
aaaaabbaaaaaaaaaaaaaaaaaaaaaaa
aabbbbbbaabbbbbaaaaaaabbbbbaaa
abbbbbbbbbbbbbbbbbbbbbbbbbbaaa
aabbbbbbcbbbbbbbbbbbbbbbdbbbaa
aabbbbdeddbbbcccbbbbbdddeddbaa
aadbbfddddcbbdedbbbbbdgddddbaa
aadbbhfbbiddddddbccedddbdedbba
aabbbbbbbddcdddddddddddbjgbbaa
aabbbbbbdddbbbkcddddddbbbbbbaa
aabbbbbcdddbbbbbbcddddcbbbbaaa
aabbbbbcddcbbbbbbbdiddcbbbaaaa
aabbbbbbgdcbbbbbbbddddcbbbaaaa
aabbbbbbdddbbbbbblddddcbbbaaaa
aabbbbbbdcdbbbbbbmddgdcbbbaaaa
aabbbbbbdddbbbbbbcddddcbbbaaaa
aadbbbbbdddbbbbbbbccdddbbbaaaa
aandbbbbddbbbbbbbbbocddbbbaaaa
aaddbbbbdddbbbbbbbbbbddbbdaaaa
aadddpddedddbbbbbbbbdedbbdaaaa
aaddppcdddgddcbcdddddcbbbdaaaa
aaqdbbbbbdddddddddddcbbbbdaaaa
aabbbbbbbbcdddcdddddcbbbbbaaaa
aabbbbbbbbbbbbbbbgbbbbbbbbaaaa
aabbbbbbbbbbbbbbbbbbbbbbbbaaaa
aaaaabbbbabbbbbbbaabbbbbbaaaaa
aaaaaaaaaaaaaaaaaaaaaaaaaaaaaa
"}