//MAP CONVERTED BY dmm2tgm.py THIS HEADER COMMENT PREVENTS RECONVERSION, DO NOT REMOVE
"a" = (
/turf/template_noop,
/area/template_noop)
"b" = (
/turf/simulated/mineral/ignore_mapgen,
/area/submap/cave/Scave1)
"c" = (
/obj/effect/spider/stickyweb,
/turf/simulated/mineral/floor/ignore_mapgen,
/area/submap/cave/Scave1)
"d" = (
/turf/simulated/mineral/floor/ignore_mapgen,
/area/submap/cave/Scave1)
"e" = (
/obj/effect/spider/spiderling/frost,
/turf/simulated/mineral/floor/ignore_mapgen,
/area/submap/cave/Scave1)
"f" = (
/obj/item/weapon/spacecash/c100,
/obj/item/weapon/spacecash/c100,
/turf/simulated/mineral/floor/ignore_mapgen,
/area/submap/cave/Scave1)
"g" = (
/obj/item/weapon/spacecash/c100,
/obj/item/weapon/spacecash/c100,
/obj/item/weapon/spacecash/c100,
/obj/effect/decal/remains,
/turf/simulated/mineral/floor/ignore_mapgen,
/area/submap/cave/Scave1)
"h" = (
/obj/item/weapon/grenade/spawnergrenade/spider,
/turf/simulated/mineral/floor/ignore_mapgen,
/area/submap/cave/Scave1)
"i" = (
/mob/living/simple_animal/hostile/giant_spider/frost,
/turf/simulated/mineral/floor/ignore_mapgen,
/area/submap/cave/Scave1)
"j" = (
/obj/random/toolbox,
/turf/simulated/mineral/floor/ignore_mapgen,
/area/submap/cave/Scave1)
"k" = (
/obj/effect/decal/mecha_wreckage/ripley,
/turf/simulated/mineral/floor/ignore_mapgen,
/area/submap/cave/Scave1)
"l" = (
/obj/item/mecha_parts/mecha_equipment/tool/drill/diamonddrill,
/turf/simulated/mineral/floor/ignore_mapgen,
/area/submap/cave/Scave1)
"m" = (
/obj/item/device/flashlight,
/turf/simulated/mineral/floor/ignore_mapgen,
/area/submap/cave/Scave1)
"n" = (
/obj/effect/spider/stickyweb,
/obj/effect/spider/stickyweb,
/turf/simulated/mineral/floor/ignore_mapgen,
/area/submap/cave/Scave1)
"p" = (
/obj/effect/decal/remains,
/turf/simulated/mineral/floor/ignore_mapgen,
/area/submap/cave/Scave1)
"B" = (
/obj/random/mob/spider/mutant,
/turf/simulated/mineral/floor/ignore_mapgen,
/area/submap/cave/Scave1)
"O" = (
/obj/random/mob/spider,
/turf/simulated/mineral/floor/ignore_mapgen,
/area/submap/cave/Scave1)

(1,1,1) = {"
a
a
a
a
a
a
a
a
a
a
a
a
a
a
a
a
a
a
a
a
a
a
a
a
a
a
a
"}
(2,1,1) = {"
a
a
a
b
a
a
a
a
a
a
a
a
a
a
a
a
a
a
a
a
a
a
a
a
a
a
a
"}
(3,1,1) = {"
a
a
b
b
b
b
d
d
b
b
b
b
b
b
b
b
d
m
d
d
d
p
b
b
b
a
a
"}
(4,1,1) = {"
a
a
b
b
b
b
b
b
b
b
b
b
b
b
b
b
b
d
d
d
d
d
b
b
b
a
a
"}
(5,1,1) = {"
a
a
b
b
b
b
b
b
b
b
b
b
b
b
b
b
b
b
b
d
n
b
b
b
b
a
a
"}
(6,1,1) = {"
a
b
b
b
b
b
f
g
b
b
b
b
b
b
b
b
b
b
b
n
n
b
b
b
b
b
a
"}
(7,1,1) = {"
a
b
b
b
b
d
d
f
b
b
b
b
b
b
b
b
b
b
b
d
c
b
b
b
b
b
a
"}
(8,1,1) = {"
a
a
b
b
b
e
d
b
b
b
c
c
b
b
b
b
b
b
b
d
d
b
b
b
b
b
a
"}
(9,1,1) = {"
a
a
a
b
c
d
d
b
b
d
d
d
B
d
d
d
d
d
d
e
d
b
b
b
b
b
a
"}
(10,1,1) = {"
a
a
a
b
b
d
d
O
d
d
d
d
d
d
c
d
d
d
d
d
d
d
b
b
b
a
a
"}
(11,1,1) = {"
a
a
b
b
b
b
c
d
d
d
d
c
c
d
d
d
d
b
d
d
B
d
c
b
b
b
a
"}
(12,1,1) = {"
a
a
b
b
b
b
b
d
c
b
b
b
b
b
b
b
b
b
b
d
d
d
d
b
b
b
a
"}
(13,1,1) = {"
a
a
b
b
b
b
b
d
d
b
b
b
b
b
b
b
b
b
b
b
d
d
d
b
b
b
a
"}
(14,1,1) = {"
a
a
b
b
b
c
d
d
d
b
b
b
b
b
b
b
b
b
b
b
c
d
d
b
b
b
a
"}
(15,1,1) = {"
a
a
b
b
b
c
e
d
d
j
b
b
b
b
b
b
b
b
b
b
b
d
c
b
b
b
a
"}
(16,1,1) = {"
a
a
a
b
b
c
d
d
d
c
b
b
b
b
b
b
b
b
b
b
c
d
d
b
b
b
a
"}
(17,1,1) = {"
a
a
a
b
b
b
b
b
d
d
b
b
b
b
b
b
b
b
b
b
d
d
d
b
b
b
a
"}
(18,1,1) = {"
a
a
a
b
b
b
b
c
d
d
c
b
b
k
l
c
b
b
b
b
d
d
d
B
b
a
a
"}
(19,1,1) = {"
a
a
a
b
b
b
b
c
d
d
d
d
d
d
d
d
c
b
b
b
d
d
d
b
b
a
a
"}
(20,1,1) = {"
a
a
a
b
b
b
b
e
d
d
d
O
d
d
d
d
c
i
b
b
d
d
d
b
b
b
a
"}
(21,1,1) = {"
a
a
a
b
b
b
b
d
d
d
d
d
d
d
B
d
d
c
b
d
d
c
c
b
b
b
a
"}
(22,1,1) = {"
a
a
a
b
b
d
d
d
d
d
d
d
d
d
d
d
d
d
d
e
c
b
b
b
b
b
a
"}
(23,1,1) = {"
a
a
b
b
b
d
B
d
d
b
c
c
c
c
c
c
d
d
d
d
b
b
b
b
b
b
a
"}
(24,1,1) = {"
a
a
b
b
b
d
d
b
b
b
b
b
b
b
b
b
b
b
b
b
b
b
b
b
b
b
a
"}
(25,1,1) = {"
a
a
b
b
d
e
d
d
h
b
b
b
b
b
b
b
b
b
b
b
b
b
b
b
b
b
a
"}
(26,1,1) = {"
a
a
b
b
b
d
d
e
B
b
b
b
b
b
b
b
b
b
d
d
d
d
b
b
b
a
a
"}
(27,1,1) = {"
a
a
b
b
b
d
d
d
b
b
b
a
a
a
a
a
a
a
a
a
a
a
a
a
a
a
a
"}
(28,1,1) = {"
a
a
a
a
b
b
b
b
b
b
a
a
a
a
a
a
a
a
a
a
a
a
a
a
a
a
a
"}
(29,1,1) = {"
a
a
a
a
a
a
a
b
a
a
a
a
a
a
a
a
a
a
a
a
a
a
a
a
a
a
a
"}
(30,1,1) = {"
a
a
a
a
a
a
a
a
a
a
a
a
a
a
a
a
a
a
a
a
a
a
a
a
a
a
a
"}
