//MAP CONVERTED BY dmm2tgm.py THIS HEADER COMMENT PREVENTS RECONVERSION, DO NOT REMOVE
"a" = (
/turf/simulated/wall/solidrock,
/area/submap/spatial_anomaly)
"b" = (
/turf/simulated/floor/outdoors/rocks/caves,
/area/submap/spatial_anomaly)
"c" = (
/obj/effect/map_effect/portal/master/side_a{
	dir = 4;
	icon_state = "portal_side_a";
	portal_id = "spatial_anomaly_5"
	},
/obj/effect/map_effect/perma_light/brighter{
	light_color = "#ff00ff"
	},
/turf/simulated/floor/outdoors/rocks/caves,
/area/submap/spatial_anomaly)
"d" = (
/obj/effect/map_effect/portal/master/side_b{
	dir = 8;
	icon_state = "portal_side_b";
	portal_id = "spatial_anomaly_5"
	},
/obj/effect/map_effect/perma_light/brighter{
	light_color = "#ff00ff"
	},
/turf/simulated/floor/outdoors/rocks/caves,
/area/submap/spatial_anomaly)
"e" = (
/obj/structure/barricade,
/turf/simulated/floor/outdoors/rocks/caves,
/area/submap/spatial_anomaly)
"f" = (
/turf/template_noop,
/area/template_noop)
"g" = (
/obj/effect/map_effect/portal/master/side_b{
	portal_id = "spatial_anomaly_4"
	},
/obj/effect/map_effect/perma_light/brighter{
	light_color = "#ff00ff"
	},
/turf/simulated/floor/outdoors/rocks/caves,
/area/submap/spatial_anomaly)
"h" = (
/obj/effect/map_effect/portal/line/side_a{
	icon_state = "portal_line_side_a";
	dir = 4
	},
/obj/effect/map_effect/perma_light/brighter{
	light_color = "#ff00ff"
	},
/turf/simulated/floor/outdoors/rocks/caves,
/area/submap/spatial_anomaly)
"i" = (
/obj/effect/map_effect/portal/line/side_b{
	icon_state = "portal_line_side_b";
	dir = 8
	},
/obj/effect/map_effect/perma_light/brighter{
	light_color = "#ff00ff"
	},
/turf/simulated/floor/outdoors/rocks/caves,
/area/submap/spatial_anomaly)
"j" = (
/turf/simulated/floor/lava,
/area/submap/spatial_anomaly)
"k" = (
/obj/item/disposable_teleporter/slime,
/turf/simulated/floor/outdoors/rocks/caves,
/area/submap/spatial_anomaly)
"l" = (
/obj/effect/map_effect/perma_light/brighter{
	light_color = "#ff00ff"
	},
/turf/simulated/floor/outdoors/rocks/caves,
/area/submap/spatial_anomaly)
"m" = (
/obj/effect/map_effect/perma_light/brighter{
	light_color = "#ff00ff"
	},
/turf/simulated/floor/plating/external,
/area/submap/spatial_anomaly)
"n" = (
/obj/effect/map_effect/portal/master/side_a{
	dir = 4;
	icon_state = "portal_side_a";
	portal_id = "spatial_anomaly_3"
	},
/obj/effect/map_effect/perma_light/brighter{
	light_color = "#ff00ff"
	},
/turf/simulated/floor/outdoors/rocks/caves,
/area/submap/spatial_anomaly)
"o" = (
/obj/effect/map_effect/portal/master/side_a{
	dir = 1;
	icon_state = "portal_side_a";
	portal_id = "spatial_anomaly_4"
	},
/obj/effect/map_effect/perma_light/brighter{
	light_color = "#ff00ff"
	},
/turf/simulated/floor/outdoors/rocks/caves,
/area/submap/spatial_anomaly)
"p" = (
/obj/effect/map_effect/portal/master/side_b{
	dir = 8;
	icon_state = "portal_side_b";
	portal_id = "spatial_anomaly_3"
	},
/obj/effect/map_effect/perma_light/brighter{
	light_color = "#ff00ff"
	},
/turf/simulated/floor/outdoors/rocks/caves,
/area/submap/spatial_anomaly)
"q" = (
/obj/effect/map_effect/portal/master/side_b{
	portal_id = "spatial_anomaly_2"
	},
/obj/effect/map_effect/perma_light/brighter{
	light_color = "#ff00ff"
	},
/turf/simulated/floor/outdoors/rocks/caves,
/area/submap/spatial_anomaly)
"r" = (
/obj/effect/map_effect/portal/line/side_b,
/obj/effect/map_effect/perma_light/brighter{
	light_color = "#ff00ff"
	},
/turf/simulated/floor/outdoors/rocks/caves,
/area/submap/spatial_anomaly)
"s" = (
/obj/machinery/crystal/lava,
/turf/simulated/floor/lava,
/area/submap/spatial_anomaly)
"t" = (
/turf/simulated/floor/plating/external,
/area/submap/spatial_anomaly)
"u" = (
/obj/effect/map_effect/portal/master/side_a{
	portal_id = "spatial_anomaly_1"
	},
/obj/effect/map_effect/perma_light/brighter{
	light_color = "#ff00ff"
	},
/turf/simulated/floor/outdoors/rocks/caves,
/area/submap/spatial_anomaly)
"v" = (
/obj/item/stool/padded,
/turf/simulated/floor/plating/external,
/area/submap/spatial_anomaly)
"w" = (
/obj/structure/table/steel_reinforced,
/obj/item/xenoarch_multi_tool,
/turf/simulated/floor/plating/external,
/area/submap/spatial_anomaly)
"x" = (
/turf/simulated/wall/solidrock,
/area/template_noop)
"y" = (
/obj/random/technology_scanner,
/turf/simulated/floor/outdoors/rocks/caves,
/area/submap/spatial_anomaly)
"z" = (
/obj/structure/table/steel_reinforced,
/obj/random/unidentified_medicine/scientific,
/turf/simulated/floor/plating/external,
/area/submap/spatial_anomaly)
"A" = (
/obj/structure/table/steel_reinforced,
/obj/random/tool/power,
/turf/simulated/floor/plating/external,
/area/submap/spatial_anomaly)
"B" = (
/obj/structure/table/steel_reinforced,
/obj/item/ore/diamond,
/turf/simulated/floor/plating/external,
/area/submap/spatial_anomaly)
"C" = (
/obj/structure/sign/warning/lava,
/turf/simulated/wall,
/area/submap/spatial_anomaly)
"D" = (
/obj/effect/map_effect/portal/line/side_a,
/obj/effect/map_effect/perma_light/brighter{
	light_color = "#ff00ff"
	},
/turf/simulated/floor/outdoors/rocks/caves,
/area/submap/spatial_anomaly)
"E" = (
/obj/structure/table/rack,
/obj/item/pickaxe/jackhammer,
/turf/simulated/floor/outdoors/rocks/caves,
/area/submap/spatial_anomaly)
"F" = (
/obj/effect/map_effect/portal/master/side_a{
	dir = 1;
	icon_state = "portal_side_a";
	portal_id = "spatial_anomaly_2"
	},
/obj/effect/map_effect/perma_light/brighter{
	light_color = "#ff00ff"
	},
/turf/simulated/floor/outdoors/rocks/caves,
/area/submap/spatial_anomaly)
"G" = (
/obj/effect/map_effect/portal/line/side_a{
	icon_state = "portal_line_side_a";
	dir = 1
	},
/obj/effect/map_effect/perma_light/brighter{
	light_color = "#ff00ff"
	},
/turf/simulated/floor/outdoors/rocks/caves,
/area/submap/spatial_anomaly)
"H" = (
/turf/unsimulated/wall,
/area/template_noop)
"I" = (
/obj/effect/map_effect/portal/master/side_b{
	dir = 1;
	icon_state = "portal_side_b";
	portal_id = "spatial_anomaly_1"
	},
/obj/effect/map_effect/perma_light/brighter{
	light_color = "#ff00ff"
	},
/turf/simulated/floor/outdoors/rocks/caves,
/area/submap/spatial_anomaly)
"J" = (
/obj/effect/map_effect/portal/line/side_b{
	icon_state = "portal_line_side_b";
	dir = 1
	},
/obj/effect/map_effect/perma_light/brighter{
	light_color = "#ff00ff"
	},
/turf/simulated/floor/outdoors/rocks/caves,
/area/submap/spatial_anomaly)
"K" = (
/obj/item/mining_scanner,
/obj/structure/table/rack,
/turf/simulated/floor/outdoors/rocks/caves,
/area/submap/spatial_anomaly)
"L" = (
/obj/item/storage/belt/archaeology,
/obj/effect/decal/remains/human,
/turf/simulated/floor/outdoors/rocks/caves,
/area/submap/spatial_anomaly)
"M" = (
/obj/structure/bookcase/manuals/xenoarchaeology,
/turf/simulated/floor/plating/external,
/area/submap/spatial_anomaly)
"N" = (
/obj/item/pickaxe/brush,
/turf/simulated/floor/outdoors/rocks/caves,
/area/submap/spatial_anomaly)
"O" = (
/obj/item/pickaxe/one_pick,
/turf/simulated/floor/outdoors/rocks/caves,
/area/submap/spatial_anomaly)
"P" = (
/obj/item/pickaxe/four_pick,
/turf/simulated/floor/outdoors/rocks/caves,
/area/submap/spatial_anomaly)
"Q" = (
/obj/effect/decal/remains/human,
/turf/simulated/floor/plating/external,
/area/submap/spatial_anomaly)
"R" = (
/obj/item/pickaxe/five_pick,
/turf/simulated/floor/outdoors/rocks/caves,
/area/submap/spatial_anomaly)
"S" = (
/obj/item/pickaxe/six_pick,
/turf/simulated/floor/outdoors/rocks/caves,
/area/submap/spatial_anomaly)
"T" = (
/obj/item/pickaxe/two_pick,
/turf/simulated/floor/outdoors/rocks/caves,
/area/submap/spatial_anomaly)
"U" = (
/obj/item/measuring_tape,
/turf/simulated/floor/outdoors/rocks/caves,
/area/submap/spatial_anomaly)
"X" = (
/obj/item/pickaxe/three_pick,
/turf/simulated/floor/outdoors/rocks/caves,
/area/submap/spatial_anomaly)
"Y" = (
/obj/item/pickaxe/excavationdrill,
/turf/simulated/floor/plating/external,
/area/submap/spatial_anomaly)

(1,1,1) = {"
f
f
f
f
f
f
f
f
f
f
f
f
f
f
f
f
f
f
f
f
f
f
f
f
f
f
f
f
f
f
"}
(2,1,1) = {"
f
f
f
f
f
f
f
f
f
f
f
f
f
f
f
f
f
f
f
f
f
f
f
f
f
f
f
f
f
f
"}
(3,1,1) = {"
f
f
f
f
f
f
f
f
x
a
a
a
a
a
x
x
x
x
f
f
f
f
f
f
f
f
f
f
f
f
"}
(4,1,1) = {"
f
f
f
f
f
x
a
a
a
a
a
a
a
a
a
a
a
a
a
a
f
f
f
f
f
f
f
f
f
f
"}
(5,1,1) = {"
f
f
f
x
a
a
a
a
a
a
a
l
b
b
b
b
b
a
a
a
a
a
a
a
f
f
f
f
f
f
"}
(6,1,1) = {"
f
f
x
a
a
a
a
a
a
a
a
b
a
a
a
a
R
a
a
a
a
a
a
a
a
a
a
f
f
f
"}
(7,1,1) = {"
f
f
x
a
t
g
b
O
b
a
a
b
a
a
a
a
b
a
a
a
b
T
b
I
t
a
a
f
f
f
"}
(8,1,1) = {"
f
f
x
a
a
a
a
b
b
a
a
b
a
a
a
a
p
a
a
l
b
b
b
J
t
a
a
f
f
f
"}
(9,1,1) = {"
f
f
x
a
a
a
a
a
b
a
a
b
a
a
a
a
t
a
a
b
a
b
b
J
t
a
a
f
f
f
"}
(10,1,1) = {"
f
f
x
a
t
t
a
a
l
a
a
b
b
b
o
t
a
a
a
b
a
a
a
a
a
a
f
f
f
f
"}
(11,1,1) = {"
f
f
x
a
c
h
a
a
b
a
a
a
a
a
a
a
a
a
a
b
b
b
b
b
a
a
f
f
f
f
"}
(12,1,1) = {"
f
f
x
a
b
b
a
a
b
b
t
a
a
a
a
a
a
a
a
a
a
X
b
l
a
a
a
f
f
f
"}
(13,1,1) = {"
f
f
x
a
b
b
a
b
b
b
t
t
B
a
a
t
q
b
b
b
b
b
b
b
a
a
a
f
f
f
"}
(14,1,1) = {"
f
x
a
a
b
b
b
b
y
b
t
v
w
a
a
t
r
b
b
b
a
a
a
a
a
a
a
f
f
f
"}
(15,1,1) = {"
f
x
a
a
b
b
C
N
b
t
t
t
z
a
a
t
r
b
b
b
b
b
b
b
a
a
a
f
f
f
"}
(16,1,1) = {"
f
x
a
a
j
b
b
b
b
m
t
Q
A
a
a
a
a
a
a
a
b
b
b
t
a
a
a
f
f
f
"}
(17,1,1) = {"
f
x
a
a
j
j
b
b
a
a
a
a
a
a
a
a
a
a
a
a
b
L
m
t
a
a
a
f
f
f
"}
(18,1,1) = {"
f
x
a
a
j
j
s
a
a
a
a
a
a
a
b
b
b
b
b
b
b
b
t
t
a
a
a
f
f
f
"}
(19,1,1) = {"
f
x
a
a
s
j
a
a
b
b
b
l
b
b
b
b
S
b
l
b
b
Y
t
M
a
a
a
f
f
f
"}
(20,1,1) = {"
f
f
x
a
j
j
a
a
P
b
a
a
a
a
a
a
a
a
a
a
a
a
a
a
a
a
f
f
f
f
"}
(21,1,1) = {"
f
f
x
a
k
b
a
a
b
a
a
a
a
t
a
a
a
a
a
a
a
a
a
a
a
a
f
f
f
f
"}
(22,1,1) = {"
f
f
x
a
b
b
a
a
b
a
a
a
a
n
a
a
t
u
b
b
U
b
F
t
a
a
f
f
f
f
"}
(23,1,1) = {"
f
f
x
a
d
i
a
a
b
a
a
a
a
b
a
a
t
D
b
b
b
b
G
t
a
a
f
f
f
f
"}
(24,1,1) = {"
f
f
x
a
t
t
a
a
l
b
b
b
b
b
a
a
t
D
b
b
b
b
G
t
a
a
f
f
f
f
"}
(25,1,1) = {"
f
f
f
x
a
a
a
a
a
a
a
a
a
a
a
a
a
a
a
b
b
a
a
a
a
f
f
f
f
f
"}
(26,1,1) = {"
f
f
f
f
x
a
a
a
a
a
a
a
a
a
a
a
a
b
e
l
E
a
a
a
f
f
f
f
f
f
"}
(27,1,1) = {"
f
f
f
f
f
f
f
x
a
a
a
a
f
H
f
f
H
l
e
b
K
a
a
f
f
f
f
f
f
f
"}
(28,1,1) = {"
f
f
f
f
f
f
f
f
f
f
f
f
f
H
f
f
H
b
a
a
a
a
f
f
f
f
f
f
f
f
"}
(29,1,1) = {"
f
f
f
f
f
f
f
f
f
f
f
f
f
H
H
H
a
a
a
a
f
f
f
f
f
f
f
f
f
f
"}
(30,1,1) = {"
f
f
f
f
f
f
f
f
f
f
f
f
f
f
f
f
f
f
f
f
f
f
f
f
f
f
f
f
f
f
"}
