//MAP CONVERTED BY dmm2tgm.py THIS HEADER COMMENT PREVENTS RECONVERSION, DO NOT REMOVE
"a" = (
/turf/template_noop,
/area/submap/AbandonedTemple)
"b" = (
/turf/simulated/mineral/floor/cave,
/area/submap/AbandonedTemple)
"c" = (
/turf/simulated/floor/tiled/asteroid_steel,
/area/submap/AbandonedTemple)
"d" = (
/turf/simulated/wall/sandstone,
/area/submap/AbandonedTemple)
"e" = (
/obj/effect/decal/cleanable/cobweb,
/turf/simulated/floor/carpet/turcarpet,
/area/submap/AbandonedTemple)
"f" = (
/obj/effect/decal/remains/mummy1,
/turf/simulated/floor/carpet/turcarpet,
/area/submap/AbandonedTemple)
"g" = (
/turf/simulated/wall/sandstonediamond,
/area/submap/AbandonedTemple)
"h" = (
/obj/item/flame/candle/everburn,
/turf/simulated/floor/tiled/asteroid_steel,
/area/submap/AbandonedTemple)
"i" = (
/obj/item/ectoplasm,
/turf/simulated/floor/tiled/asteroid_steel,
/area/submap/AbandonedTemple)
"j" = (
/obj/structure/table/wooden_reinforced,
/obj/item/coin/iron,
/obj/item/coin/platinum,
/obj/item/coin/uranium,
/obj/item/coin/diamond,
/obj/item/coin/iron,
/obj/item/coin/uranium,
/obj/item/coin/iron,
/obj/item/coin/phoron,
/obj/item/coin/platinum,
/obj/effect/decal/cleanable/cobweb,
/turf/simulated/floor/tiled/asteroid_steel,
/area/submap/AbandonedTemple)
"k" = (
/obj/structure/table/wooden_reinforced,
/obj/item/coin/gold,
/obj/item/coin/gold,
/obj/item/coin/gold,
/obj/item/coin/silver,
/obj/item/coin/silver,
/obj/item/coin/silver,
/obj/item/coin/gold,
/obj/item/coin/gold,
/obj/item/coin/gold,
/obj/item/coin/silver,
/obj/item/coin/silver,
/obj/item/coin/silver,
/turf/simulated/floor/tiled/asteroid_steel,
/area/submap/AbandonedTemple)
"l" = (
/obj/effect/decal/remains/xeno,
/turf/simulated/floor/tiled/asteroid_steel,
/area/submap/AbandonedTemple)
"m" = (
/obj/effect/decal/cleanable/cobweb2,
/turf/simulated/floor/tiled/asteroid_steel,
/area/submap/AbandonedTemple)
"n" = (
/obj/structure/loot_pile/maint/technical,
/turf/simulated/floor/tiled/asteroid_steel,
/area/submap/AbandonedTemple)
"o" = (
/obj/structure/loot_pile/maint/technical,
/obj/effect/decal/cleanable/cobweb2,
/turf/simulated/floor/tiled/asteroid_steel,
/area/submap/AbandonedTemple)
"p" = (
/turf/simulated/floor/carpet/turcarpet,
/area/submap/AbandonedTemple)
"q" = (
/obj/structure/table/woodentable,
/obj/item/flame/lighter/zippo/royal,
/obj/item/clothing/mask/smokable/pipe,
/turf/simulated/floor/carpet/turcarpet,
/area/submap/AbandonedTemple)
"r" = (
/obj/effect/rune,
/obj/effect/decal/remains/human,
/turf/simulated/floor/tiled/asteroid_steel,
/area/submap/AbandonedTemple)
"s" = (
/obj/effect/decal/cleanable/blood,
/turf/simulated/floor/tiled/asteroid_steel,
/area/submap/AbandonedTemple)
"t" = (
/obj/machinery/artifact,
/turf/simulated/floor/tiled/asteroid_steel,
/area/submap/AbandonedTemple)
"u" = (
/obj/structure/bed/chair/comfy/brown{
	dir = 4
	},
/obj/effect/decal/cleanable/blood,
/turf/simulated/floor/carpet/turcarpet,
/area/submap/AbandonedTemple)
"v" = (
/obj/structure/table/woodentable,
/obj/item/paper,
/obj/item/pen/fountain,
/turf/simulated/floor/carpet/turcarpet,
/area/submap/AbandonedTemple)
"w" = (
/obj/effect/decal/cleanable/blood/xeno,
/turf/simulated/floor/tiled/asteroid_steel,
/area/submap/AbandonedTemple)
"x" = (
/obj/effect/decal/cleanable/blood/xeno,
/obj/effect/decal/remains/posi,
/turf/simulated/floor/tiled/asteroid_steel,
/area/submap/AbandonedTemple)
"y" = (
/obj/structure/table/woodentable,
/obj/item/flame/candle/candelabra/everburn,
/turf/simulated/floor/carpet/turcarpet,
/area/submap/AbandonedTemple)
"z" = (
/obj/structure/simple_door/gold,
/turf/simulated/floor/tiled/asteroid_steel,
/area/submap/AbandonedTemple)
"A" = (
/obj/effect/decal/remains/posi,
/turf/simulated/floor/tiled/asteroid_steel,
/area/submap/AbandonedTemple)
"B" = (
/obj/machinery/crystal{
	icon_state = "crystal3";
	light_color = "#f44256";
	light_power = 3
	},
/obj/effect/decal/cleanable/cobweb,
/turf/simulated/floor/tiled/asteroid_steel,
/area/submap/cave/crystal1)
"C" = (
/obj/structure/flora/pottedplant/dead,
/turf/simulated/floor/tiled/asteroid_steel,
/area/submap/AbandonedTemple)
"D" = (
/obj/machinery/crystal{
	icon_state = "crystal3";
	light_color = "#f44256";
	light_power = 3
	},
/turf/simulated/floor/tiled/asteroid_steel,
/area/submap/AbandonedTemple)
"E" = (
/obj/effect/decal/remains/human,
/turf/simulated/floor/tiled/asteroid_steel,
/area/submap/AbandonedTemple)
"F" = (
/obj/effect/decal/cleanable/blood,
/obj/effect/decal/remains/human,
/turf/simulated/floor/carpet/turcarpet,
/area/submap/AbandonedTemple)
"G" = (
/obj/structure/table/woodentable,
/obj/item/paper/alien{
	desc = "";
	icon_state = "alienpaper_words";
	info = "(On the screen of the tablet are several lines of characters written in a language you don't seem to recognize. At the end of each line is a set of numbers seperated by a colon. The screen flickers occasionally, as if damaged. Nothing about the tablet seems particularly interesting, but it does seem very, very old.)"
	},
/turf/simulated/floor/carpet/turcarpet,
/area/submap/AbandonedTemple)
"H" = (
/obj/effect/decal/cleanable/blood/xeno,
/turf/simulated/floor/carpet/turcarpet,
/area/submap/AbandonedTemple)
"I" = (
/obj/structure/table/bench/wooden,
/turf/simulated/floor/tiled/asteroid_steel,
/area/submap/AbandonedTemple)
"J" = (
/obj/effect/decal/cleanable/cobweb,
/turf/simulated/floor/tiled/asteroid_steel,
/area/submap/AbandonedTemple)
"K" = (
/obj/structure/table/bench/wooden,
/obj/effect/decal/remains/xeno,
/turf/simulated/floor/tiled/asteroid_steel,
/area/submap/AbandonedTemple)
"L" = (
/obj/structure/simple_door/sandstone,
/turf/simulated/floor/tiled/asteroid_steel,
/area/submap/AbandonedTemple)
"M" = (
/obj/effect/decal/cleanable/cobweb,
/obj/item/flame/candle/candelabra/everburn,
/turf/simulated/floor/tiled/asteroid_steel,
/area/submap/AbandonedTemple)
"N" = (
/obj/effect/decal/cleanable/cobweb2,
/obj/item/flame/candle/candelabra/everburn,
/turf/simulated/floor/tiled/asteroid_steel,
/area/submap/AbandonedTemple)
"O" = (
/obj/effect/decal/cleanable/blood,
/turf/simulated/mineral/floor/cave,
/area/submap/AbandonedTemple)

(1,1,1) = {"
a
a
a
a
a
a
a
a
a
a
a
a
a
a
a
a
a
a
a
a
a
a
a
a
a
"}
(2,1,1) = {"
a
a
a
b
b
b
b
b
b
b
b
b
b
b
b
b
b
b
b
b
a
a
a
a
a
"}
(3,1,1) = {"
a
a
c
c
c
c
c
c
c
c
c
c
c
c
c
b
b
b
b
b
b
a
a
a
a
"}
(4,1,1) = {"
a
b
c
d
d
d
d
d
d
d
d
d
d
d
m
c
b
b
b
b
b
b
a
a
a
"}
(5,1,1) = {"
a
b
c
d
e
p
u
p
p
p
w
c
c
d
d
m
c
b
b
b
b
b
b
a
a
"}
(6,1,1) = {"
a
b
c
d
f
q
v
y
p
p
c
E
c
s
d
d
c
c
b
b
b
b
b
a
a
"}
(7,1,1) = {"
a
b
c
d
g
g
g
g
g
g
g
g
z
g
g
d
d
c
c
b
b
b
b
a
a
"}
(8,1,1) = {"
a
b
c
d
h
c
h
z
c
g
B
c
c
c
c
c
d
d
c
b
b
b
b
a
a
"}
(9,1,1) = {"
a
b
c
d
i
r
c
g
c
g
C
c
c
c
c
c
D
d
m
c
c
s
b
a
a
"}
(10,1,1) = {"
a
b
c
d
h
s
h
g
c
g
c
w
c
I
c
K
c
d
d
d
d
c
b
a
a
"}
(11,1,1) = {"
a
b
c
d
g
g
g
g
c
z
c
p
p
I
c
I
c
d
M
c
d
c
b
a
a
"}
(12,1,1) = {"
a
b
c
d
j
c
p
p
c
g
c
F
G
c
c
c
w
L
c
w
L
c
b
a
a
"}
(13,1,1) = {"
a
b
c
d
k
c
p
p
c
g
c
p
y
c
c
c
s
L
c
c
L
c
O
a
a
"}
(14,1,1) = {"
a
b
c
d
g
g
g
g
c
z
c
p
H
I
c
I
c
d
N
c
d
s
b
a
a
"}
(15,1,1) = {"
a
b
c
d
c
c
w
g
c
g
c
c
l
I
c
I
c
d
d
d
d
c
b
a
a
"}
(16,1,1) = {"
a
b
c
d
l
t
c
g
c
g
C
c
c
c
c
c
D
d
s
c
c
c
b
a
a
"}
(17,1,1) = {"
a
b
c
d
m
c
c
z
c
g
D
c
c
c
c
s
d
d
c
b
b
b
b
a
a
"}
(18,1,1) = {"
a
b
c
d
g
g
g
g
g
g
g
g
z
g
g
d
d
J
c
b
b
b
b
a
a
"}
(19,1,1) = {"
a
b
c
d
n
c
c
n
c
c
c
c
w
n
d
d
c
c
b
b
b
b
b
a
a
"}
(20,1,1) = {"
a
b
c
d
o
c
x
c
c
A
n
l
n
d
d
c
c
b
b
b
b
b
b
a
a
"}
(21,1,1) = {"
a
b
c
d
d
d
d
d
d
d
d
d
d
d
J
c
b
b
b
b
b
b
a
a
a
"}
(22,1,1) = {"
a
a
c
c
c
c
c
c
c
c
c
c
c
c
c
b
b
b
b
b
b
a
a
a
a
"}
(23,1,1) = {"
a
a
a
b
b
b
b
b
b
b
b
b
b
b
b
b
b
b
b
b
a
a
a
a
a
"}
(24,1,1) = {"
a
a
a
a
a
a
a
a
a
a
a
a
a
a
a
a
a
a
a
a
a
a
a
a
a
"}
(25,1,1) = {"
a
a
a
a
a
a
a
a
a
a
a
a
a
a
a
a
a
a
a
a
a
a
a
a
a
"}
