"a" = (/turf/template_noop,/area/template_noop)
"b" = (/obj/structure/cliff/automatic/corner{icon_state = "cliffbuilder-corner"; dir = 6},/turf/simulated/mineral/floor/ignore_mapgen,/area/template_noop)
"c" = (/obj/structure/cliff/automatic{icon_state = "cliffbuilder"; dir = 2},/turf/simulated/mineral/floor/ignore_mapgen,/area/template_noop)
"d" = (/obj/structure/cliff/automatic/corner{icon_state = "cliffbuilder-corner"; dir = 10},/turf/simulated/mineral/floor/ignore_mapgen,/area/template_noop)
"e" = (/obj/structure/cliff/automatic{icon_state = "cliffbuilder"; dir = 6},/turf/simulated/mineral/floor/ignore_mapgen,/area/template_noop)
"f" = (/turf/simulated/mineral/floor/ignore_mapgen,/area/template_noop)
"g" = (/obj/structure/cliff/automatic{icon_state = "cliffbuilder"; dir = 10},/turf/simulated/mineral/floor/ignore_mapgen,/area/template_noop)
"h" = (/obj/structure/cliff/automatic{icon_state = "cliffbuilder"; dir = 4},/turf/simulated/mineral/floor/ignore_mapgen,/area/template_noop)
"i" = (/mob/living/simple_mob/humanoid/merc/ranged/grenadier,/turf/simulated/floor/cult,/area/template_noop)
"j" = (/turf/simulated/floor/cult,/area/template_noop)
"k" = (/obj/random/tool/power,/obj/random/tech_supply,/turf/simulated/floor/cult,/area/template_noop)
"l" = (/obj/structure/cliff/automatic{icon_state = "cliffbuilder"; dir = 8},/turf/simulated/mineral/floor/ignore_mapgen,/area/template_noop)
"m" = (/obj/structure/bonfire/permanent/sifwood,/obj/structure/grille/rustic,/turf/simulated/floor/cult,/area/template_noop)
"n" = (/obj/random/multiple/minevault,/turf/simulated/floor/cult,/area/template_noop)
"o" = (/obj/structure/cliff/automatic/corner,/turf/simulated/mineral/floor/ignore_mapgen,/area/template_noop)
"p" = (/obj/structure/cliff/automatic{icon_state = "cliffbuilder"; dir = 5},/turf/simulated/mineral/floor/ignore_mapgen,/area/template_noop)
"q" = (/obj/structure/cliff/automatic{icon_state = "cliffbuilder"; dir = 9},/turf/simulated/mineral/floor/ignore_mapgen,/area/template_noop)
"r" = (/obj/structure/cliff/automatic/corner{icon_state = "cliffbuilder-corner"; dir = 9},/turf/simulated/mineral/floor/ignore_mapgen,/area/template_noop)
"s" = (/obj/structure/cliff/automatic,/turf/simulated/mineral/floor/ignore_mapgen,/area/template_noop)

(1,1,1) = {"
aaaaaaaaa
aabcccdaa
abefffgda
ahfijkfla
ahfjmjfla
ahfnjjfla
aopfffqra
aaosssraa
aaaaaaaaa
"}
